0 0 0 0 0 0 0 0 0 0 0 0 0 0 0 0 0 0 0 0 0 0 0 0 0 0 0 0 0 0 0 0 0 0 0 0 0 0 0 0 0 0 0 0 0 0 0 0 0 0 0 0 0 0 0 0 0 0 0 0 0 0 0 0
0 0 0 0 0 0 0 152 51 0 0 55 0 0 0 0 0 0 0 0 108 0 0 0 0 0 0 37 0 0 0 0 0 0 0 0 0 0 0 48 48 48 48 0 0 0 0 0 0 0 0 0 0 0 0 54 0 0 154 0 0 0 0 0
0 0 0 0 0 0 0 0 0 0 0 0 0 0 165 0 0 0 0 0 0 0 0 0 0 0 0 0 0 0 0 0 0 0 27 0 0 0 27 0 0 0 27 0 0 0 0 0 0 0 0 0 165 0 0 0 0 0 0 0 0 0 0 0
0 0 0 0 0 0 56 0 0 0 0 0 0 0 0 0 0 0 0 0 0 0 0 165 0 0 0 0 0 0 0 0 0 0 0 49 49 49 49 49 49 49 0 0 0 0 0 0 0 0 0 0 0 0 0 0 0 0 0 0 0 0 0 0
0 0 0 0 0 0 0 108 0 37 0 0 0 0 37 0 0 0 0 0 0 0 0 0 0 0 0 37 0 0 0 0 0 0 0 49 49 49 214 49 49 49 0 0 0 0 0 0 0 0 0 0 0 0 0 0 0 0 0 54 0 0 0 0
0 0 0 0 0 0 0 0 0 0 54 0 0 0 0 0 0 0 0 0 0 0 0 0 0 0 0 0 0 0 0 0 0 0 0 49 49 49 49 49 49 49 0 0 0 0 0 0 0 0 0 0 0 0 0 0 0 0 0 0 0 0 0 0
0 0 0 0 0 0 0 0 0 0 54 0 0 0 0 0 0 0 0 0 0 152 0 37 0 0 0 0 0 0 0 0 0 0 0 49 49 49 49 49 49 49 0 0 0 0 0 0 0 37 0 0 0 0 0 165 0 0 0 0 0 0 0 0
0 0 0 0 0 0 0 0 0 0 0 0 0 0 0 0 0 0 0 0 0 0 0 0 0 0 0 0 0 0 0 0 0 0 27 0 0 0 27 0 0 0 27 0 0 0 0 0 0 0 0 0 0 0 0 0 0 0 0 0 0 0 0 0
0 0 0 0 0 0 0 0 0 0 0 0 0 0 0 0 0 0 165 0 0 0 0 0 0 0 0 0 0 0 0 0 0 0 0 0 0 0 0 0 0 0 0 0 0 0 0 0 0 0 0 0 0 0 0 0 0 0 0 0 0 0 0 0
0 0 0 0 0 0 0 0 0 0 0 0 0 0 0 0 0 0 0 0 0 0 0 0 0 0 0 37 0 0 0 0 0 0 0 0 0 0 0 0 0 0 0 0 0 0 0 0 0 0 0 0 0 0 0 37 0 0 0 0 0 0 0 0
0 0 0 0 0 0 0 0 0 0 0 0 0 0 0 0 0 0 0 0 0 0 0 0 0 0 0 0 0 0 0 0 0 0 0 0 0 0 0 0 0 0 0 0 0 0 0 0 0 0 0 0 0 0 0 0 0 0 0 0 0 0 0 0
0 0 0 0 0 0 0 0 0 0 0 0 0 0 37 0 108 0 0 0 0 0 0 0 0 0 0 0 0 0 0 165 0 0 0 0 0 152 0 0 0 0 0 0 154 0 0 0 37 0 0 0 0 0 0 0 0 0 0 0 0 0 0 0
0 0 0 0 0 0 0 0 0 0 0 0 0 0 0 0 0 0 0 0 0 0 0 0 0 0 0 0 0 0 0 0 0 0 0 0 0 0 0 0 0 0 0 0 0 0 0 0 0 0 0 54 0 0 0 0 51 55 237 0 0 0 0 0
0 0 0 0 0 0 0 0 0 0 0 0 0 0 0 0 0 0 0 0 0 0 0 0 0 0 0 0 0 108 0 37 0 0 0 0 0 0 0 0 0 0 0 0 0 0 0 0 0 0 0 0 0 0 0 0 0 0 0 0 54 0 0 0
0 0 0 0 0 0 0 0 0 0 0 0 0 0 0 0 0 0 0 0 0 0 0 0 0 0 0 0 0 0 0 0 0 0 0 0 0 0 0 0 0 0 0 0 0 0 37 0 0 0 0 0 0 0 0 219 0 0 0 0 0 48 236 0
0 0 0 0 0 0 0 0 0 0 0 0 0 0 0 0 0 0 37 152 0 0 0 0 37 0 0 0 0 0 0 0 0 0 0 0 0 0 0 37 0 0 0 0 154 0 0 0 0 0 0 0 0 0 0 0 0 37 0 0 0 0 0 0
0 0 0 0 0 0 0 0 0 0 0 0 0 0 0 0 0 0 0 0 0 0 0 0 0 0 0 0 0 0 0 0 0 0 0 0 0 0 0 0 0 0 0 0 0 0 165 0 0 0 0 0 0 0 0 48 0 255 0 0 0 0 219 0
0 0 0 0 0 0 0 0 0 0 0 0 0 0 0 0 0 0 0 0 0 0 0 0 0 0 0 0 0 0 0 0 0 0 0 0 0 0 0 0 0 0 0 0 0 0 0 0 0 0 0 0 0 0 0 0 0 0 0 0 55 0 55 0
0 0 0 0 0 0 0 0 0 0 0 0 0 0 0 0 0 0 0 0 0 0 0 0 0 0 0 0 0 0 0 0 0 0 0 0 0 0 0 0 0 0 37 0 0 0 0 0 0 0 0 0 0 0 0 0 0 236 0 255 0 0 0 0
0 0 0 0 0 0 0 0 0 0 0 0 0 0 0 0 0 0 0 0 0 0 0 0 0 0 0 0 0 0 0 0 0 0 0 0 0 0 0 0 0 0 0 0 0 54 0 0 0 0 252 70 70 0 37 0 0 0 0 0 0 37 0 0
0 0 0 0 0 0 0 0 37 0 0 0 0 0 0 0 0 0 0 0 0 0 0 0 0 152 0 0 0 0 0 27 0 0 0 0 0 0 0 0 0 0 0 0 0 0 0 0 0 0 0 0 70 0 0 0 0 0 0 0 0 0 254 0
0 0 0 0 0 0 0 0 0 0 0 0 0 0 0 0 0 0 0 0 0 0 0 0 0 0 0 0 0 0 0 0 0 0 0 0 154 0 0 37 0 0 0 0 0 0 0 0 0 0 0 0 70 0 0 0 0 0 0 0 0 0 254 0
0 0 0 0 0 116 0 0 0 0 0 0 0 0 0 0 0 0 0 0 0 0 0 0 0 0 0 0 0 0 0 0 0 0 0 0 0 0 0 0 0 0 0 0 0 0 0 0 70 70 70 70 70 0 0 0 0 54 0 0 0 55 0 0
0 0 0 116 188 0 0 0 0 0 0 0 0 0 0 0 0 0 0 0 0 0 0 0 0 0 0 0 0 0 0 0 0 0 0 0 0 0 0 0 0 0 0 0 0 0 0 0 70 0 0 0 0 0 0 0 0 0 0 37 0 0 0 0
0 0 0 152 0 0 0 0 0 0 0 0 0 0 0 0 0 0 0 0 0 0 0 0 0 0 0 0 0 0 0 0 0 0 0 0 0 0 0 0 0 0 0 0 0 70 70 70 70 70 0 0 0 0 70 55 0 51 0 0 0 0 0 0
0 0 0 0 188 0 0 0 0 0 0 0 0 0 0 0 0 0 0 0 0 0 0 0 0 0 0 0 0 0 0 0 0 0 0 0 0 37 0 0 0 0 0 0 0 70 0 0 0 70 70 70 70 0 70 0 0 0 0 0 0 0 0 0
0 0 0 188 0 0 0 0 0 0 0 0 0 0 0 0 0 0 0 0 0 0 0 0 0 0 0 0 0 0 0 0 0 0 0 0 0 0 0 0 0 0 70 70 70 70 0 0 0 0 0 0 70 70 70 70 70 0 0 55 0 0 0 0
0 0 152 0 0 0 0 0 0 0 0 0 0 0 0 0 0 0 0 0 0 0 0 0 0 0 0 0 0 0 0 0 0 0 0 0 0 0 0 0 0 0 70 0 0 70 70 70 70 0 0 0 0 0 0 0 70 70 0 0 0 0 0 0
0 0 188 0 0 0 0 0 0 0 0 0 0 0 0 0 0 0 0 0 0 0 119 0 201 0 0 0 0 0 0 37 0 0 0 0 0 0 0 51 0 0 0 0 0 0 0 0 70 70 70 70 70 70 0 0 0 70 0 0 0 0 0 0
0 0 0 0 0 0 0 0 0 236 0 0 48 0 0 0 0 0 0 0 0 0 0 0 0 0 0 37 0 0 0 0 0 0 0 37 0 0 0 0 98 64 0 32 0 0 0 70 70 0 235 0 70 70 70 70 70 70 0 0 0 0 0 0
0 0 0 0 0 0 0 0 218 0 254 55 51 0 0 0 0 180 0 0 0 0 37 0 0 0 0 0 0 0 0 0 0 0 0 0 0 0 0 0 0 0 0 0 0 70 70 70 0 0 0 0 0 0 0 70 0 0 0 0 0 0 0 0
0 0 0 0 0 0 0 0 254 0 0 236 48 0 0 0 0 0 0 0 0 0 0 0 0 0 0 0 0 0 0 0 0 0 0 0 0 0 0 0 0 0 0 0 0 0 0 0 0 0 70 70 70 70 70 70 0 0 0 0 0 0 0 0
0 0 0 0 0 0 0 0 0 0 27 0 214 0 0 0 0 108 37 0 0 0 37 0 0 0 37 0 0 236 0 254 0 0 20 0 37 0 0 0 0 0 61 0 0 70 70 70 70 70 70 0 0 70 0 70 70 70 70 236 0 0 0 0
0 0 0 0 0 0 0 0 0 0 218 0 48 0 0 0 0 0 0 0 0 0 0 0 0 0 0 0 0 0 0 0 0 0 0 0 0 0 0 0 0 0 0 0 0 0 0 0 0 0 0 0 70 70 0 70 0 0 0 70 118 0 0 0
0 0 0 0 0 0 0 236 0 254 0 254 51 0 0 0 0 144 0 0 0 0 37 0 0 0 0 0 0 0 0 0 0 0 0 0 0 0 0 0 0 0 0 0 0 70 70 70 70 0 0 0 235 0 0 55 0 70 70 70 0 0 0 0
0 0 0 0 0 0 0 0 0 0 0 0 48 0 0 0 0 0 0 0 0 0 0 0 0 0 0 37 0 0 0 0 0 0 0 37 0 0 0 0 0 0 0 57 0 0 0 0 70 0 70 0 0 0 0 0 0 70 0 0 0 0 0 0
0 0 0 0 0 0 0 0 0 0 0 0 0 0 0 0 0 0 0 0 0 0 153 0 189 0 0 0 0 0 0 37 0 0 0 0 0 0 0 98 0 0 0 0 0 0 0 0 70 70 70 0 55 70 0 0 0 70 70 118 0 56 56 0
0 0 0 0 0 0 0 0 0 0 0 0 0 0 0 0 0 0 0 0 0 0 0 0 0 0 0 0 0 0 0 0 0 0 0 0 0 0 48 0 0 0 70 70 0 0 0 0 70 0 0 0 0 70 70 70 0 0 70 0 0 0 224 0
0 0 188 0 0 0 0 0 0 0 0 0 0 0 0 0 0 0 0 0 0 0 0 0 0 0 37 0 0 37 0 0 0 0 0 0 0 0 48 0 0 0 0 70 0 0 0 0 70 70 70 70 70 70 0 70 70 70 70 0 0 0 0 0
0 0 0 0 152 0 0 0 0 0 0 0 0 0 0 0 0 0 0 0 0 0 0 0 0 0 0 0 0 0 0 37 0 37 0 0 0 0 0 0 0 70 70 70 0 0 0 0 0 70 0 0 0 70 0 70 0 235 0 0 0 0 0 0
0 0 0 188 0 0 0 0 0 0 0 0 0 0 0 0 0 0 0 0 0 0 0 0 0 0 236 0 0 0 0 0 0 0 128 37 0 0 0 0 0 70 0 0 0 0 0 252 70 70 0 0 51 70 0 70 0 0 0 0 0 0 0 0
0 0 0 0 0 152 0 0 0 0 0 0 0 0 0 0 0 0 0 0 0 0 0 0 37 0 0 0 0 0 0 0 0 0 0 0 0 0 0 0 0 70 70 0 0 0 0 0 0 0 0 0 0 0 0 70 0 0 0 0 0 0 0 0
0 0 0 0 188 0 0 0 0 0 0 0 0 0 0 0 0 0 0 0 0 0 37 0 0 236 0 0 0 90 0 166 0 96 0 0 165 0 0 0 0 0 70 70 70 70 0 0 0 0 0 0 0 188 70 70 0 0 0 0 0 0 98 0
0 0 0 0 0 116 0 0 0 0 0 0 0 0 0 0 0 0 0 0 0 0 0 0 0 0 0 0 0 0 37 0 37 0 0 0 37 0 0 0 0 0 0 0 0 0 0 0 0 0 0 0 0 0 0 0 0 0 0 98 0 0 0 0
0 0 0 0 0 0 116 0 37 0 0 0 0 0 0 0 0 0 0 37 0 37 0 37 0 37 0 0 0 92 114 0 0 94 0 0 0 0 0 49 0 0 0 0 0 0 0 0 0 0 0 0 0 0 0 0 0 0 0 0 0 0 0 0
0 0 0 0 0 0 0 0 0 0 0 0 0 0 0 0 0 0 0 0 0 0 0 0 0 0 0 0 0 0 0 0 0 0 0 0 0 0 154 37 0 49 0 0 0 0 0 0 0 0 0 0 0 0 0 0 0 98 0 0 0 0 0 0
0 0 0 0 0 0 0 0 0 0 0 0 0 0 0 0 0 0 0 153 0 0 0 0 0 37 0 188 0 0 0 0 129 0 0 37 0 0 118 0 190 0 0 0 0 0 0 0 0 0 217 0 0 0 0 0 0 0 0 0 0 0 0 0
0 0 0 0 0 0 0 0 0 0 0 0 0 0 0 0 0 237 0 0 0 0 0 0 0 0 0 0 0 0 0 0 37 0 0 0 0 0 0 0 0 0 0 0 0 0 0 0 0 218 236 0 254 254 98 0 0 0 0 0 98 0 0 0
0 0 0 0 0 0 0 0 0 0 0 0 0 0 0 37 0 37 0 37 0 37 0 37 0 37 153 0 0 37 236 0 0 0 0 37 0 0 0 0 0 37 0 0 37 0 0 0 0 0 218 236 61 254 0 98 0 0 98 0 0 0 0 0
0 0 0 0 0 0 0 0 0 0 0 0 0 0 0 0 0 0 0 0 0 0 0 0 0 0 0 0 0 0 0 0 0 0 0 0 0 0 49 236 0 0 0 0 0 0 0 0 0 0 0 0 98 0 0 0 0 0 0 0 0 0 0 0
0 0 0 0 0 0 0 0 0 0 0 0 0 0 0 0 0 0 0 0 0 0 0 0 0 37 0 0 37 0 0 0 0 0 0 0 0 0 0 0 0 0 0 0 0 0 0 219 0 0 0 0 0 0 0 0 98 0 0 98 0 0 0 0
0 0 0 0 0 0 0 0 0 0 0 0 0 0 0 37 0 0 37 0 0 37 0 0 0 0 0 0 0 0 0 0 37 236 0 0 0 37 0 0 0 37 0 0 37 49 49 37 154 0 0 56 0 0 0 0 98 98 0 98 0 0 0 0
0 0 0 0 0 0 0 0 0 0 0 0 0 55 0 0 0 0 0 0 0 0 0 37 0 49 49 110 37 0 0 0 0 0 0 0 0 0 0 0 0 0 0 0 0 0 0 0 0 0 0 56 56 0 0 0 0 0 98 0 0 0 0 0
0 0 0 0 0 0 0 0 0 0 0 0 0 0 37 0 0 0 0 0 0 163 0 0 0 0 0 0 0 0 37 0 37 0 0 153 0 90 0 0 37 0 0 0 138 0 0 94 0 37 0 0 0 0 0 0 0 0 0 0 0 0 0 0
0 0 0 0 0 0 0 0 0 0 0 0 0 253 153 109 0 0 0 0 0 0 0 37 0 0 110 0 37 0 0 0 0 0 0 0 0 0 0 0 0 0 0 0 0 0 0 0 0 0 0 0 0 0 0 0 0 0 0 0 0 0 0 0
0 0 0 0 0 0 0 0 0 37 0 0 37 0 0 0 0 0 0 0 0 0 0 0 0 0 0 0 0 0 0 0 0 0 0 0 0 0 98 214 55 49 49 49 0 0 0 0 0 37 0 0 0 37 0 0 0 0 0 0 0 0 0 0
0 0 0 0 0 0 0 0 0 0 0 0 0 0 55 37 0 49 37 0 0 37 0 37 0 0 0 0 37 0 0 0 37 0 37 0 0 0 0 55 27 49 49 49 27 0 0 0 0 0 0 0 0 0 0 0 0 0 0 0 0 0 0 0
0 0 0 0 0 0 0 0 0 0 0 0 0 0 0 0 0 0 0 0 0 0 0 0 0 0 0 0 0 0 0 0 0 0 0 0 0 0 0 0 0 49 49 49 0 0 0 0 0 0 0 0 0 0 0 236 0 0 0 0 0 0 0 0
0 0 0 0 0 0 0 0 0 37 0 0 0 37 49 0 37 0 0 37 0 0 0 163 0 162 37 0 0 0 235 0 37 0 0 0 0 0 0 0 0 49 49 49 0 0 0 0 0 0 0 0 0 0 0 0 0 0 0 0 0 0 0 0
0 0 0 0 0 0 0 0 0 0 0 0 0 0 0 0 0 0 0 0 0 0 0 0 0 0 0 0 0 0 0 0 0 0 0 0 0 0 0 55 27 49 49 0 27 0 0 37 0 0 0 0 0 37 0 0 0 37 0 0 0 0 0 0
0 0 0 0 0 0 55 49 49 0 0 37 110 0 0 0 0 0 0 37 0 0 0 37 0 126 0 0 49 48 48 0 0 0 0 0 56 56 0 55 55 0 0 0 0 58 0 0 0 0 217 0 0 0 0 0 0 49 0 0 0 0 0 0
0 0 0 0 0 0 55 37 49 0 0 0 0 0 0 0 109 0 0 0 0 0 0 0 0 0 0 0 49 37 48 0 0 0 0 0 0 0 0 0 0 0 0 0 0 0 0 0 0 0 0 0 0 0 0 0 0 49 0 0 0 0 0 0
0 0 0 0 0 0 0 0 0 37 0 0 0 37 0 0 37 0 0 49 0 37 0 0 0 0 37 0 49 49 49 0 37 0 37 0 0 0 0 0 0 0 37 0 0 90 0 0 0 37 0 0 138 0 0 94 0 37 0 0 0 0 0 0
0 0 0 0 0 0 0 0 0 0 0 0 0 0 0 0 0 0 0 0 0 0 0 0 0 0 0 0 0 0 0 0 0 0 0 0 0 0 0 0 0 0 0 0 0 0 0 0 0 0 0 0 0 0 0 0 0 0 0 0 0 0 0 0
