35 35 39 35 35 33 35 35 35 35 39 35 6 35 35 35 35 37 17 17 17 17 17 17 17 17 17 17 17 17 17 17 17 17 17 17 17 17 17 17 17 17 17 17 17 17 17 17 17 17 17 17 17 17 17 17 17 17 17 17 17 17 17 17
37 120 120 120 120 120 35 35 35 120 120 120 120 120 120 120 35 120 17 17 17 17 17 17 17 17 17 17 17 17 17 17 17 143 143 143 106 143 143 143 143 143 143 106 143 143 143 106 143 143 106 143 106 143 143 106 143 143 106 143 143 143 143 17
35 35 35 35 35 120 35 35 120 120 120 120 120 120 120 120 35 106 17 17 17 17 17 17 17 17 17 17 17 17 17 17 17 143 17 17 17 17 17 17 17 17 17 17 17 17 17 17 17 17 17 17 17 17 17 17 17 17 17 17 17 143 143 17
16 120 120 120 120 120 120 120 120 120 120 120 120 120 120 120 120 120 18 21 17 17 17 17 17 17 17 17 17 17 17 106 143 143 143 106 17 17 17 17 29 29 29 29 29 32 29 29 29 29 29 29 29 30 29 29 29 29 29 17 17 106 143 17
16 120 120 120 120 120 120 120 120 120 120 120 120 120 120 120 120 120 100 120 21 17 17 17 143 143 143 17 17 17 20 106 143 143 143 106 20 17 17 17 29 29 29 111 111 111 111 111 111 111 111 111 111 111 111 111 111 29 29 17 17 143 143 17
16 120 120 120 120 120 120 120 120 120 120 120 120 120 120 120 120 120 18 21 17 17 17 17 143 143 143 17 17 17 17 143 106 143 106 143 17 17 17 17 29 29 29 111 111 111 29 29 30 29 29 29 111 29 29 29 111 106 29 17 17 143 106 17
35 35 35 39 35 120 35 35 120 120 120 120 120 120 120 120 35 106 17 17 17 17 17 17 143 143 143 17 17 17 17 17 17 143 17 17 17 26 26 26 8 8 8 8 91 9 8 8 29 29 29 111 111 111 29 29 29 111 29 17 17 143 17 17
35 35 35 35 35 120 39 35 35 120 120 120 120 120 120 120 39 120 20 17 17 17 17 17 17 143 17 17 17 17 17 17 17 143 17 17 17 26 26 26 8 8 8 106 110 106 8 8 29 31 111 111 29 111 111 29 29 111 29 17 17 106 17 17
35 35 35 35 35 33 35 35 35 36 36 36 91 36 36 36 35 120 90 143 143 143 143 143 143 143 143 143 143 143 143 143 143 143 17 17 17 26 26 26 8 8 8 9 110 8 8 8 29 29 111 29 29 29 111 111 111 111 29 17 38 143 143 17
35 35 35 35 34 34 34 34 34 34 34 109 109 109 34 34 35 120 20 17 17 17 17 17 17 143 17 17 17 17 17 17 17 17 17 17 17 26 26 26 8 8 110 106 110 110 9 8 29 29 106 29 29 29 111 29 111 29 29 17 17 143 143 17
35 35 35 35 34 34 34 36 34 34 34 109 109 109 34 34 35 120 17 17 17 17 17 17 143 143 143 17 17 17 17 17 17 17 17 17 17 26 26 26 8 8 8 8 110 9 8 8 29 111 111 111 29 111 106 29 111 29 29 17 17 17 143 17
26 26 26 26 34 34 136 136 136 34 34 109 109 109 34 34 35 37 35 35 17 17 17 17 143 143 143 17 17 17 17 17 17 17 17 17 17 26 26 26 8 8 8 106 110 110 8 8 29 111 29 111 111 111 111 111 111 111 30 17 17 17 143 17
26 26 26 26 34 36 136 136 136 90 109 109 109 109 109 34 35 120 35 35 17 17 17 17 143 143 143 17 17 17 17 17 17 17 17 17 17 26 26 26 8 8 8 9 110 9 8 8 29 106 29 29 111 29 29 111 29 106 29 17 17 143 143 17
26 26 26 26 34 34 136 136 136 34 34 109 109 109 34 34 35 120 35 35 17 17 17 17 17 17 17 17 17 17 17 17 17 17 17 17 17 26 26 26 8 8 8 110 110 110 106 8 31 111 111 111 111 29 31 111 29 111 29 17 17 143 143 38
26 26 26 26 34 34 34 36 34 34 34 109 109 109 34 34 35 35 35 35 17 17 17 17 17 17 17 17 17 17 17 17 17 17 17 17 17 26 26 26 8 8 8 9 110 9 8 8 29 111 106 29 29 29 29 111 111 111 29 17 17 143 143 17
26 26 26 26 34 34 34 34 34 34 34 109 109 109 34 34 35 35 35 35 17 17 17 17 17 17 17 17 17 17 17 17 17 17 17 17 17 26 26 26 8 8 110 106 110 110 110 8 29 111 111 111 29 29 111 111 111 29 29 17 17 106 143 17
26 26 26 26 26 26 26 26 26 8 8 41 91 41 8 8 26 26 26 26 26 26 26 26 26 26 26 26 26 26 26 26 26 26 26 26 26 26 26 26 8 8 8 9 110 9 8 8 29 29 111 111 111 111 111 29 111 30 29 17 17 143 143 17
26 26 26 26 26 26 26 26 26 8 8 110 110 110 8 8 26 26 26 26 26 26 26 26 26 26 26 26 26 26 26 26 26 26 26 26 26 26 26 26 8 8 8 106 110 110 8 9 29 29 111 29 32 29 111 106 111 29 29 17 17 143 17 17
26 26 26 26 26 26 26 26 26 8 8 8 110 9 8 8 8 8 8 8 8 8 8 26 26 26 26 26 26 26 26 26 26 26 26 26 26 26 26 26 8 8 8 8 110 8 9 111 111 29 111 111 111 29 111 111 29 29 29 17 17 143 17 17
26 26 26 26 26 26 26 26 26 8 106 110 110 110 106 8 8 8 8 8 8 8 8 26 26 26 26 26 26 26 26 26 26 26 26 26 26 26 26 26 8 8 110 110 110 110 106 8 29 111 29 29 106 111 111 29 29 29 29 17 17 143 143 17
26 26 26 26 26 26 26 26 26 8 8 8 110 8 9 8 110 110 110 110 110 8 8 26 26 26 26 26 26 26 26 26 26 26 26 26 26 26 26 26 8 8 8 9 110 8 9 8 29 111 29 29 30 29 32 29 29 29 29 17 17 143 106 17
26 26 26 26 26 26 26 26 26 8 106 110 110 110 110 8 110 110 8 110 110 8 8 26 26 26 26 26 26 26 26 26 26 26 26 26 26 26 26 26 8 8 110 106 110 110 8 8 29 29 29 29 29 29 29 29 29 29 29 17 17 143 143 17
26 26 26 26 26 26 26 26 26 8 8 8 110 8 9 8 110 110 110 110 110 8 8 26 26 26 26 26 26 26 26 26 26 26 26 26 26 26 26 26 8 8 8 9 110 9 8 8 26 26 26 26 26 26 26 26 26 26 26 17 17 143 143 17
26 26 26 26 26 26 26 26 26 8 110 106 110 106 8 8 8 8 8 8 8 8 8 26 26 26 26 26 26 26 26 26 26 26 26 26 26 26 26 26 8 8 106 110 110 110 106 8 26 26 26 26 26 26 26 26 17 17 17 17 17 143 143 17
26 26 26 26 26 26 26 26 26 8 8 9 110 8 8 8 8 8 8 8 8 8 8 26 26 26 26 26 26 26 26 26 26 26 26 26 26 26 26 26 8 8 9 8 110 8 9 8 26 26 26 26 26 26 26 26 17 17 17 17 143 143 143 17
26 26 26 26 26 26 26 26 26 8 8 106 110 110 110 8 8 8 8 8 8 8 8 8 8 8 8 8 8 8 8 8 8 8 8 8 8 8 8 9 8 8 8 110 110 110 8 8 26 26 26 26 26 26 26 26 17 17 143 143 143 143 143 17
26 26 26 26 26 26 26 26 26 8 8 9 110 8 9 8 8 8 106 8 8 8 106 8 8 8 9 8 8 106 8 8 8 8 8 8 8 9 8 110 8 9 8 9 110 8 8 8 26 26 26 26 26 26 26 26 17 17 143 143 106 143 143 17
26 26 26 26 26 26 26 26 26 8 8 8 110 8 110 9 110 8 110 9 110 9 110 8 106 8 110 8 8 110 8 8 9 8 9 110 8 110 8 110 8 110 8 8 110 9 8 8 26 26 26 26 26 26 26 26 17 38 143 143 143 143 143 17
26 26 26 26 26 26 26 26 26 8 8 8 110 110 110 110 110 110 110 110 110 110 110 110 110 110 110 110 110 110 110 110 110 110 110 110 110 110 110 110 110 110 110 110 110 8 8 8 26 26 26 26 26 26 26 26 17 17 143 143 143 17 17 17
26 26 26 26 26 26 26 26 26 8 8 8 9 8 106 9 110 8 110 9 110 8 110 8 110 8 110 8 9 110 8 8 110 8 8 110 8 110 8 106 8 110 9 8 110 9 8 8 26 26 17 17 17 17 17 17 17 17 143 106 143 17 17 17
26 26 26 26 26 26 26 26 26 8 8 8 8 8 8 8 106 8 8 8 106 8 9 8 106 8 106 8 8 9 8 110 110 110 8 9 8 106 8 8 9 9 8 9 110 8 8 8 26 26 17 17 17 17 17 17 17 17 143 143 143 17 17 17
26 26 26 26 26 26 26 26 26 8 8 8 8 8 8 8 8 8 8 8 8 8 8 8 8 8 8 8 8 8 8 8 110 8 8 8 8 8 8 8 8 8 106 110 110 110 8 8 26 26 17 17 137 137 137 17 17 17 17 143 143 17 17 17
26 26 26 26 26 26 26 26 26 26 26 26 26 26 26 26 26 8 133 133 133 133 133 133 133 133 133 133 133 8 8 106 110 110 110 110 110 8 8 8 8 8 8 9 110 8 8 8 26 26 17 17 137 137 137 137 137 90 143 143 106 17 17 17
26 26 26 26 26 26 26 26 26 26 26 26 26 26 26 26 26 8 133 8 8 8 8 8 8 8 8 8 133 8 8 8 110 8 8 8 110 8 8 8 8 8 8 106 110 110 9 8 26 26 17 17 137 137 137 17 17 17 17 143 143 17 17 17
26 26 26 26 26 26 26 26 26 26 26 26 26 26 26 26 26 8 133 8 8 133 133 133 133 133 8 8 93 8 8 106 110 110 106 8 106 110 110 8 8 8 8 9 110 9 8 8 26 26 17 17 17 17 17 17 17 17 143 143 143 17 17 17
26 26 26 26 26 26 26 26 26 26 26 26 26 26 26 26 26 8 133 8 8 133 133 133 133 133 8 8 110 8 8 8 110 8 8 8 8 8 8 8 8 8 8 110 110 110 106 8 26 26 17 17 17 17 17 17 17 17 106 143 143 17 17 17
26 26 26 26 26 26 26 26 26 26 26 26 26 26 26 26 26 8 133 133 133 133 133 133 133 133 8 110 110 8 106 110 110 110 8 8 8 8 8 8 8 8 8 8 110 9 9 8 26 26 26 26 26 26 26 26 17 17 143 143 143 17 17 17
26 26 26 26 26 26 26 26 26 26 26 26 26 26 26 26 26 8 8 8 8 133 133 133 133 133 8 8 8 8 8 8 110 8 8 8 8 8 8 8 8 8 8 106 110 106 8 8 26 26 26 26 26 26 26 26 17 17 143 143 17 17 17 17
26 26 26 26 26 26 26 26 26 26 26 26 26 26 26 26 26 8 8 8 8 133 133 133 133 133 8 8 8 8 106 110 110 106 8 8 8 8 8 8 8 8 8 9 110 9 8 8 26 26 26 26 26 26 26 26 17 17 143 143 17 17 17 17
26 26 26 26 26 26 26 26 26 26 26 26 26 26 26 26 26 8 8 8 8 8 8 8 8 8 8 8 8 8 8 8 110 8 8 8 8 8 8 8 8 8 110 106 110 110 8 8 26 26 26 26 26 26 26 26 17 17 143 143 143 17 17 17
26 26 26 26 26 26 26 26 26 26 26 26 26 26 26 26 26 8 8 8 5 9 5 8 5 8 5 9 7 8 5 8 91 8 5 9 8 8 8 8 8 8 8 8 110 9 8 8 26 26 26 26 26 26 26 26 17 17 143 143 143 38 17 17
26 26 26 26 26 26 26 26 26 26 26 26 26 26 26 26 26 8 8 112 112 112 112 112 112 112 112 112 112 112 112 112 112 112 112 112 8 8 8 8 8 8 9 110 110 110 8 8 26 26 26 26 26 26 26 26 17 17 17 143 143 17 17 17
26 26 26 26 26 26 26 26 26 26 26 26 26 26 26 26 26 8 5 112 112 112 112 112 112 112 112 112 112 112 112 112 112 112 112 112 5 8 8 8 8 8 8 8 110 9 8 8 26 26 26 26 26 26 26 26 17 17 17 143 143 17 17 17
26 26 26 26 26 26 26 26 26 26 26 26 26 26 26 26 26 8 9 112 112 8 5 8 7 9 5 8 5 8 5 9 5 9 112 112 9 8 8 8 8 8 106 110 110 110 8 8 26 26 26 26 26 26 26 26 17 17 143 106 143 17 17 17
26 26 26 26 26 26 26 26 26 26 26 26 26 26 26 26 26 8 7 112 112 5 8 8 8 8 8 8 8 8 8 8 8 5 112 112 5 8 8 8 8 8 8 9 110 8 8 8 26 26 26 26 26 26 26 26 17 17 143 143 143 17 17 17
26 26 26 26 26 26 26 26 26 26 26 26 26 26 26 26 26 8 8 112 112 9 5 8 5 9 5 8 5 8 7 9 5 8 112 112 8 8 8 8 9 110 110 110 110 106 8 8 26 26 26 26 26 26 26 26 17 38 143 143 17 17 17 17
26 26 26 26 8 8 8 8 8 8 8 8 8 8 8 8 8 8 5 112 112 112 112 112 112 112 112 112 112 112 112 112 112 112 112 112 5 8 8 8 8 110 8 9 110 9 8 8 26 26 26 26 26 26 26 26 17 17 143 143 17 17 17 17
26 26 26 26 8 8 8 8 8 8 8 9 8 8 8 8 8 8 9 112 112 112 112 112 112 112 112 112 112 112 112 112 112 112 112 112 9 8 8 8 9 106 8 110 110 110 8 8 26 26 26 26 26 26 26 26 17 17 143 143 143 17 17 17
26 26 26 26 8 8 8 8 8 8 8 8 106 9 8 8 8 8 8 8 5 8 5 8 5 9 5 8 5 8 5 9 7 8 5 8 8 8 8 8 8 9 8 8 110 9 8 8 26 26 26 26 26 26 26 26 17 17 143 143 106 17 17 17
8 8 8 8 8 8 8 9 8 9 8 9 114 8 8 8 8 8 8 8 8 8 8 8 8 8 8 8 8 8 8 8 8 8 8 8 8 8 8 8 8 8 8 110 110 110 106 8 26 26 26 26 26 26 26 26 17 17 17 143 143 17 17 17
8 9 9 9 8 9 114 114 114 114 114 8 106 9 8 9 9 9 8 8 9 8 8 9 8 8 8 8 8 8 8 8 106 8 8 8 106 8 8 8 8 8 8 9 110 8 8 8 26 26 26 26 26 26 26 26 17 17 17 143 143 17 17 17
8 9 115 115 115 90 114 114 114 114 114 9 114 114 114 114 114 114 114 114 114 114 114 114 114 114 114 114 9 9 106 8 110 8 110 9 110 8 110 8 106 9 110 8 110 9 8 8 26 26 26 26 26 26 26 26 17 17 106 143 143 17 17 17
8 8 115 8 8 41 114 114 114 114 114 90 114 114 114 114 114 114 114 114 114 114 114 114 114 114 114 114 90 110 110 110 110 110 110 110 110 110 110 110 110 110 110 110 110 8 8 8 26 26 26 26 26 26 26 26 17 17 143 143 106 17 17 17
8 8 115 115 115 90 114 114 114 114 114 8 114 8 8 9 9 8 9 8 8 9 8 9 9 8 9 8 8 8 106 8 110 8 110 8 110 8 110 8 106 8 110 8 9 8 8 8 26 26 26 26 26 26 26 26 17 17 106 143 143 17 17 17
8 8 115 8 8 9 114 114 114 114 114 9 106 8 8 8 8 8 8 8 8 8 8 8 8 8 8 8 8 8 110 8 110 8 9 8 106 8 8 8 110 9 8 8 8 8 8 8 26 26 26 26 26 26 26 26 17 17 143 143 17 17 17 17
8 9 115 9 8 8 9 8 9 9 8 9 114 8 8 8 8 8 8 8 8 8 8 8 8 8 8 8 8 8 8 8 8 8 8 8 8 8 8 8 9 8 8 8 8 8 8 8 26 26 26 26 26 26 26 26 17 17 143 143 17 17 17 17
8 8 115 8 8 8 8 8 8 8 8 8 106 8 8 8 8 8 8 8 8 8 8 8 8 8 8 8 8 8 8 8 8 8 8 8 8 8 8 8 8 8 8 8 8 8 8 8 26 26 26 26 26 26 26 26 17 17 143 143 106 17 17 17
8 9 115 9 8 8 8 8 8 8 8 8 8 8 8 8 8 17 17 17 17 17 17 17 17 17 17 17 17 17 17 17 17 17 17 17 17 17 17 17 17 17 17 17 17 17 17 17 17 17 17 17 17 17 17 17 17 17 143 143 143 17 17 17
8 9 115 9 8 8 8 8 8 8 8 8 8 8 8 8 9 17 38 17 17 20 17 17 17 20 17 17 17 20 17 17 17 20 17 17 17 20 17 17 17 20 17 17 17 20 17 38 17 20 17 17 17 20 17 17 17 20 106 143 143 20 17 17
8 8 115 8 8 8 9 9 9 8 9 8 8 8 9 8 115 18 143 143 143 143 106 143 143 143 143 143 143 143 143 143 143 143 143 143 143 143 143 143 143 143 143 143 143 143 106 143 143 143 143 143 143 143 143 143 143 143 143 143 143 17 17 17
8 9 115 115 115 115 115 115 115 115 115 115 115 115 115 115 115 90 143 143 106 143 143 143 143 143 143 143 143 143 143 143 106 143 143 143 143 143 106 143 143 143 143 143 143 143 143 143 143 143 143 143 143 143 143 143 143 143 143 143 143 17 17 17
8 9 8 9 8 9 9 9 9 9 9 8 8 9 8 8 115 18 143 106 143 106 143 106 143 143 143 143 106 143 143 143 143 143 143 143 143 143 143 143 143 143 143 143 143 143 143 143 143 143 106 143 143 143 143 143 143 143 143 143 143 17 17 17
8 8 8 8 8 8 8 8 8 8 8 8 8 8 8 8 9 17 17 17 17 20 17 17 17 20 17 17 17 20 17 17 17 20 17 38 17 20 17 17 17 20 17 17 17 20 17 17 17 20 17 17 17 20 17 17 38 20 17 17 17 17 17 17
8 8 8 8 8 8 8 8 8 8 8 8 8 8 8 8 8 17 17 17 17 17 17 17 17 17 17 17 17 17 17 17 17 17 17 17 17 17 17 17 17 17 17 17 17 17 17 17 17 17 17 17 17 17 17 17 17 17 17 17 17 17 17 17
