29 29 29 29 29 29 29 29 29 30 29 29 29 29 29 29 29 29 29 29 29 29 29 29 29 30 29 29 29 29 29 29 29 29 29 29 29 29 30 29 29 29 29 29 29 29 29 29 29 29 29 29 29 29 29 30 29 29 29 29 29 29 29 29
44 29 29 29 29 29 117 117 117 117 117 117 117 117 117 117 117 117 117 117 117 117 117 117 117 117 117 117 117 117 117 117 90 118 118 118 118 118 118 118 118 118 118 29 29 29 29 29 29 29 29 29 117 117 117 117 117 117 117 117 29 29 29 24
44 44 29 29 29 30 117 29 29 117 29 29 31 29 117 29 29 29 117 29 29 29 29 117 29 29 29 117 29 31 29 29 29 29 118 118 118 118 118 118 118 118 118 118 29 29 29 29 29 29 29 29 117 29 29 29 29 29 29 117 29 29 24 24
44 44 44 44 29 29 117 29 29 117 29 29 29 29 117 29 29 29 117 29 29 29 29 117 29 29 29 117 29 29 29 29 29 118 118 118 118 118 118 118 118 118 118 118 29 29 29 32 29 29 29 31 117 29 29 29 31 29 29 117 29 29 24 24
44 44 44 44 44 29 117 117 117 117 29 29 29 29 117 117 117 117 117 29 29 29 29 117 29 29 29 117 117 117 117 117 90 118 118 118 118 118 118 118 118 118 118 118 118 118 90 117 117 29 29 29 117 29 29 117 117 117 117 117 29 24 24 24
44 44 44 44 44 44 29 29 29 117 117 117 117 117 117 29 29 29 117 29 29 31 29 117 29 29 29 117 29 29 29 29 29 118 118 118 118 118 118 118 118 118 118 118 118 118 29 29 117 117 29 29 117 29 29 117 29 30 29 29 24 24 24 24
44 44 44 44 44 44 44 29 30 117 117 117 117 117 117 29 29 29 117 117 117 117 117 117 117 117 117 117 29 29 29 29 29 29 118 118 118 118 118 118 118 118 118 118 118 29 29 29 117 117 117 117 117 29 29 117 29 29 29 24 24 24 24 24
44 44 44 44 44 44 44 44 29 29 29 29 29 29 117 117 117 117 117 29 29 29 29 117 29 29 29 117 29 29 29 117 90 118 118 118 118 118 118 118 118 118 118 118 118 29 29 29 117 29 29 117 29 29 29 117 29 29 24 24 24 24 24 24
44 44 44 44 44 44 44 44 44 44 29 29 29 29 117 29 29 29 117 29 29 29 29 117 29 29 29 117 29 32 29 117 29 29 118 118 118 118 118 118 118 118 118 118 118 90 117 117 117 29 29 117 29 29 29 117 29 24 24 24 24 24 24 24
44 44 44 44 44 44 44 44 44 44 44 29 29 29 117 31 29 29 117 117 117 117 117 117 117 117 117 117 117 117 117 117 29 29 29 31 29 29 29 91 29 29 91 29 29 29 29 29 117 29 29 117 117 117 117 117 29 24 24 24 24 24 24 24
44 44 44 44 44 44 44 44 44 44 44 29 29 29 117 29 29 29 117 29 29 29 29 117 29 29 29 117 29 29 29 117 29 29 29 29 29 29 29 117 29 29 117 29 29 29 29 29 117 29 29 117 29 30 29 29 24 24 24 24 24 24 24 24
44 44 44 44 44 44 44 44 44 44 44 44 29 29 117 117 117 117 117 29 29 29 29 117 29 29 29 117 29 29 29 117 29 29 29 117 117 117 117 117 117 117 117 117 117 117 117 117 117 29 29 117 29 29 29 24 24 24 24 26 24 24 24 24
44 44 44 44 44 44 44 44 44 44 44 44 44 29 29 29 29 29 117 29 29 29 30 117 29 29 29 117 29 29 29 117 29 29 29 117 29 29 29 117 29 29 117 29 29 29 117 29 117 117 117 117 29 29 24 24 109 109 109 109 109 24 24 24
44 44 44 44 44 44 44 44 44 44 44 44 44 44 29 29 29 29 117 29 29 29 29 117 117 117 117 117 117 117 117 117 117 117 117 117 29 29 29 117 29 29 117 29 31 29 117 29 117 29 29 29 29 24 24 24 24 109 24 24 109 109 24 24
44 44 44 44 44 44 44 44 44 44 44 44 44 44 44 29 29 29 117 29 29 29 29 117 29 29 29 117 29 29 29 117 29 29 29 117 29 29 29 117 29 29 117 117 117 117 117 117 117 29 29 29 24 24 24 109 109 109 24 24 24 109 109 24
44 44 44 44 44 44 44 44 44 44 44 44 44 44 44 44 29 29 117 117 117 117 117 117 117 117 117 117 29 29 32 117 29 29 29 117 117 117 117 117 117 117 117 117 117 29 117 29 31 29 29 24 24 24 24 109 24 109 109 109 24 24 109 24
44 44 44 44 44 44 44 44 44 44 44 44 44 44 44 44 44 29 29 29 29 29 29 29 117 29 29 29 29 29 29 117 29 31 29 29 29 29 29 117 29 29 117 29 29 29 117 29 29 29 29 24 24 24 26 109 109 109 24 24 24 24 109 24
44 44 44 44 44 44 44 44 44 44 44 44 44 44 44 44 44 44 29 29 29 29 29 29 117 29 29 29 29 117 117 117 117 117 29 29 29 29 29 117 29 29 117 29 29 29 117 29 29 29 24 24 24 24 24 24 24 109 24 109 109 24 109 24
44 44 44 44 44 44 45 44 44 45 44 45 44 44 44 44 44 44 44 29 29 29 29 29 117 29 29 29 117 117 117 117 117 117 117 29 29 29 117 117 117 117 117 117 117 117 117 29 29 24 24 24 24 24 109 109 109 106 24 106 24 24 109 24
44 44 44 44 44 126 126 126 126 126 126 126 44 44 44 44 44 44 44 44 44 29 29 32 117 29 29 117 117 117 117 117 117 117 117 117 117 117 117 29 32 29 117 29 117 117 29 29 24 24 108 108 108 90 109 24 24 24 24 109 109 109 109 24
44 44 44 45 126 126 126 126 126 126 126 126 126 44 44 44 44 44 44 44 44 44 29 29 117 117 117 117 117 117 117 117 117 117 117 117 29 29 29 29 29 29 117 29 30 29 29 24 24 24 24 24 108 24 109 109 109 109 24 24 24 109 109 24
44 44 45 126 126 126 126 126 126 126 126 126 126 126 45 44 44 44 44 44 44 44 44 29 29 29 29 117 117 117 117 117 117 117 117 117 117 117 117 117 117 117 117 29 29 24 24 24 24 24 26 24 108 26 24 24 24 109 24 109 24 109 109 24
44 44 44 126 126 126 126 44 44 45 126 126 126 126 126 44 44 44 44 44 44 44 44 44 44 29 29 29 117 117 117 117 117 117 117 29 31 29 29 117 29 29 29 24 24 24 24 24 108 108 108 108 108 24 24 24 24 109 109 109 109 109 24 24
44 44 45 126 126 126 45 44 44 44 44 126 126 126 126 126 45 44 44 44 44 44 44 44 44 44 29 29 29 117 117 117 117 117 117 29 29 117 117 117 29 29 24 24 24 24 26 24 108 24 24 24 24 24 24 24 24 24 24 109 24 24 24 24
44 44 44 126 126 126 44 44 44 44 44 45 126 126 126 126 126 44 44 44 44 44 44 44 44 44 44 29 29 29 29 91 29 29 117 29 29 117 29 29 24 24 24 24 26 108 108 108 108 108 24 26 24 24 108 108 24 109 109 109 109 109 24 24
44 45 126 126 126 126 45 44 44 44 44 44 44 126 126 126 126 126 45 44 44 44 44 44 44 44 44 44 29 29 29 120 29 29 117 117 117 117 29 24 24 24 24 24 24 108 24 24 24 108 108 108 108 24 108 24 24 24 24 24 24 109 24 24
44 44 126 126 126 45 44 44 44 44 44 44 44 45 126 126 126 126 126 44 44 44 44 44 44 44 44 44 29 29 29 120 29 29 29 32 29 29 24 24 24 24 108 108 108 108 24 26 24 24 24 24 108 108 108 108 108 24 24 109 109 109 24 24
44 45 126 126 126 44 44 44 44 45 44 45 44 44 44 126 126 126 126 126 44 44 45 44 44 44 44 44 44 29 29 120 29 29 29 29 24 24 24 24 24 24 108 24 24 108 108 108 108 24 24 24 24 24 24 24 108 108 24 24 24 24 24 24
44 44 126 126 126 45 44 45 126 126 126 126 44 44 44 44 126 126 126 126 45 44 106 45 106 44 42 42 42 42 120 120 120 42 42 42 42 24 24 120 24 26 91 24 24 24 26 24 108 108 108 108 108 108 24 24 24 108 24 24 24 24 24 24
45 126 126 126 126 44 45 126 126 106 126 126 126 44 44 45 126 126 126 126 44 44 120 45 120 44 42 120 120 120 120 120 120 120 120 120 42 24 120 120 24 120 120 120 24 24 24 108 108 24 108 24 108 108 108 108 108 108 24 24 24 24 24 24
45 126 126 126 126 126 126 126 106 126 106 126 126 44 44 44 44 126 126 126 90 120 120 120 120 120 42 120 42 42 42 47 42 42 120 120 42 24 26 24 26 120 120 120 90 108 108 108 24 24 24 24 26 24 24 108 24 24 24 24 24 24 24 24
44 126 126 126 126 126 126 126 106 126 126 106 126 45 44 44 45 126 126 126 44 120 120 120 120 120 120 120 47 42 42 21 42 42 42 120 120 24 24 24 24 120 120 120 26 26 24 24 24 24 108 108 108 108 108 108 24 24 26 24 24 24 24 24
44 126 126 126 126 126 126 126 126 126 126 126 106 44 44 44 44 126 126 126 90 120 120 120 120 120 120 120 92 141 100 134 21 13 120 120 120 120 120 120 120 120 120 120 90 108 108 108 108 108 108 24 24 108 24 108 108 108 108 108 24 24 24 24
44 126 126 126 126 126 126 126 126 126 106 126 126 45 44 44 45 126 126 126 45 120 120 120 120 120 120 120 47 42 42 21 42 42 42 120 120 24 24 24 24 120 120 120 24 24 24 24 24 24 24 24 108 108 24 108 24 24 24 108 108 24 24 24
45 126 126 126 126 126 126 106 126 106 126 106 126 45 44 44 44 126 126 126 90 120 120 120 120 120 42 120 42 42 42 47 42 42 120 120 42 24 24 24 26 120 120 120 90 108 108 108 108 24 24 24 108 24 24 108 24 108 108 108 24 24 24 24
44 126 126 126 126 45 44 126 126 126 126 126 126 44 44 44 126 126 126 126 44 45 120 45 120 44 42 120 120 120 120 120 120 120 120 120 42 24 24 120 120 120 120 120 26 24 24 24 108 24 108 24 24 24 24 24 24 108 24 24 24 24 24 24
44 44 126 126 126 45 44 45 126 126 126 126 45 44 44 45 126 126 126 126 45 44 106 44 106 45 42 42 42 42 120 120 120 42 42 42 42 24 24 24 24 26 91 24 24 24 24 26 108 108 108 24 108 108 24 24 24 108 108 108 24 116 116 24
44 44 126 126 126 45 44 44 44 45 44 45 44 44 45 126 126 126 126 126 44 44 44 44 45 44 48 48 48 48 48 120 48 48 48 24 24 24 120 120 24 24 108 108 24 24 24 26 108 24 24 24 24 108 108 108 24 24 108 24 24 24 116 24
44 45 126 126 126 44 44 44 44 44 44 44 44 44 126 126 126 126 126 44 44 44 44 44 48 48 137 137 137 137 48 120 48 138 48 24 24 24 120 120 24 24 24 108 26 24 24 24 108 108 108 108 108 108 24 108 108 108 108 26 24 24 116 24
44 44 126 126 126 126 44 44 44 44 44 44 45 126 126 126 126 126 44 44 44 44 44 44 48 48 137 48 48 137 48 120 48 138 138 48 24 24 24 24 24 108 108 108 24 24 24 24 24 108 24 24 24 108 24 108 24 108 24 24 24 24 91 24
44 44 44 126 126 126 45 44 44 44 45 44 126 126 126 126 126 45 44 44 44 44 48 48 137 137 137 48 48 137 48 120 48 138 138 138 48 24 24 24 26 108 24 24 24 24 24 108 108 108 24 24 108 108 24 108 24 24 24 110 110 110 110 24
44 44 45 126 126 126 44 44 44 44 44 126 126 126 126 126 45 44 44 44 44 48 137 137 137 48 48 48 48 91 48 91 48 91 48 138 138 48 24 24 24 108 108 24 26 24 24 24 26 24 24 24 24 24 24 108 24 24 26 110 24 24 110 24
44 44 44 126 126 126 126 45 44 44 126 126 126 126 126 44 44 44 44 44 48 137 137 48 137 106 48 48 48 135 135 135 135 135 48 48 138 48 48 24 24 24 108 108 108 108 24 24 24 24 24 24 24 108 108 108 24 24 24 110 26 24 24 24
44 44 44 126 126 126 126 126 126 126 126 126 126 126 45 44 44 44 44 48 48 137 48 48 48 48 48 48 48 135 135 135 135 135 48 138 138 48 48 48 24 24 24 26 24 91 24 24 24 24 24 24 24 24 24 24 24 24 110 24 110 110 110 24
44 44 44 44 126 126 126 126 126 126 126 126 126 45 44 44 44 44 48 137 137 137 48 137 137 137 48 48 48 135 135 135 135 135 48 138 48 48 138 138 48 48 24 24 24 110 110 110 110 110 24 24 24 24 24 24 24 24 110 24 24 110 110 24
44 44 44 44 45 126 126 126 126 126 126 126 44 44 44 44 44 48 48 137 48 137 48 137 48 137 48 48 48 91 48 91 48 91 48 138 48 138 106 138 138 138 48 24 24 24 110 24 26 110 110 24 24 24 26 110 110 24 110 110 24 24 110 24
44 44 44 44 44 44 45 45 44 45 44 44 44 44 44 44 48 48 48 137 48 137 48 137 48 137 137 137 137 137 48 138 138 138 48 138 138 138 106 138 138 138 48 48 24 24 110 110 24 24 110 24 24 24 24 110 24 24 110 110 24 110 110 26
44 44 44 44 44 44 44 44 44 44 44 44 44 44 44 48 48 106 48 137 48 137 48 137 48 48 137 48 48 137 48 48 138 48 48 48 48 48 48 48 48 138 48 48 48 48 24 110 110 110 110 24 110 110 24 110 110 24 110 110 24 110 110 24
44 44 44 44 44 44 44 44 44 44 44 44 44 44 48 137 137 137 48 137 137 137 48 137 48 137 137 48 48 137 106 48 138 138 138 138 138 138 48 48 48 138 138 138 138 48 48 24 26 24 110 110 110 110 24 24 24 24 24 24 110 24 26 24
44 44 44 44 44 44 44 44 44 44 44 44 44 48 48 137 48 137 48 48 48 137 48 137 48 137 48 48 48 48 137 48 138 48 48 138 48 138 138 106 48 138 48 48 138 48 48 48 24 24 26 24 24 24 24 110 24 110 110 24 110 24 24 24
44 44 44 44 44 44 44 44 44 44 44 44 44 48 48 137 48 137 48 48 48 137 48 137 48 137 137 137 137 48 137 48 138 48 48 138 48 138 48 48 48 138 48 48 138 48 48 106 48 24 24 24 110 110 110 110 24 110 110 24 110 110 24 24
44 44 44 44 44 44 44 44 44 44 44 44 44 48 137 137 137 137 137 137 137 137 137 137 48 48 48 48 137 48 137 48 138 106 48 138 48 138 138 138 138 138 48 48 138 138 138 138 106 48 24 110 110 24 110 110 24 24 24 24 24 26 24 24
44 44 44 44 44 44 44 44 44 44 44 44 48 137 137 137 48 48 137 48 48 137 48 137 137 137 137 137 137 48 137 48 48 48 48 138 48 48 48 48 48 48 48 48 48 48 48 48 48 48 24 110 110 24 26 24 110 110 24 110 24 24 24 24
44 44 44 44 44 44 44 44 44 44 44 48 137 137 137 137 48 48 137 48 48 137 48 48 48 48 48 48 48 48 137 48 138 138 138 138 138 138 138 138 138 138 138 138 138 138 138 138 138 138 48 24 24 24 24 24 24 110 110 110 24 24 24 24
44 44 44 44 44 44 44 44 44 48 48 48 137 106 106 106 48 48 137 48 48 137 48 137 137 137 137 137 137 48 137 48 138 48 48 48 48 48 48 48 48 48 48 48 48 48 48 48 48 138 48 48 48 48 48 24 24 24 26 24 24 24 24 24
44 44 44 44 44 44 44 44 48 137 137 137 137 48 48 48 48 48 137 48 48 137 48 137 48 48 48 48 137 48 137 48 138 48 48 48 140 140 48 140 140 140 140 140 140 140 48 48 48 138 138 138 138 138 48 48 24 24 24 24 24 24 24 24
44 44 44 44 44 44 44 44 48 137 48 48 48 48 137 137 137 137 137 48 48 137 137 137 137 137 137 137 137 48 137 48 138 138 138 48 140 140 48 140 140 140 140 140 140 140 48 48 48 48 48 48 48 138 48 48 48 24 24 24 24 24 24 24
44 44 44 44 44 44 44 48 48 137 48 48 48 48 48 48 48 48 48 48 48 48 48 137 48 48 48 48 48 48 137 48 48 48 138 48 140 140 48 140 140 140 140 140 140 140 48 48 48 48 48 48 48 138 138 138 48 24 24 24 24 24 24 24
44 44 44 44 44 44 48 48 48 137 137 137 137 137 137 137 137 137 137 137 48 48 48 137 48 106 137 137 137 137 137 137 137 48 138 48 140 140 48 140 140 140 140 140 140 140 48 48 48 48 48 48 48 138 48 138 48 48 48 24 24 24 24 24
44 44 44 44 44 44 48 48 48 48 137 48 48 137 48 48 137 48 48 137 48 48 48 137 48 48 137 48 48 48 48 48 137 48 138 48 140 140 48 140 140 140 140 140 140 140 90 138 138 138 138 138 138 138 48 138 138 138 48 24 24 24 24 24
44 44 44 44 44 48 137 137 137 48 137 137 137 137 48 48 137 48 48 137 137 137 137 137 48 106 137 48 137 137 137 48 137 48 138 48 140 140 48 140 140 140 140 140 140 140 48 48 48 48 106 48 48 48 48 48 48 138 48 48 24 24 24 24
44 44 44 44 44 48 137 137 137 48 48 48 48 137 48 48 137 48 48 48 48 48 48 48 48 48 137 48 137 137 137 48 137 48 138 48 48 48 48 48 48 48 91 48 48 48 48 48 48 48 138 48 48 48 48 48 48 138 48 48 48 24 24 24
44 44 44 44 48 48 137 137 137 137 137 137 137 137 48 48 137 137 137 137 137 137 137 137 137 137 137 48 137 137 137 137 137 48 138 138 138 138 138 138 138 138 138 138 138 138 138 138 138 138 138 138 138 138 138 138 138 138 48 48 48 48 24 24
44 48 48 48 48 48 48 48 48 48 48 48 48 48 48 48 48 48 48 48 48 48 48 48 48 48 48 48 48 48 48 48 48 48 48 48 48 48 48 48 48 48 48 48 48 48 48 48 48 48 48 48 48 48 48 48 48 48 48 48 48 48 48 24
