1 1 1 1 1 27 1 1 1 1 1 27 1 2 1 1 1 2 1 1 1 1 1 1 1 1 1 1 1 1 1 1 1 1 1 1 1 1 1 1 1 1 1 1 1 1 1 1 1 1 1 1 1 1 1 1 1 1 1 1 1 1 1 1
1 1 13 1 1 116 1 106 1 116 2 116 1 106 1 106 1 106 1 27 4 2 1 1 2 2 2 1 2 2 2 2 1 2 2 1 2 2 1 1 1 2 1 1 2 1 1 1 2 2 1 2 2 1 2 2 2 2 1 2 1 4 1 1
1 1 116 116 2 116 1 116 2 116 1 116 1 116 2 116 1 116 1 4 108 108 108 108 108 108 108 108 108 108 108 108 108 108 108 108 108 108 108 108 108 108 108 108 108 108 108 108 108 108 108 108 108 108 108 108 108 108 108 108 108 108 4 1
1 1 1 116 116 116 116 116 116 116 116 116 116 116 116 116 116 116 116 1 108 108 108 108 108 108 108 108 108 108 108 108 108 108 108 108 108 108 108 108 108 108 108 108 108 108 108 108 108 108 108 108 108 108 108 108 108 108 108 108 108 108 2 1
1 2 116 116 1 116 1 116 2 116 1 116 2 116 1 116 1 116 2 1 108 108 1 1 2 2 2 2 2 1 1 1 1 1 2 2 1 1 1 2 1 2 1 1 1 1 1 1 2 1 1 1 1 1 1 2 1 2 1 1 108 108 1 1
1 1 1 116 116 116 116 116 116 116 116 116 116 116 116 116 116 116 116 27 108 108 2 109 109 109 109 109 109 109 109 109 109 109 109 109 109 109 109 109 109 109 109 109 109 109 109 109 109 109 109 109 109 109 109 2 139 139 139 2 108 108 1 1
1 1 116 116 2 116 1 116 1 116 2 116 2 116 1 116 2 116 1 1 108 108 1 109 109 109 109 109 109 109 109 109 109 109 109 109 109 109 109 109 109 109 109 109 109 109 109 109 109 109 109 109 109 109 109 2 139 139 139 1 108 108 1 1
1 1 1 116 116 116 116 116 116 116 116 116 116 116 116 116 116 116 116 27 108 108 1 109 109 1 4 1 1 2 1 1 1 2 2 2 1 1 1 1 2 1 1 1 1 2 2 1 1 1 1 2 1 1 91 1 2 139 139 1 108 108 1 1
1 27 116 116 1 116 2 116 1 116 1 116 1 116 1 116 1 116 2 1 108 108 1 109 109 4 110 110 110 110 110 110 110 110 110 110 110 110 110 110 110 110 110 110 110 110 110 110 110 110 110 110 110 110 110 110 1 139 139 1 108 108 1 1
1 1 1 2 1 116 1 116 1 106 1 106 2 116 1 106 2 116 27 27 108 108 2 109 109 1 110 110 110 110 110 110 110 110 110 110 110 110 110 110 110 110 110 110 110 110 110 110 110 110 110 110 110 110 110 110 90 139 139 2 108 108 1 1
1 1 1 1 1 1 1 27 1 1 1 2 1 27 1 1 1 91 1 1 108 108 2 109 109 1 110 110 1 4 1 2 2 2 2 2 1 1 1 1 1 2 1 1 1 1 2 1 2 1 2 1 4 2 110 110 2 139 139 2 108 108 2 1
1 1 1 106 1 115 1 115 1 106 1 115 1 115 1 106 1 115 27 1 108 108 2 109 109 2 110 110 4 111 111 111 111 111 111 111 111 111 111 111 111 111 111 111 111 111 111 111 111 111 111 111 111 4 110 110 1 139 139 1 108 108 1 1
1 1 2 115 1 115 1 115 1 115 1 115 1 115 1 115 2 115 2 1 108 108 2 109 109 1 110 110 1 111 111 111 111 111 111 111 111 111 111 111 111 111 111 111 111 111 111 111 111 111 111 111 111 2 110 110 2 139 139 1 108 108 1 1
1 27 115 115 115 115 115 115 115 115 115 115 115 115 115 115 115 115 115 1 108 108 2 109 109 1 110 110 90 111 111 2 1 1 2 1 1 2 1 1 2 1 2 2 2 1 2 2 2 2 1 111 111 2 110 110 1 139 139 1 108 108 2 1
1 3 115 1 115 2 115 1 115 27 115 1 115 27 115 1 115 2 115 27 108 108 2 109 109 1 1 1 1 111 111 1 112 112 112 112 112 112 112 112 112 112 112 112 112 112 112 112 112 112 2 111 111 1 110 110 1 139 139 1 1 1 2 1
1 1 115 115 115 115 115 115 115 115 115 115 115 115 115 115 115 115 115 1 108 108 2 109 109 90 140 140 1 111 111 2 112 112 112 112 112 112 112 112 112 112 112 112 112 112 112 112 112 112 2 1 2 1 110 110 1 139 139 1 138 138 2 1
1 1 1 115 1 115 27 115 1 115 1 115 1 115 27 115 1 115 2 1 108 108 2 109 109 1 140 140 2 111 111 1 112 112 2 1 2 1 1 2 2 2 2 1 2 1 2 1 112 112 2 141 141 90 110 110 2 139 139 2 138 138 2 1
1 1 115 115 115 115 115 115 115 115 115 115 115 115 115 115 115 115 115 1 108 108 1 109 109 1 140 140 1 111 111 1 112 112 1 113 113 113 113 113 113 113 113 113 113 113 113 1 112 112 2 141 141 1 110 110 2 139 139 1 138 138 1 1
1 3 115 27 115 2 115 1 115 2 115 1 115 2 115 1 115 27 115 1 108 108 1 109 109 1 140 140 1 111 111 1 112 112 1 113 113 113 113 113 113 113 113 113 113 113 113 2 112 112 2 141 141 2 110 110 1 139 139 1 138 138 1 1
1 1 115 115 115 115 115 115 115 115 115 115 115 115 115 115 115 115 115 27 108 108 1 109 109 1 140 140 1 111 111 2 112 112 2 113 113 2 2 2 1 1 1 2 1 113 113 1 112 112 1 141 141 1 110 110 1 139 139 1 138 138 2 1
1 2 115 27 115 1 115 27 115 27 115 1 115 1 115 1 115 1 115 1 108 108 2 109 109 2 140 140 1 111 111 1 112 112 1 113 113 1 1 1 1 21 3 114 1 113 113 2 112 112 1 1 1 1 110 110 2 139 139 90 138 138 1 1
1 1 115 1 106 1 115 1 115 1 115 27 115 1 115 1 115 1 1 27 108 108 1 109 109 1 140 140 2 111 111 1 112 112 2 113 113 2 2 2 21 114 100 114 1 113 113 2 112 112 90 111 111 2 110 110 1 139 139 1 138 138 1 1
1 1 91 1 1 27 27 1 1 2 1 1 27 1 1 27 2 27 1 27 108 108 1 109 109 1 140 140 1 111 111 1 112 112 1 113 113 1 114 106 1 21 3 114 2 113 113 1 112 112 1 111 111 1 110 110 1 139 139 1 138 138 2 1
1 1 108 108 108 108 108 108 108 108 108 108 108 108 108 108 108 108 108 108 108 108 1 109 109 1 140 140 1 111 111 1 112 112 1 113 113 2 114 1 1 2 2 114 1 113 113 1 112 112 1 111 111 1 110 110 1 139 139 1 138 138 2 1
1 1 108 108 108 108 108 108 108 108 108 108 108 108 108 108 108 108 108 108 108 108 1 109 109 2 140 140 1 111 111 1 112 112 1 113 113 2 114 114 2 114 114 114 1 113 113 1 112 112 2 111 111 1 110 110 1 139 139 2 138 138 1 1
1 1 1 2 1 1 2 1 1 1 2 2 1 1 2 1 1 2 2 2 108 108 1 109 109 1 140 140 1 111 111 1 112 112 2 113 113 1 114 1 1 2 114 114 1 113 113 2 112 112 1 111 111 2 110 110 2 139 139 2 138 138 1 1
1 1 108 108 108 108 108 108 108 2 108 108 108 108 108 108 108 108 2 1 108 108 1 109 109 1 140 140 2 111 111 1 112 112 1 113 113 1 114 114 106 1 114 114 2 113 113 1 112 112 1 111 111 1 110 110 1 139 139 1 138 138 2 1
1 2 108 108 108 108 108 108 108 2 108 108 108 108 108 108 108 108 2 2 108 108 1 109 109 1 140 140 1 111 111 1 112 112 2 113 113 1 114 114 106 2 114 114 1 113 113 1 112 112 1 111 111 1 110 110 1 139 139 1 138 138 2 1
1 2 108 108 108 108 108 108 108 2 108 108 108 108 108 108 108 108 1 1 108 108 2 109 109 1 140 140 1 111 111 2 112 112 1 113 113 2 114 2 2 1 114 114 1 113 113 1 112 112 2 111 111 1 110 110 1 139 139 1 138 138 1 1
1 2 2 2 108 108 108 108 108 1 108 2 108 2 108 108 108 108 2 2 108 108 1 109 109 2 140 140 1 111 111 2 112 112 1 113 113 1 114 114 2 2 114 114 1 113 113 2 112 112 1 111 111 1 110 110 2 139 139 1 138 138 1 1
1 2 108 108 108 108 108 108 108 2 108 2 108 2 108 108 108 108 1 2 108 108 2 109 109 2 140 140 1 111 111 1 112 112 1 113 113 1 114 114 2 106 114 114 2 113 113 2 112 112 1 111 111 2 110 110 1 139 139 1 138 138 2 1
1 1 108 108 108 108 108 108 108 1 108 108 108 108 108 108 108 108 1 1 108 108 1 109 109 2 140 140 2 111 111 1 112 112 1 113 113 1 114 1 2 1 2 114 1 113 113 1 112 112 1 111 111 1 110 110 1 139 139 1 138 138 2 1
1 1 2 1 1 2 2 1 1 2 2 1 1 2 1 1 2 1 1 2 108 108 1 109 109 1 140 140 1 111 111 2 112 112 1 113 113 2 114 114 1 106 114 114 1 113 113 2 112 112 2 111 111 1 110 110 1 139 139 1 138 138 1 1
1 2 106 106 108 108 1 2 108 108 108 108 108 108 106 106 1 1 1 1 108 108 1 109 109 1 140 140 1 111 111 2 112 112 2 113 113 1 114 114 2 1 1 114 2 113 113 2 112 112 2 111 111 1 110 110 2 139 139 1 138 138 1 1
2 1 108 108 108 108 1 1 108 108 108 106 108 108 108 108 1 1 1 1 108 108 2 109 109 1 140 140 1 111 111 1 112 112 1 113 113 1 114 114 2 114 114 114 2 113 113 2 112 112 2 111 111 1 110 110 1 139 139 2 138 138 2 1
1 1 108 108 1 1 1 2 108 108 1 2 2 1 108 108 2 1 1 2 108 108 1 109 109 1 140 140 1 111 111 1 112 112 1 113 113 2 114 1 1 3 93 3 1 113 113 1 112 112 2 111 111 1 110 110 1 139 139 1 138 138 2 1
1 2 108 108 1 1 1 1 106 106 1 1 1 1 108 106 1 1 1 1 108 108 1 109 109 2 140 140 2 111 111 2 112 112 1 113 113 1 114 114 114 114 114 114 2 113 113 2 112 112 2 111 111 2 110 110 1 139 139 1 138 138 1 1
1 2 108 108 1 1 2 2 108 108 2 1 1 2 108 108 2 1 1 2 108 108 1 109 109 1 140 140 2 111 111 2 112 112 2 113 113 1 2 114 2 1 2 1 2 113 113 2 112 112 2 111 111 1 110 110 2 139 139 1 138 138 1 1
1 1 108 108 108 106 108 108 108 108 2 2 1 2 108 108 2 1 1 1 108 108 2 109 109 1 140 140 1 111 111 1 112 112 2 113 113 2 114 114 1 114 114 114 90 113 113 2 112 112 1 111 111 1 110 110 2 139 139 2 138 138 1 1
1 1 108 108 108 108 108 108 108 108 1 2 106 108 108 108 1 1 1 1 108 108 2 109 109 1 140 140 1 111 111 1 112 112 1 113 113 1 114 114 2 114 114 114 1 2 1 2 112 112 1 111 111 1 110 110 1 139 139 1 138 138 2 1
1 2 1 2 1 2 1 2 2 2 2 2 1 2 1 1 2 1 1 1 108 108 1 109 109 2 140 140 2 111 111 1 112 112 2 113 113 1 114 114 2 1 2 114 2 143 143 1 112 112 2 111 111 1 110 110 1 139 139 1 138 138 1 1
1 2 108 108 108 108 2 2 108 108 108 108 106 108 108 108 1 1 1 2 108 108 1 109 109 1 140 140 2 111 111 1 112 112 90 113 113 2 114 114 2 106 1 114 1 143 143 90 112 112 2 111 111 2 110 110 1 139 139 1 138 138 1 1
1 1 108 108 108 108 2 1 108 108 108 108 108 108 108 108 1 1 1 1 108 108 1 109 109 1 140 140 1 111 111 2 112 112 1 113 113 2 114 114 1 114 2 114 1 143 143 1 112 112 1 111 111 1 110 110 2 139 139 2 138 138 1 1
1 2 106 108 1 1 2 1 106 106 1 2 2 1 108 108 2 1 1 1 108 108 2 109 109 1 140 140 1 111 111 1 112 112 2 113 113 1 114 1 2 106 1 114 1 143 143 1 4 4 1 111 111 1 110 110 1 139 139 1 138 138 2 1
1 1 108 106 2 1 1 2 108 108 1 1 1 2 106 108 2 1 1 1 108 108 1 109 109 1 140 140 1 111 111 1 112 112 2 113 113 2 114 114 114 114 114 114 2 143 143 1 142 142 90 111 111 1 110 110 2 139 139 1 138 138 2 1
1 2 1 108 2 1 2 1 108 108 2 1 1 1 108 108 2 1 1 2 108 108 1 109 109 2 140 140 1 111 111 2 112 112 1 113 113 1 1 1 1 1 1 1 1 143 143 1 142 142 1 111 111 2 110 110 1 139 139 1 138 138 1 1
1 2 108 108 108 108 108 108 108 106 1 2 108 108 108 108 1 1 1 1 108 108 2 109 109 2 140 140 1 111 111 1 1 2 1 113 113 113 113 113 1 143 143 143 143 143 143 2 142 142 2 111 111 2 110 110 1 139 139 1 138 138 1 1
1 1 108 108 108 108 108 108 108 108 2 2 108 108 108 108 1 1 1 2 108 108 1 109 109 1 140 140 1 111 111 90 142 142 4 113 113 113 113 113 1 143 143 143 143 143 143 1 142 142 2 111 111 1 110 110 1 139 139 2 138 138 1 1
1 2 1 1 2 1 1 2 2 1 1 1 1 2 2 1 1 1 1 2 108 108 2 109 109 1 140 140 1 111 111 1 142 142 4 4 1 2 1 1 2 2 1 91 2 1 2 1 142 142 1 111 111 1 110 110 2 139 139 1 138 138 1 1
1 1 108 108 1 1 1 1 1 1 1 1 1 1 1 1 1 2 2 1 108 108 2 109 109 2 140 140 2 111 111 2 142 142 142 142 142 142 142 142 142 142 142 142 142 142 142 142 142 142 2 111 111 1 110 110 1 139 139 1 138 138 1 1
1 2 1 108 108 108 1 1 108 1 1 2 1 1 2 1 108 108 108 1 108 108 1 109 109 1 140 140 1 111 111 1 142 142 142 142 142 142 142 142 142 142 142 142 142 142 142 142 142 142 2 111 111 1 110 110 1 139 139 1 138 138 2 1
1 1 1 1 108 108 108 108 108 108 108 108 108 108 108 108 108 108 108 1 108 108 2 109 109 1 140 140 1 111 111 1 2 1 2 1 1 91 1 1 2 2 2 1 1 1 1 2 1 1 2 111 111 2 110 110 90 139 139 1 138 138 1 1
1 1 1 2 108 108 108 108 106 1 2 1 2 1 108 2 1 2 1 1 108 108 1 109 109 1 140 140 2 111 111 111 111 111 111 111 111 111 111 111 111 111 111 111 111 111 111 111 111 111 111 111 111 2 110 110 1 139 139 1 138 138 1 1
1 2 1 1 108 108 106 108 108 108 108 1 2 108 108 108 1 1 1 2 108 108 1 109 109 2 140 140 2 111 111 111 111 111 111 111 111 111 111 111 111 111 111 111 111 111 111 111 111 111 111 111 111 2 110 110 1 139 139 2 138 138 1 1
1 1 1 108 108 108 1 1 108 108 108 1 1 108 2 108 1 1 1 1 108 108 2 109 109 1 140 140 1 1 91 1 1 1 2 1 2 2 1 1 1 2 1 1 1 1 2 1 1 1 1 2 1 1 110 110 2 1 2 2 138 138 2 1
1 1 108 108 1 1 2 1 1 2 1 1 1 1 1 2 1 1 1 1 108 108 2 109 109 1 140 140 140 4 110 110 110 110 110 110 110 110 110 110 110 110 110 110 110 110 110 110 110 110 110 110 110 110 110 110 4 109 109 4 138 138 4 1
1 1 1 1 1 1 1 1 1 1 1 1 1 1 1 1 1 1 1 2 108 108 2 109 109 1 140 140 140 1 110 110 110 110 110 110 110 110 110 110 110 110 110 110 110 110 110 110 110 110 110 110 110 110 110 110 1 109 109 1 138 138 1 1
1 1 1 1 1 1 1 1 1 1 1 1 1 1 1 1 1 1 1 2 108 108 1 109 109 2 1 91 1 2 1 1 1 2 2 1 1 1 2 2 2 1 1 1 2 1 1 1 1 2 1 2 1 2 2 1 1 109 109 2 138 138 1 1
1 1 1 1 1 1 1 1 1 1 1 1 1 1 1 1 1 1 1 1 108 108 2 109 109 109 109 109 109 109 109 109 109 109 109 109 109 109 109 109 109 109 109 109 109 109 109 109 109 109 109 109 109 109 109 109 109 109 109 1 1 1 1 1
1 1 1 1 1 1 1 1 1 1 1 1 1 1 1 1 1 1 1 1 108 108 1 109 109 109 109 109 109 109 109 109 109 109 109 109 109 109 109 109 109 109 109 109 109 109 109 109 109 109 109 109 109 109 109 109 109 109 109 4 106 106 2 1
1 1 1 1 1 1 1 1 1 1 1 1 1 1 1 1 1 1 1 1 108 108 1 2 1 1 1 2 1 1 1 2 2 1 1 1 1 1 2 1 1 1 1 2 1 91 1 2 1 1 1 2 2 2 1 1 2 2 4 2 108 108 2 1
1 1 1 1 1 1 1 1 1 1 1 1 1 1 1 1 1 1 1 1 108 108 108 108 108 108 108 108 108 108 108 108 108 108 108 108 108 108 108 108 108 108 108 108 108 108 108 108 108 108 108 108 108 108 108 108 108 108 108 108 108 108 2 1
1 1 1 1 1 1 1 1 1 1 1 1 1 1 1 1 1 1 1 2 108 108 108 108 108 108 108 108 108 108 108 108 108 108 108 108 108 108 108 108 108 108 108 108 108 108 108 108 108 108 108 108 108 108 108 108 108 108 108 108 108 108 2 1
1 1 1 1 1 1 1 1 1 1 1 1 1 1 1 1 1 1 1 2 1 2 2 1 2 2 2 2 1 1 1 1 2 1 1 1 1 1 1 1 1 1 2 1 1 2 2 2 1 1 1 1 2 2 2 2 2 2 2 2 2 1 2 1
