1 1 1 1 1 1 6 1 1 2 3 2 2 1 1 2 1 1 1 1 1 1 1 1 1 21 1 1 1 1 1 1 1 1 1 1 1 1 1 1 1 1 1 1 1 1 1 1 1 1 1 1 1 1 1 1 1 1 1 1 1 1 1 1
1 1 1 1 1 136 136 136 2 108 108 108 108 108 108 108 108 3 1 1 1 137 137 137 100 107 21 1 1 1 1 1 1 1 1 1 1 1 1 1 1 1 1 1 1 1 1 1 1 1 1 1 1 1 1 1 1 1 1 1 1 1 1 1
1 1 1 1 2 136 136 136 27 108 108 108 108 108 108 108 108 13 1 1 1 137 137 1 1 21 1 1 17 17 17 17 17 17 17 17 17 17 17 1 1 1 1 1 1 1 1 1 1 1 1 1 1 1 1 1 1 1 1 1 1 1 1 1
1 1 3 1 1 136 136 136 1 108 108 108 108 108 108 108 108 3 1 1 1 1 2 1 1 2 1 1 17 17 17 38 17 17 17 17 17 17 17 1 1 1 1 1 1 1 1 1 1 1 1 1 1 1 1 1 1 1 1 1 1 1 1 1
1 108 108 108 2 136 136 136 2 108 108 108 2 1 27 1 2 1 1 1 27 137 137 137 137 137 137 2 17 17 114 114 114 17 114 114 17 17 17 1 1 1 1 1 1 1 1 1 1 1 17 17 17 17 17 17 17 1 1 1 1 1 1 1
2 108 108 108 27 136 136 136 2 108 108 108 2 1 1 2 27 1 137 137 137 137 137 137 137 137 137 1 17 38 114 114 114 17 114 114 114 17 17 1 1 1 1 1 1 1 1 1 1 1 17 114 114 114 114 114 17 1 1 1 1 1 1 1
27 108 108 108 1 1 136 1 2 108 108 108 92 137 137 137 137 137 137 1 1 137 137 137 137 137 137 2 17 17 114 114 114 17 114 114 114 38 17 1 1 17 17 20 17 17 17 20 17 17 17 114 114 114 114 114 17 1 1 1 1 1 1 1
2 108 108 108 2 1 136 1 1 108 108 108 1 1 1 1 1 1 1 1 1 1 1 2 1 1 2 2 17 17 17 114 114 114 114 114 114 17 17 1 1 17 114 114 114 114 114 114 114 114 17 114 17 17 114 114 17 1 1 1 1 1 1 1
1 108 108 108 1 1 93 2 1 108 108 108 2 1 1 27 2 1 27 1 1 1 1 1 1 1 1 1 17 17 114 114 114 114 114 114 114 17 17 1 1 20 114 114 114 114 114 114 114 114 18 114 114 17 114 114 17 1 1 1 1 1 1 1
1 108 108 108 108 108 106 108 108 108 108 108 108 108 108 108 108 108 108 108 12 12 12 12 12 12 12 12 12 12 17 17 38 17 17 38 17 17 1 1 1 17 114 114 114 114 114 114 114 114 17 114 17 17 114 114 17 1 1 1 1 1 1 1
3 108 108 108 108 108 108 108 108 108 108 108 108 108 108 108 108 108 108 108 12 111 111 111 111 111 111 111 111 11 114 114 114 114 114 114 114 17 1 1 1 38 114 114 114 17 17 20 17 38 17 114 114 114 114 114 17 1 1 1 1 1 1 1
1 108 108 108 108 108 108 108 108 108 108 108 108 108 108 108 108 108 108 108 12 111 111 111 111 111 111 111 111 90 114 114 114 114 114 114 114 38 1 1 1 17 114 114 114 17 1 1 1 1 17 114 114 114 114 114 17 1 1 1 1 1 1 1
1 2 2 27 1 2 108 1 1 108 108 108 12 12 11 12 12 108 108 108 12 111 111 111 111 111 111 111 111 11 114 114 114 114 114 114 114 17 1 1 1 20 114 114 114 20 1 1 1 1 17 17 17 17 17 17 17 1 1 1 1 1 1 1
1 1 1 1 1 1 91 1 2 108 108 108 12 111 111 106 12 106 108 108 12 111 111 111 12 12 12 12 12 12 38 17 17 17 114 114 114 17 1 1 1 17 114 114 114 17 1 1 1 1 1 1 1 1 1 1 1 1 1 1 1 1 1 1
1 1 1 1 138 138 138 1 3 108 108 108 12 111 111 111 11 108 108 108 12 111 111 111 12 111 111 111 111 12 12 12 12 17 106 114 114 17 17 18 17 17 114 114 114 17 17 17 38 17 17 17 17 17 1 1 1 1 1 1 1 1 1 1
1 1 1 1 138 138 138 1 2 108 108 108 12 111 111 111 90 108 108 108 12 111 111 111 11 111 111 12 111 111 111 111 12 17 114 114 114 114 114 114 114 114 114 114 114 114 114 114 114 114 114 114 114 17 1 1 1 1 1 1 1 1 1 1
1 1 1 1 1 2 1 27 1 108 108 108 12 111 111 111 11 108 108 108 12 111 111 111 12 12 12 12 111 111 111 111 12 20 114 114 114 114 114 114 114 114 114 114 114 114 114 114 114 114 114 114 114 17 1 1 1 1 1 1 1 1 1 1
1 1 1 1 108 108 108 108 108 108 108 108 12 111 111 111 12 12 11 12 12 111 111 111 12 12 12 12 12 12 12 12 12 17 114 114 114 114 114 114 114 114 114 114 114 114 114 114 114 114 114 114 114 17 1 1 1 1 1 1 1 1 1 1
1 1 1 3 108 108 108 108 108 108 108 108 11 111 111 111 111 111 111 106 111 111 111 111 111 111 111 111 111 111 111 111 12 17 17 17 17 17 17 17 17 17 114 114 114 17 17 18 17 17 114 114 114 17 1 1 1 1 1 1 1 1 1 1
1 1 1 2 108 108 108 108 108 108 108 108 12 111 111 111 111 111 111 111 111 111 111 111 111 111 111 111 111 111 111 111 12 109 109 109 109 109 109 109 109 17 114 114 114 17 1 1 1 17 114 114 114 38 1 1 1 1 1 1 1 1 1 1
1 1 1 1 1 2 1 27 2 1 3 1 12 111 111 111 111 111 111 111 111 111 111 111 111 111 111 111 111 111 111 111 12 109 109 109 109 109 109 109 109 20 114 114 114 20 1 1 1 20 114 114 114 20 1 1 1 1 1 1 1 1 1 1
1 1 1 1 1 1 1 1 1 1 1 8 12 12 12 12 12 12 12 12 12 111 111 111 12 12 11 12 12 111 111 111 12 109 109 109 109 109 109 109 106 17 114 114 114 17 1 1 1 17 114 114 114 17 1 1 1 1 1 1 1 1 1 1
1 1 1 1 1 1 1 1 1 8 8 8 113 113 113 113 113 113 113 113 12 111 111 111 12 109 109 109 12 111 111 111 12 109 109 109 17 18 91 18 17 17 114 114 114 17 1 1 1 17 114 114 114 17 1 1 1 1 1 1 1 1 1 1
1 1 1 1 1 1 1 1 1 8 8 9 113 113 113 113 113 113 113 113 23 111 111 111 12 109 109 109 12 111 111 111 12 109 109 109 17 114 114 114 114 114 114 114 114 17 1 1 1 17 17 20 17 17 1 1 1 1 1 1 1 1 1 1
1 1 1 8 9 8 9 8 8 8 8 8 113 113 113 113 106 113 113 113 12 111 111 111 12 109 109 109 12 111 111 111 12 109 109 109 17 114 114 114 114 114 114 114 114 38 1 1 1 1 1 1 1 1 1 1 1 1 1 1 1 1 1 1
1 1 1 8 113 113 113 8 8 8 8 9 113 113 113 12 12 12 11 91 11 111 111 111 12 109 109 109 12 111 111 111 12 109 109 109 17 114 114 114 114 114 114 114 114 17 1 1 1 1 1 1 1 1 1 1 1 1 1 1 1 1 1 1
1 1 1 9 113 113 113 9 8 8 8 9 113 113 113 11 111 111 111 111 111 111 111 111 12 109 109 109 12 12 11 12 12 109 109 109 17 38 17 17 17 17 17 17 17 17 1 1 1 1 1 1 1 1 1 1 1 1 1 1 1 1 1 1
1 1 1 8 113 113 113 8 8 8 8 9 113 113 113 90 111 111 111 111 111 111 111 111 12 109 109 109 109 109 109 109 109 109 109 109 109 109 109 109 109 109 109 109 32 27 1 27 2 27 4 1 27 27 1 1 27 1 1 1 1 1 1 1
1 1 1 8 113 113 113 9 8 8 8 8 113 113 113 11 111 111 111 111 111 111 111 111 12 109 109 109 109 109 109 109 109 109 109 109 109 109 109 109 109 109 109 109 29 110 110 110 110 110 110 110 110 2 1 1 1 1 2 1 1 1 1 1
1 1 1 9 113 113 113 8 9 8 9 8 113 113 113 12 12 12 12 12 12 12 12 12 12 109 109 109 109 109 109 109 109 109 109 109 109 109 109 109 109 109 109 109 29 110 110 110 110 110 110 110 110 4 1 1 35 35 35 35 35 1 1 1
1 1 1 8 113 113 113 113 113 113 113 113 113 113 113 113 106 113 113 113 113 113 113 8 8 29 29 30 29 29 29 29 29 109 109 109 29 29 29 29 29 109 109 109 29 110 110 110 110 110 110 110 110 27 1 1 35 141 141 141 35 35 35 35
1 1 1 9 113 113 113 113 113 113 113 113 113 113 113 113 113 113 113 113 113 113 113 8 8 29 29 29 29 29 29 29 29 109 109 109 29 110 110 110 29 109 109 109 29 110 110 110 27 27 4 27 2 27 1 1 37 141 141 141 37 141 141 35
1 1 1 8 113 113 113 113 113 113 113 113 113 113 113 113 113 113 113 113 113 113 113 9 8 8 29 29 29 29 29 29 29 109 109 109 29 110 110 110 29 109 109 109 29 110 110 110 2 1 1 1 1 1 1 1 35 141 141 141 35 35 35 35
1 1 1 8 9 9 8 9 9 8 9 8 113 113 113 8 9 8 9 8 113 113 113 8 8 8 29 29 29 29 29 29 31 109 109 109 29 110 110 110 29 109 109 109 29 110 110 110 3 1 1 1 1 1 27 1 35 35 91 35 35 1 1 1
1 1 1 1 1 1 1 1 1 1 1 8 113 113 113 9 1 1 1 9 113 113 113 9 8 8 29 29 29 29 29 29 29 109 109 109 29 110 110 110 29 109 109 109 29 110 110 110 27 1 1 1 1 1 1 1 1 110 110 1 1 1 1 1
1 1 1 1 1 1 1 1 1 1 1 9 113 113 113 9 1 1 1 8 113 113 113 8 8 8 29 109 109 109 109 109 109 109 109 109 29 110 110 110 29 29 95 29 29 110 110 110 1 1 4 2 27 1 2 27 1 110 27 110 110 1 1 1
1 1 1 1 1 1 1 1 1 1 1 8 113 113 113 8 1 1 1 9 113 113 113 9 8 8 32 109 109 109 109 109 109 109 109 109 29 110 110 110 110 110 110 106 110 110 110 110 110 106 110 110 110 110 110 110 27 1 1 27 1 1 1 1
1 1 1 1 1 1 8 9 8 8 9 8 113 113 113 9 1 1 1 8 113 113 113 8 8 9 29 109 109 109 109 109 109 109 109 109 29 110 110 110 110 110 110 110 110 110 110 110 110 110 110 110 110 110 110 110 2 110 110 1 1 1 1 1
1 1 1 1 1 1 8 113 113 113 113 113 113 113 113 8 1 1 1 9 41 91 41 8 119 119 29 29 91 29 29 29 29 29 29 29 31 110 110 110 110 110 110 110 110 110 110 110 110 110 110 110 110 110 110 110 27 1 1 1 1 1 1 1
1 1 1 1 1 1 41 113 113 113 113 113 113 113 113 9 1 1 1 2 119 119 119 119 119 119 119 119 119 119 119 119 119 119 119 4 27 27 2 2 27 27 2 27 2 110 110 110 1 27 3 27 1 110 110 110 2 1 1 1 1 1 1 1
1 1 1 1 1 1 8 113 113 113 113 113 113 113 113 8 1 1 1 3 119 119 119 119 119 119 119 119 119 119 119 119 119 119 119 90 112 112 112 112 112 112 112 112 27 110 110 110 27 1 1 1 27 106 110 110 27 1 1 1 27 1 1 1
1 1 1 1 1 1 8 91 8 8 9 8 9 8 8 9 1 1 1 1 119 119 119 119 119 119 119 119 119 119 119 119 119 119 119 4 112 112 112 112 112 112 112 112 3 110 110 110 4 1 1 1 4 110 110 110 4 21 1 2 115 115 1 1
1 1 1 1 1 1 1 116 116 106 116 116 116 116 116 1 1 1 1 1 2 1 2 2 1 1 1 3 2 1 2 1 2 1 1 1 106 112 112 112 112 112 112 112 27 110 110 110 2 1 1 1 27 110 110 110 100 110 21 1 115 115 1 1
1 1 1 1 1 1 2 116 116 116 116 116 116 116 116 2 1 1 1 1 1 1 1 1 1 1 2 1 112 112 112 2 1 1 1 2 112 112 112 27 27 2 27 2 2 110 110 110 27 1 1 1 27 110 110 110 4 21 1 1 1 115 27 1
1 1 1 1 1 1 1 2 116 116 116 116 116 116 2 1 1 1 1 1 1 1 1 1 1 1 1 2 112 112 112 1 1 1 1 2 112 112 112 27 110 110 110 110 110 110 110 110 27 1 1 1 27 1 110 27 27 1 1 1 115 115 1 1
1 1 1 1 1 1 1 3 116 116 116 116 116 116 3 1 1 1 1 1 2 1 3 1 3 2 1 1 112 112 112 2 1 1 1 4 112 112 112 4 110 110 110 110 110 110 110 110 2 1 1 1 2 110 110 110 1 106 115 115 115 1 1 1
1 1 1 1 1 1 1 1 116 116 116 116 116 116 2 1 1 1 1 2 115 106 115 115 115 115 115 2 112 112 112 1 1 1 1 1 112 112 112 2 110 110 110 110 110 110 110 110 27 1 1 1 1 1 91 2 2 27 115 115 1 1 1 1
1 1 1 1 1 1 2 116 116 116 116 116 116 116 116 1 1 1 1 1 115 115 106 115 106 115 115 1 112 112 112 1 2 3 2 1 112 112 112 27 1 27 2 2 27 27 2 27 27 1 1 1 106 115 115 1 1 115 115 1 1 1 1 1
1 1 1 1 1 1 1 116 116 116 116 116 116 116 116 2 1 1 1 2 115 115 115 115 115 115 106 2 112 112 112 112 112 112 112 112 112 112 112 112 112 112 112 112 112 112 112 1 1 1 1 1 115 1 2 1 2 115 115 1 1 1 1 1
1 1 1 1 1 1 1 2 1 91 2 2 1 2 1 2 1 1 1 2 106 115 115 115 115 115 115 1 112 112 112 112 112 112 112 112 112 112 112 112 112 112 112 112 112 112 112 2 1 1 1 1 115 115 115 1 115 115 2 1 1 1 1 1
1 1 1 1 1 1 1 1 118 118 1 1 1 1 1 1 1 1 1 1 115 115 115 115 115 115 115 1 112 112 112 112 112 112 112 112 112 112 112 112 112 112 112 112 112 112 112 1 1 1 1 1 1 1 115 115 115 1 1 1 1 1 1 1
1 1 1 1 1 1 1 1 118 118 118 106 118 118 118 118 118 118 118 90 115 115 115 115 115 115 115 1 1 2 2 1 2 3 1 1 112 112 112 2 1 1 1 2 112 112 112 1 1 1 1 1 1 1 115 115 1 1 1 1 1 1 1 1
1 1 1 1 1 1 1 2 118 118 118 118 118 118 118 118 118 118 118 1 2 1 4 1 1 115 115 2 1 1 1 1 1 1 1 2 112 112 112 1 1 1 1 1 112 112 112 2 1 1 1 1 1 115 115 2 1 1 1 1 1 1 1 1
1 1 1 1 1 1 1 1 118 118 1 1 2 1 1 1 2 1 2 1 1 1 1 1 2 115 115 1 1 1 1 1 1 1 1 2 112 112 112 2 1 1 1 1 112 112 112 1 1 1 2 1 115 115 1 1 1 1 1 1 1 1 1 1
1 1 1 1 1 1 1 2 118 118 1 1 1 1 1 1 1 1 1 1 1 1 1 1 1 115 115 2 1 1 1 1 1 1 1 2 112 112 112 2 1 1 1 2 112 112 112 2 1 1 1 115 115 2 1 1 1 1 1 1 1 1 1 1
1 1 1 1 1 2 1 1 1 2 2 1 1 1 1 1 1 1 1 1 1 1 1 1 2 115 115 1 1 1 1 2 2 2 1 1 112 112 112 1 1 1 1 1 112 112 112 2 1 2 115 115 1 1 1 1 1 1 1 1 1 1 1 1
1 1 1 2 118 118 118 2 118 118 118 118 1 1 1 1 1 1 1 1 1 1 1 1 2 115 115 115 115 1 1 112 112 112 106 112 112 112 112 1 1 1 1 1 1 1 1 1 1 115 115 2 1 1 1 1 1 1 1 1 1 1 1 1
1 1 1 2 118 118 118 1 118 118 118 118 2 1 1 1 1 1 1 1 1 1 1 1 1 115 115 115 115 1 2 112 112 112 112 112 112 112 112 2 1 1 1 1 1 1 1 1 115 115 1 1 1 1 1 1 1 1 1 1 1 1 1 1
1 1 1 2 118 118 118 2 1 118 118 118 1 1 1 1 1 1 1 1 1 1 1 1 2 2 2 115 115 1 2 112 112 112 112 112 112 112 112 2 1 1 1 1 1 1 1 115 115 1 1 1 1 1 1 1 1 1 1 1 1 1 1 1
1 1 1 1 118 118 118 118 118 118 118 118 2 1 1 1 1 1 1 1 1 1 1 1 1 1 2 115 115 1 1 1 2 1 2 2 1 2 1 1 1 1 1 1 1 1 115 115 2 1 1 1 1 1 1 1 1 1 1 1 1 1 1 1
1 1 1 1 118 118 118 118 118 118 118 118 1 1 1 1 1 1 1 1 1 1 1 1 1 1 1 115 115 115 115 115 115 115 115 115 115 115 115 115 115 115 115 115 115 115 115 2 1 1 1 1 1 1 1 1 1 1 1 1 1 1 1 1
1 1 1 2 118 118 118 118 118 118 118 118 2 1 1 1 1 1 1 1 1 1 1 1 1 1 1 1 1 2 1 2 2 1 2 1 1 1 1 2 2 2 1 1 1 1 1 2 1 1 1 1 1 1 1 1 1 1 1 1 1 1 1 1
1 1 1 2 118 118 118 118 118 118 118 118 1 1 1 1 1 1 1 1 1 1 1 1 1 1 1 1 1 1 1 1 1 1 1 1 1 1 1 1 1 1 1 1 1 1 1 1 1 1 1 1 1 1 1 1 1 1 1 1 1 1 1 1
1 1 1 1 1 1 2 2 1 1 2 1 1 1 1 1 1 1 1 1 1 1 1 1 1 1 1 1 1 1 1 1 1 1 1 1 1 1 1 1 1 1 1 1 1 1 1 1 1 1 1 1 1 1 1 1 1 1 1 1 1 1 1 1
