1 1 1 2 1 1 1 1 1 1 1 1 1 1 1 1 1 1 1 1 1 1 1 1 1 1 1 1 1 1 1 1 1 1 1 1 1 1 1 1 1 1 1 1 1 1 1 1 1 1 1 1 1 1 1 1 1 1 1 1 1 1 1 1
1 108 108 108 108 108 108 1 108 108 108 1 1 1 1 1 1 1 1 1 1 1 1 1 1 1 1 1 1 1 1 1 1 1 1 1 1 1 1 1 1 1 1 1 1 1 1 1 1 1 1 1 1 1 1 1 1 1 1 1 1 1 1 1
13 108 108 108 108 2 108 108 108 1 108 106 1 1 1 1 1 1 35 35 35 35 35 35 35 35 35 35 35 35 1 1 1 1 1 1 1 1 1 1 1 1 1 1 1 1 1 1 1 1 1 1 1 1 1 1 1 1 1 1 1 1 1 1
2 108 108 108 1 1 1 2 1 1 1 1 1 1 1 1 1 1 35 35 35 35 35 39 37 35 35 35 35 35 1 1 1 1 1 1 1 1 1 1 1 1 1 1 1 1 1 1 1 1 1 1 1 1 1 1 1 1 1 1 1 1 1 1
2 108 108 108 3 106 108 108 108 2 1 1 1 1 1 1 1 1 35 35 35 35 35 116 116 116 35 35 35 35 1 1 1 1 1 1 1 1 1 1 1 1 1 1 1 1 1 1 1 1 1 1 1 1 1 1 1 1 1 1 1 1 1 1
1 108 108 108 90 108 108 108 108 3 1 1 1 1 1 1 1 1 35 35 35 35 116 106 116 106 116 35 35 35 1 1 1 1 1 1 1 1 1 1 1 1 1 1 1 1 1 1 1 1 1 1 1 1 1 1 1 1 1 1 1 1 1 1
1 108 108 108 3 108 108 108 108 1 3 2 1 1 1 1 1 1 21 49 116 116 116 15 116 15 116 116 35 35 1 1 1 1 1 1 1 1 1 1 1 1 1 1 1 1 1 1 1 1 1 1 1 1 1 1 1 1 1 1 1 1 1 1
1 1 1 1 2 108 108 108 108 108 108 108 106 2 1 1 1 21 139 100 116 116 116 106 116 106 116 116 116 33 1 1 1 1 1 1 1 1 1 1 1 1 1 1 1 1 1 1 1 1 1 1 1 1 1 1 1 1 1 1 1 1 1 1
1 1 1 1 1 108 108 108 108 108 108 108 108 2 1 1 1 1 21 49 106 116 116 15 116 15 116 116 35 35 1 1 1 1 1 1 1 1 1 1 1 1 1 1 1 1 1 1 1 1 1 1 1 1 1 1 1 1 1 1 1 1 1 1
1 1 1 1 1 1 2 1 2 108 108 108 108 4 1 1 1 1 35 35 35 35 116 116 116 116 116 35 35 35 1 1 1 1 1 1 1 1 1 1 1 1 1 1 1 1 1 1 1 1 1 1 1 1 1 1 1 1 1 1 1 1 1 1
1 1 1 1 1 108 108 106 108 108 108 108 108 1 1 1 1 1 35 35 35 35 35 116 116 116 35 35 35 35 1 1 1 1 1 1 1 1 1 1 1 1 1 1 1 1 1 1 1 1 1 1 1 1 1 1 1 1 1 1 1 1 1 1
1 1 1 1 3 108 108 108 108 106 108 108 108 2 1 1 1 1 35 35 35 35 35 91 49 91 35 35 35 35 1 1 1 1 1 1 1 1 1 1 1 1 1 1 1 1 1 1 1 1 1 1 1 1 1 1 1 1 1 1 1 1 1 1
1 1 3 1 2 108 108 108 108 2 1 3 1 1 1 1 1 2 1 1 2 1 118 118 118 118 118 2 1 1 1 1 1 1 1 1 1 1 1 1 1 1 1 1 1 1 1 1 1 1 1 1 1 1 1 1 1 1 1 1 1 1 1 1
1 106 108 108 108 108 108 108 108 3 1 1 109 109 1 1 1 2 118 118 118 118 118 118 118 118 118 118 118 118 1 1 1 1 1 1 1 1 1 1 1 1 1 1 1 1 1 1 1 1 1 1 1 1 1 1 1 1 1 1 1 1 1 1
1 108 108 108 108 108 108 108 108 2 1 1 109 109 1 1 1 1 91 1 1 1 2 1 1 2 1 1 1 91 1 1 1 1 1 1 1 1 1 1 1 1 1 1 1 1 1 1 1 1 1 1 1 1 1 1 1 1 1 1 1 1 1 1
4 108 108 108 108 3 1 1 2 2 1 2 1 1 1 1 27 119 119 1 27 120 120 120 120 120 120 27 1 121 121 2 1 1 1 1 1 1 1 1 1 1 1 1 1 1 1 1 1 1 1 1 1 1 1 1 1 1 1 1 1 1 1 1
2 108 108 108 108 90 109 109 109 109 109 109 109 109 1 1 119 119 119 2 120 120 120 120 120 120 120 120 2 121 121 121 1 1 1 1 1 1 1 1 1 1 1 1 1 1 1 1 1 1 1 1 1 1 1 1 1 1 1 1 1 1 1 1
1 108 108 108 108 3 109 109 109 109 109 109 4 1 1 119 119 119 119 90 120 120 120 120 120 120 120 120 90 121 121 121 121 1 1 1 1 1 1 1 1 1 1 1 1 1 1 1 1 1 1 1 1 1 1 1 1 1 1 1 1 1 1 1
1 2 2 1 2 1 106 109 109 109 109 109 109 109 27 119 119 119 119 2 120 120 120 120 120 120 120 106 1 121 121 121 121 2 1 1 1 1 1 1 1 1 1 1 138 138 138 138 138 1 1 1 1 1 1 1 1 1 1 1 1 1 1 1
1 1 1 1 1 2 109 109 1 109 2 109 4 2 1 119 119 119 119 2 120 120 120 120 120 120 120 120 2 121 121 121 121 1 1 1 1 1 1 1 1 1 1 1 138 34 34 34 138 1 1 1 1 1 1 1 1 1 1 1 1 1 1 1
1 1 1 1 1 109 109 109 1 109 2 106 109 109 27 119 119 119 119 1 120 120 120 120 120 120 120 120 1 121 121 121 121 2 1 1 1 1 1 1 1 1 1 1 138 138 138 138 138 1 1 1 1 1 1 1 1 1 1 1 1 1 1 1
48 48 48 48 48 48 91 48 48 1 2 1 2 1 1 119 119 119 119 27 120 120 120 120 120 120 120 120 2 121 121 121 121 1 1 1 1 1 1 1 1 1 1 1 1 1 138 1 1 1 1 1 1 1 1 26 1 1 1 1 1 1 1 1
48 48 48 48 48 110 110 110 48 48 1 1 1 1 119 119 119 119 119 1 120 120 120 120 120 120 120 120 1 121 121 121 121 121 121 121 1 1 1 1 1 1 1 1 138 138 138 138 138 1 1 1 1 139 139 139 106 139 1 1 1 1 1 1
48 48 48 48 110 110 110 110 110 48 48 1 1 1 119 1 119 1 119 1 27 120 120 120 120 120 120 27 1 121 1 121 1 121 1 121 121 1 1 1 1 1 1 1 138 34 34 34 138 1 1 26 106 139 1 1 139 139 139 1 1 1 1 1
48 48 48 110 110 110 110 110 110 110 48 48 1 1 2 1 1 1 2 2 1 1 3 1 2 3 2 2 1 1 1 91 1 1 1 121 121 1 1 1 1 1 1 1 138 138 138 138 138 1 1 139 139 1 1 139 139 1 139 139 1 1 1 1
48 48 110 110 110 110 110 110 110 110 110 48 48 1 1 1 111 111 111 111 1 1 1 1 1 1 1 1 1 1 1 115 2 1 1 1 1 1 1 1 1 1 1 1 1 1 91 1 1 1 139 139 139 139 139 139 1 1 1 139 26 1 1 1
48 110 110 110 110 110 110 110 110 110 110 110 90 111 111 111 111 111 111 111 1 1 1 1 1 1 1 1 1 1 1 115 2 1 1 1 1 1 1 1 1 1 1 1 1 115 115 115 1 139 139 1 26 1 139 106 139 1 106 139 1 1 1 1
48 48 110 110 110 110 110 110 110 110 110 48 48 1 27 27 1 1 91 1 1 1 1 1 1 1 1 1 1 1 2 115 1 1 1 1 1 1 1 1 1 2 1 2 1 115 27 115 90 139 1 1 139 139 139 1 139 139 139 1 1 1 1 1
48 48 48 110 110 110 110 110 110 110 48 48 48 1 1 1 1 1 112 27 1 1 1 1 1 1 1 1 1 1 2 115 1 1 1 1 1 1 1 1 2 115 115 115 115 115 115 115 1 139 139 1 1 139 1 1 139 106 1 1 1 1 1 1
48 48 48 48 110 110 110 110 110 48 48 48 48 1 1 1 1 112 112 112 1 1 1 1 1 1 1 1 1 1 1 115 2 1 1 1 1 1 1 1 2 115 1 4 2 115 1 1 1 1 106 139 139 139 139 106 139 1 1 1 1 1 1 1
48 48 48 48 48 110 110 110 48 48 48 1 1 1 1 2 112 112 112 112 112 2 1 1 1 1 1 1 1 1 1 115 2 1 1 1 1 1 1 1 2 115 3 1 3 115 2 1 6 1 1 2 1 1 2 26 1 1 1 1 1 1 1 1
48 48 48 48 48 48 110 48 48 1 1 1 1 1 1 112 112 112 112 112 112 112 1 1 1 1 1 1 1 1 1 115 1 1 1 1 1 1 2 1 1 115 1 4 1 115 94 125 125 125 1 127 127 127 1 1 1 1 1 1 1 1 1 1
42 42 42 42 42 48 48 48 1 1 1 1 1 2 112 112 112 112 112 112 112 112 112 2 1 1 1 1 1 1 2 115 1 1 1 1 1 115 115 115 115 115 115 115 115 115 2 125 125 125 90 127 127 127 1 1 1 1 1 1 1 1 1 1
42 42 47 42 42 46 42 42 1 1 1 1 1 112 112 112 112 112 112 112 112 112 112 112 2 1 1 1 1 1 1 115 1 2 2 1 1 115 1 4 1 115 1 1 95 27 1 106 125 125 1 127 127 127 1 1 1 1 1 1 1 1 1 1
46 113 113 113 42 113 113 42 1 1 2 1 112 112 112 112 112 34 36 34 112 112 112 112 112 1 1 1 1 1 1 115 115 115 115 115 115 115 3 1 3 115 1 1 106 125 125 125 125 125 2 127 2 1 2 1 1 1 1 1 1 1 1 1
42 113 113 113 42 113 113 46 1 1 1 112 112 112 112 112 112 36 34 36 112 112 112 112 112 112 2 1 1 1 1 1 2 2 1 2 2 115 2 4 1 115 2 6 125 125 125 125 125 125 1 127 2 1 1 1 1 1 1 1 1 1 1 1
46 113 113 113 46 113 113 42 1 1 112 112 112 112 112 112 112 34 36 34 112 112 112 112 112 112 112 1 1 1 1 1 1 1 1 1 1 115 115 115 115 115 2 1 125 106 125 125 125 125 2 127 1 1 1 1 1 1 1 1 1 1 1 1
42 113 42 46 42 46 46 42 2 112 112 112 112 112 112 112 112 112 112 112 112 112 112 112 112 112 112 112 1 1 1 2 1 2 1 1 1 1 2 1 2 2 1 1 1 2 1 2 91 1 1 127 1 1 1 1 1 1 1 1 1 1 1 1
42 113 113 113 113 113 113 90 112 112 112 112 112 112 112 112 112 112 112 112 112 112 112 112 112 112 112 112 112 90 118 106 118 2 1 1 1 1 1 1 1 1 1 1 1 1 1 2 127 1 2 127 2 1 1 1 1 1 1 1 1 1 1 1
46 113 46 42 46 42 42 42 1 2 1 2 2 1 1 1 2 1 3 1 1 2 2 1 2 1 1 2 1 1 118 118 118 2 1 1 42 46 42 46 42 46 42 46 42 42 42 2 127 127 127 127 1 1 1 1 1 1 1 1 1 1 1 1
42 113 113 113 113 113 46 46 46 46 42 1 124 124 124 124 124 124 124 124 124 124 124 124 124 124 124 124 106 1 118 118 118 1 1 1 46 126 126 126 126 126 126 126 126 126 46 2 1 2 1 127 1 1 1 1 1 1 1 1 1 1 1 1
46 113 113 113 113 113 42 46 117 42 42 1 124 1 1 1 1 1 1 2 124 2 1 91 1 1 124 124 124 1 118 118 118 1 1 1 47 126 126 126 126 126 126 126 126 126 90 127 127 127 127 127 2 1 1 1 1 1 1 1 1 1 1 1
42 113 113 113 113 113 90 117 117 117 46 1 124 1 1 1 1 1 2 1 124 1 123 123 123 1 106 124 106 2 118 118 118 1 1 1 42 126 126 126 126 126 126 126 126 126 42 1 1 2 1 1 2 1 1 1 1 1 1 1 1 1 1 1
46 113 113 113 113 113 42 42 117 117 42 1 124 1 1 1 1 1 1 124 124 2 123 123 123 1 1 4 1 1 118 118 118 1 1 1 42 42 46 42 126 126 126 42 42 46 42 1 1 1 1 1 1 1 1 1 1 1 1 1 1 1 1 1
46 113 113 113 113 113 46 42 117 117 42 1 124 1 1 2 124 124 124 124 1 1 123 123 123 1 1 1 1 2 118 118 118 118 118 118 1 42 42 46 126 126 126 42 1 1 1 1 1 1 1 1 1 1 1 1 1 1 1 1 1 1 1 1
46 113 113 113 113 113 113 90 117 46 42 1 124 1 1 1 124 1 1 2 1 123 123 123 123 123 1 2 2 1 118 118 118 2 2 1 1 42 46 42 126 126 126 46 1 1 1 1 1 1 1 1 1 1 1 1 1 1 1 1 1 1 1 1
46 42 47 46 42 46 46 42 46 42 1 1 124 1 1 1 124 1 123 123 123 123 123 123 123 123 92 118 118 118 118 118 118 118 118 118 47 126 126 126 126 126 126 42 1 1 1 1 1 1 1 1 1 1 1 1 1 1 1 1 1 1 1 1
1 1 1 1 1 1 1 1 1 1 33 124 124 1 1 124 124 90 123 123 123 123 123 123 123 123 4 118 118 118 118 118 118 118 118 118 92 126 126 126 126 126 126 46 1 1 1 1 1 1 1 1 1 1 1 1 1 1 1 1 1 1 1 1
1 1 1 1 1 1 1 1 1 1 1 1 124 1 1 1 124 1 123 123 123 123 123 123 123 123 92 118 118 118 118 118 118 118 118 118 47 126 126 126 126 126 126 42 1 1 1 1 1 1 1 1 1 1 1 1 1 1 1 1 1 1 1 1
1 1 1 1 1 1 1 1 1 1 1 1 124 1 1 2 124 1 2 1 1 123 123 123 123 123 1 1 2 2 1 1 2 1 2 1 42 46 42 46 42 46 42 42 1 1 1 1 1 1 1 1 1 1 1 1 1 1 1 1 1 1 1 1
1 1 1 1 1 1 1 1 1 1 1 1 124 1 1 1 124 124 124 124 1 2 123 123 123 1 1 4 1 1 1 1 1 1 1 1 1 1 1 1 1 1 1 1 1 1 1 1 1 1 1 1 1 1 1 1 1 1 1 1 1 1 1 1
1 1 1 1 1 1 1 1 1 1 1 1 124 1 1 1 1 2 1 124 124 2 123 123 123 1 106 124 106 1 1 1 1 1 1 1 1 1 1 1 1 1 1 1 1 1 1 1 1 1 1 1 1 1 1 1 1 1 1 1 1 1 1 1
1 1 1 1 1 1 1 1 1 1 1 1 124 1 1 1 1 1 1 1 124 1 123 123 123 2 124 124 124 2 1 1 1 1 1 1 1 1 1 1 1 1 1 1 1 1 1 1 1 1 1 1 1 1 1 1 1 1 1 1 1 1 1 1
1 1 1 1 1 1 1 1 1 1 1 1 124 1 1 1 1 1 1 2 124 1 1 91 1 1 124 124 106 2 1 1 1 1 1 1 1 1 1 1 1 1 1 1 1 1 1 1 1 1 1 1 1 1 1 1 1 1 1 1 1 1 1 1
1 1 1 1 1 1 1 1 1 1 1 1 124 124 124 124 124 124 124 124 124 124 124 124 124 124 124 1 2 1 1 1 1 1 1 1 1 1 1 1 1 1 1 1 1 1 1 1 1 1 1 1 1 1 1 1 1 1 1 1 1 1 1 1
1 1 1 1 1 1 1 1 1 1 1 1 1 1 1 1 1 1 1 1 2 2 1 1 2 1 1 1 1 1 1 1 1 1 1 1 1 1 1 1 1 1 1 1 1 1 1 1 1 1 1 1 1 1 1 1 1 1 1 1 1 1 1 1
1 1 1 1 1 1 1 1 1 1 1 1 1 1 1 1 1 1 1 1 1 1 1 1 1 1 1 1 1 1 1 1 1 1 1 1 1 1 1 1 1 1 1 1 1 1 1 1 1 1 1 1 1 1 1 1 1 1 1 1 1 1 1 1
1 1 1 1 1 1 1 1 1 1 1 1 1 1 1 1 1 1 1 1 1 1 1 1 1 1 1 1 1 1 1 1 1 1 1 1 1 1 1 1 1 1 1 1 1 1 1 1 1 1 1 1 1 1 1 1 1 1 1 1 1 1 1 1
1 1 1 1 1 1 1 1 1 1 1 1 1 1 1 1 1 1 1 1 1 1 1 1 1 1 1 1 1 1 1 1 1 1 1 1 1 1 1 1 1 1 1 1 1 1 1 1 1 1 1 1 1 1 1 1 1 1 1 1 1 1 1 1
1 1 1 1 1 1 1 1 1 1 1 1 1 1 1 1 1 1 1 1 1 1 1 1 1 1 1 1 1 1 1 1 1 1 1 1 1 1 1 1 1 1 1 1 1 1 1 1 1 1 1 1 1 1 1 1 1 1 1 1 1 1 1 1
1 1 1 1 1 1 1 1 1 1 1 1 1 1 1 1 1 1 1 1 1 1 1 1 1 1 1 1 1 1 1 1 1 1 1 1 1 1 1 1 1 1 1 1 1 1 1 1 1 1 1 1 1 1 1 1 1 1 1 1 1 1 1 1
1 1 1 1 1 1 1 1 1 1 1 1 1 1 1 1 1 1 1 1 1 1 1 1 1 1 1 1 1 1 1 1 1 1 1 1 1 1 1 1 1 1 1 1 1 1 1 1 1 1 1 1 1 1 1 1 1 1 1 1 1 1 1 1
1 1 1 1 1 1 1 1 1 1 1 1 1 1 1 1 1 1 1 1 1 1 1 1 1 1 1 1 1 1 1 1 1 1 1 1 1 1 1 1 1 1 1 1 1 1 1 1 1 1 1 1 1 1 1 1 1 1 1 1 1 1 1 1
1 1 1 1 1 1 1 1 1 1 1 1 1 1 1 1 1 1 1 1 1 1 1 1 1 1 1 1 1 1 1 1 1 1 1 1 1 1 1 1 1 1 1 1 1 1 1 1 1 1 1 1 1 1 1 1 1 1 1 1 1 1 1 1
