1 1 1 1 1 1 1 35 35 35 35 35 35 35 35 37 35 39 35 35 35 35 39 35 35 35 35 35 35 37 35 35 35 35 39 35 35 35 35 35 35 35 35 39 35 35 35 35 37 35 35 39 35 35 35 35 35 1 1 1 1 1 1 1
1 1 1 1 1 1 1 39 113 113 113 113 113 113 113 113 113 113 113 113 113 113 113 113 113 113 113 113 113 113 113 113 113 113 113 113 113 113 113 113 113 113 113 113 113 113 113 113 113 113 113 113 113 113 113 113 35 1 1 1 1 1 1 1
1 1 1 1 1 1 1 35 35 113 113 113 49 35 35 35 39 35 35 35 39 35 35 37 35 39 35 35 35 39 35 35 35 35 35 35 35 35 39 35 35 35 35 35 35 39 35 35 35 39 35 35 35 35 113 39 35 1 1 1 1 1 1 1
1 1 1 1 1 1 1 1 35 113 113 113 35 35 35 35 1 1 1 1 1 1 1 1 1 1 1 8 9 8 9 8 9 8 9 8 9 8 35 35 35 35 35 113 113 113 113 113 35 35 37 35 39 35 113 35 1 1 1 1 1 1 1 1
1 1 1 1 1 1 1 1 39 113 113 113 113 113 113 35 1 1 1 1 1 1 1 1 1 1 8 8 112 112 112 112 112 112 112 112 112 8 35 35 35 35 37 113 113 113 113 113 113 113 113 113 113 113 113 35 1 1 1 1 1 1 1 1
1 1 1 1 1 1 1 1 35 113 113 113 113 113 113 35 1 1 1 1 1 1 1 1 1 1 9 112 112 112 112 112 112 112 112 112 112 9 35 35 35 35 35 113 113 113 113 113 35 39 35 35 35 35 35 35 1 1 1 1 1 1 1 1
1 1 1 1 1 1 1 1 35 113 113 113 113 113 113 37 1 1 1 1 1 1 1 1 1 1 8 112 112 112 112 112 112 112 112 112 9 8 9 8 9 8 35 35 49 91 49 35 35 8 9 8 9 8 9 8 1 1 1 1 1 1 1 1
1 1 1 1 1 1 1 1 35 35 35 49 113 113 113 35 1 1 1 1 1 1 1 1 1 1 9 112 112 112 112 112 112 112 112 8 112 112 112 112 112 8 1 111 111 111 111 111 2 8 112 112 112 112 112 8 8 1 1 1 1 1 1 1
1 1 1 1 1 1 1 1 1 1 1 35 113 113 113 39 1 1 1 1 1 1 1 1 1 1 8 8 112 112 112 112 112 112 9 9 112 112 112 112 112 9 28 111 111 111 111 111 28 9 112 112 112 112 112 112 9 1 1 1 1 1 1 1
1 1 1 1 1 1 1 1 1 1 1 39 113 113 113 35 1 1 1 1 1 1 1 1 1 1 1 8 9 8 9 8 9 8 8 8 112 112 112 112 112 112 90 111 111 111 111 111 90 112 112 112 112 112 112 8 8 1 1 1 1 1 1 1
1 1 1 1 1 1 1 1 1 1 1 37 113 113 113 35 1 1 1 1 1 1 1 1 1 1 1 1 1 1 1 1 1 1 9 112 112 112 112 112 112 8 28 111 111 111 111 111 28 9 112 112 112 112 112 112 9 1 1 1 1 1 1 1
1 1 1 1 1 1 1 1 1 1 1 35 113 113 113 37 1 1 1 1 1 1 1 1 1 1 1 1 1 1 1 1 1 1 8 8 112 112 112 112 112 9 1 111 111 111 111 111 2 8 112 112 112 112 112 8 8 1 1 1 1 1 1 1
1 1 1 1 1 1 1 1 35 39 35 49 113 113 113 35 1 1 1 1 1 1 1 1 1 1 1 1 1 1 1 1 1 1 1 2 9 8 9 8 9 8 2 111 111 111 111 111 1 8 9 8 9 8 9 2 1 1 1 1 1 1 1 1
1 1 1 1 1 1 1 35 35 113 113 113 113 113 113 39 1 1 1 1 1 1 1 1 1 1 1 1 1 1 1 1 1 1 1 111 1 2 1 2 1 2 1 111 111 111 111 111 2 1 1 2 1 2 1 111 1 1 1 1 1 1 1 1
1 1 1 1 1 1 35 39 113 113 113 113 113 113 113 35 1 1 1 1 1 1 1 1 1 1 1 1 1 1 1 1 1 2 111 111 111 111 111 111 111 111 111 111 111 111 111 111 111 111 111 111 111 111 111 111 111 2 1 1 1 1 1 1
1 1 1 1 35 35 35 113 113 113 113 113 113 113 113 35 1 1 1 2 1 2 1 2 1 1 1 1 1 1 1 1 1 1 1 111 111 111 111 111 111 111 111 111 111 111 111 111 111 111 111 111 111 111 111 111 1 1 1 1 1 1 1 1
1 1 1 1 35 113 113 113 113 113 113 113 113 113 35 35 1 2 6 109 109 109 109 109 6 2 1 1 1 27 1 27 1 1 2 111 111 12 11 12 111 111 10 12 12 12 12 12 10 111 111 12 11 12 111 111 2 1 1 1 1 1 1 1
1 1 1 1 39 113 113 113 113 113 113 113 113 35 35 1 1 109 109 109 109 109 109 109 109 109 1 27 108 108 108 108 108 27 1 111 111 12 11 12 111 111 12 12 12 12 12 12 12 111 111 12 11 12 111 111 1 1 1 1 1 1 1 1
1 1 1 1 35 113 113 113 113 113 113 113 39 35 1 1 2 109 109 109 109 109 109 109 109 109 2 1 108 108 108 108 108 1 2 111 111 111 111 111 111 111 12 12 12 12 12 12 12 111 111 111 111 111 111 111 2 1 1 1 1 1 1 1
1 1 1 1 37 113 113 113 113 113 49 35 35 1 1 1 109 109 109 109 109 109 109 109 109 109 109 27 108 108 108 108 108 27 1 111 111 111 111 111 111 111 12 12 12 23 12 12 12 111 111 111 111 111 111 111 1 1 1 1 1 1 1 1
1 1 1 1 39 113 113 113 113 113 35 1 1 1 1 2 109 109 109 109 109 109 109 109 109 109 109 2 108 108 108 108 108 1 2 111 111 12 12 12 12 12 12 10 111 111 111 10 12 12 12 12 12 12 111 111 2 1 1 1 1 1 1 1
1 1 1 1 35 113 113 113 113 113 37 1 1 1 1 1 109 109 109 109 109 109 109 109 109 109 109 27 108 108 108 108 108 27 1 111 111 23 12 12 12 12 12 111 111 111 111 111 12 12 12 12 12 23 111 111 1 1 1 1 1 1 1 1
1 1 1 1 35 113 113 113 113 113 39 1 1 1 1 1 2 109 109 109 109 109 109 109 109 109 2 1 108 108 108 108 108 1 2 111 111 111 111 111 111 111 111 111 111 111 111 111 111 111 111 111 111 111 111 111 2 1 1 1 1 1 1 1
35 35 39 35 35 113 113 113 113 113 35 35 35 35 35 1 1 109 109 109 109 109 109 109 109 109 1 27 108 108 108 108 108 27 111 111 111 111 111 111 111 111 111 111 111 111 111 111 111 111 111 111 111 111 111 111 111 1 1 1 1 1 1 1
35 106 113 113 113 113 113 113 113 113 113 106 113 106 39 1 1 2 6 109 109 109 109 109 6 2 1 1 108 108 108 108 108 1 2 111 2 1 2 1 2 1 2 111 111 111 111 111 2 1 2 1 2 1 2 111 2 1 1 1 1 1 1 1
35 35 35 35 35 113 113 113 113 113 35 39 35 35 35 35 35 35 35 2 1 109 1 2 1 1 1 27 108 108 108 108 108 27 1 1 1 1 1 1 1 1 1 1 2 111 2 1 1 1 1 1 1 1 1 1 1 1 1 1 1 1 1 1
35 35 35 35 39 113 113 113 113 113 35 35 35 35 35 113 113 113 113 35 2 109 2 1 1 1 1 1 1 108 1 27 1 1 1 1 1 1 1 1 1 1 1 1 1 111 1 1 1 1 1 1 1 1 1 1 1 1 1 1 1 1 1 1
35 35 35 35 35 113 113 113 113 113 35 35 35 39 35 113 113 113 113 35 1 109 1 1 1 1 1 1 27 108 1 2 13 1 1 1 1 1 1 1 1 1 1 1 2 111 2 1 1 1 1 1 1 1 1 1 1 1 1 1 1 1 1 1
35 106 113 106 113 113 113 113 113 113 113 113 113 106 37 113 113 113 113 35 2 109 2 1 1 1 1 1 1 108 27 108 108 108 2 1 1 1 1 1 1 1 1 1 1 111 1 1 1 1 1 1 1 1 1 1 1 1 1 1 1 1 1 1
35 35 39 35 35 113 113 113 113 113 35 39 35 35 113 113 113 113 113 35 1 109 1 1 1 1 1 1 108 108 2 108 108 108 1 1 1 1 1 1 1 1 1 1 2 111 2 1 1 1 1 1 1 1 1 1 1 1 1 1 1 1 1 1
35 35 35 35 39 113 113 113 113 113 39 35 35 35 113 113 113 113 113 35 2 109 2 1 1 1 1 1 1 27 1 108 108 108 2 1 1 1 1 1 1 1 1 1 1 111 1 1 1 1 1 1 1 1 1 1 1 1 1 1 1 1 1 1
35 35 35 35 35 113 113 113 113 113 35 35 35 35 35 113 113 113 113 35 1 109 1 2 1 2 1 2 1 6 108 108 108 108 108 3 2 1 2 1 2 1 2 1 2 111 2 1 1 1 1 1 1 1 1 1 1 1 1 1 1 1 1 1
39 106 113 113 113 113 113 113 113 113 113 106 113 106 39 35 35 35 35 35 6 109 109 109 109 109 109 109 90 108 108 108 108 108 108 108 94 111 111 111 111 111 111 111 111 111 1 1 1 1 1 1 1 1 1 1 1 1 1 1 1 1 1 1
35 35 35 35 35 113 113 113 113 113 35 39 35 35 35 35 29 29 32 29 29 6 2 1 2 1 2 1 2 6 108 108 108 108 108 3 1 2 1 2 1 2 1 2 1 2 1 1 1 1 1 1 1 1 1 1 1 1 1 1 1 1 1 1
35 35 35 35 39 113 113 113 113 113 35 35 35 35 35 35 29 110 110 110 29 29 29 29 29 29 29 31 29 29 2 108 108 108 1 1 1 1 1 1 1 1 1 1 1 1 1 1 1 1 1 1 1 1 1 1 1 1 1 1 1 1 1 1
35 35 35 35 35 113 113 113 113 113 35 35 35 35 35 35 29 110 110 110 110 110 110 110 110 110 110 110 110 29 1 108 108 108 2 1 1 1 1 1 1 1 1 1 1 1 1 1 1 1 1 1 1 1 1 1 1 1 1 1 1 1 1 1
35 106 113 106 113 113 113 113 113 113 113 113 113 106 35 35 29 110 110 110 110 110 110 110 110 110 110 110 110 110 29 28 108 28 1 1 1 1 1 1 1 1 1 1 1 1 1 1 1 1 1 1 1 1 1 1 1 1 1 1 1 1 1 1
35 35 39 35 35 113 113 113 113 113 35 39 35 35 35 35 31 110 110 110 110 110 110 110 110 110 110 110 110 110 110 1 93 1 1 1 1 1 1 1 1 1 1 1 1 1 1 1 1 1 1 1 1 1 1 1 1 1 1 1 1 1 1 1
35 35 35 35 35 113 113 113 113 113 39 35 35 35 35 35 29 110 110 110 110 110 110 110 110 110 110 110 29 29 110 29 110 29 1 1 1 1 1 1 1 1 1 1 1 1 1 1 1 1 1 1 1 1 1 1 1 1 1 1 1 1 1 1
35 35 35 35 35 113 113 113 113 113 35 35 35 39 35 35 29 110 110 110 110 110 110 110 29 29 29 110 29 110 110 30 110 29 1 1 1 1 29 29 29 1 1 1 1 1 1 1 1 1 1 1 1 1 1 1 1 1 1 1 1 1 1 1
35 106 113 113 113 113 113 113 113 113 113 106 113 106 39 35 29 29 29 30 29 29 29 29 31 110 29 29 29 29 29 29 110 29 1 1 1 1 29 110 29 1 1 1 1 1 1 1 1 1 1 1 1 1 1 1 1 1 1 1 1 1 1 1
35 35 35 39 35 113 113 113 113 113 35 39 35 35 35 35 49 39 37 35 35 35 29 29 29 110 29 29 29 30 29 29 110 29 29 32 29 31 29 110 29 29 29 1 1 1 1 1 1 1 1 1 1 1 1 1 1 1 1 1 1 1 1 1
35 35 35 35 39 113 113 113 113 113 39 35 35 35 35 113 113 113 113 113 113 35 32 110 110 110 110 110 110 110 110 110 110 110 110 110 110 110 110 110 110 110 32 1 1 1 1 1 1 1 1 1 1 1 1 1 1 1 1 1 1 1 1 1
35 35 35 35 35 113 113 113 113 113 35 35 35 35 35 113 113 113 113 113 113 35 29 29 29 110 29 29 29 29 29 29 31 29 29 29 29 29 29 110 29 29 29 1 1 1 1 1 1 1 1 1 1 1 1 1 1 1 1 1 1 1 1 1
35 106 113 106 113 113 113 113 113 113 113 113 113 106 35 113 113 113 113 113 113 113 39 35 29 110 29 110 110 110 110 110 29 110 110 110 110 110 29 110 29 1 1 1 1 1 1 1 1 1 1 1 1 1 1 1 1 1 1 1 1 1 1 1
35 35 35 39 35 113 113 113 113 113 35 35 39 35 39 113 113 113 113 113 113 113 113 35 29 110 29 110 29 29 29 110 29 110 29 29 29 110 29 110 29 1 1 1 1 1 1 1 1 1 1 1 1 1 1 1 1 1 1 1 1 1 1 1
35 35 35 35 39 113 113 113 113 113 39 35 35 35 49 113 113 113 35 113 113 113 113 35 29 110 29 110 32 29 29 110 110 110 29 29 29 110 30 110 29 1 1 1 1 1 1 1 1 1 1 1 1 1 1 1 1 1 1 1 1 1 1 1
35 35 35 39 35 113 113 113 113 113 35 35 35 35 35 113 113 113 39 35 113 113 113 39 29 110 29 110 29 29 29 110 110 110 32 29 29 110 29 110 29 1 1 1 1 1 1 1 1 1 1 1 1 1 1 1 1 1 1 1 1 1 1 1
39 106 113 113 113 113 113 113 113 113 113 106 113 106 37 113 113 113 113 35 35 113 113 49 29 110 29 110 29 29 29 110 110 110 29 29 29 110 29 110 29 1 1 1 1 1 1 1 1 1 1 1 1 1 1 1 1 1 1 1 1 1 1 1
35 35 35 39 35 113 113 113 113 113 35 35 35 35 113 113 113 113 113 35 39 113 113 35 30 110 110 110 110 110 31 110 110 110 29 110 110 110 110 110 29 1 1 1 1 1 1 1 1 1 1 1 1 1 1 1 1 1 1 1 1 1 1 1
35 35 35 35 35 113 113 113 113 113 39 35 35 35 113 113 113 113 113 113 113 113 113 35 29 110 29 32 29 29 29 110 110 110 29 29 29 29 29 110 29 1 1 1 1 1 1 1 1 1 1 1 1 1 1 1 1 1 1 1 1 1 1 1
35 35 35 35 35 35 113 113 113 39 35 113 113 113 113 113 113 113 113 113 113 113 113 37 29 110 29 29 29 29 110 110 110 110 110 29 32 29 29 110 29 1 1 1 1 1 1 1 1 1 1 1 1 1 1 1 1 1 1 1 1 1 1 1
35 35 35 35 35 35 49 113 49 39 113 113 113 113 113 113 113 113 113 113 113 113 113 35 29 29 29 110 110 110 110 110 110 110 110 110 110 110 29 29 29 1 1 1 1 1 1 1 1 1 1 1 1 1 1 1 1 1 1 1 1 1 1 1
35 35 35 35 35 35 35 113 35 35 35 35 35 39 35 35 37 35 49 39 35 113 113 39 29 110 110 110 110 110 110 110 110 110 110 110 110 110 110 110 29 1 1 1 1 1 1 1 1 1 1 1 1 1 1 1 1 1 1 1 1 1 1 1
35 35 35 35 35 35 39 113 35 35 35 35 35 39 37 35 35 35 35 35 35 113 113 35 29 110 110 110 110 110 110 110 110 110 110 110 110 110 110 110 29 1 1 1 1 1 1 1 1 1 1 1 1 1 1 1 1 1 1 1 1 1 1 1
35 35 35 35 35 35 35 113 39 35 35 114 114 114 114 114 114 114 114 35 35 113 113 35 31 110 110 110 110 110 110 110 110 110 110 110 110 110 110 110 29 1 1 1 1 1 1 1 1 1 1 1 1 1 1 1 1 1 1 1 1 1 1 1
35 35 35 35 35 35 35 113 35 35 39 114 114 114 114 114 114 114 114 39 35 39 35 35 29 110 110 110 110 110 110 110 110 110 110 110 110 110 110 110 30 1 1 1 1 1 1 1 1 1 1 1 1 1 1 1 1 1 1 1 1 1 1 1
35 35 35 35 39 35 35 113 49 35 35 114 114 114 114 114 114 114 114 35 21 21 21 35 29 110 110 110 110 110 110 110 110 110 110 110 110 110 110 110 29 1 1 1 1 1 1 1 1 1 1 1 1 1 1 1 1 1 1 1 1 1 1 1
35 39 35 35 113 113 35 113 113 90 114 114 114 114 114 114 114 114 114 100 143 143 143 21 29 110 110 110 110 110 110 110 110 110 110 110 110 110 110 110 29 1 1 1 1 1 1 1 1 1 1 1 1 1 1 1 1 1 1 1 1 1 1 1
35 113 113 113 113 113 113 35 49 35 35 114 114 114 114 114 114 114 114 35 21 21 21 35 29 110 110 110 110 110 110 110 110 110 110 110 110 110 110 110 29 1 1 1 1 1 1 1 1 1 1 1 1 1 1 1 1 1 1 1 1 1 1 1
39 113 113 113 113 113 113 113 113 35 39 114 114 114 114 114 114 114 114 35 35 35 35 35 29 29 32 110 110 110 110 110 110 110 110 110 110 110 29 31 29 1 1 1 1 1 1 1 1 1 1 1 1 1 1 1 1 1 1 1 1 1 1 1
35 113 113 113 113 113 113 113 113 39 35 114 114 114 114 114 114 114 114 39 35 35 35 35 35 1 29 29 29 29 110 110 110 110 110 29 29 29 29 1 1 1 1 1 1 1 1 1 1 1 1 1 1 1 1 1 1 1 1 1 1 1 1 1
35 113 113 113 113 113 113 113 113 35 35 35 35 35 37 39 35 35 35 35 35 35 35 35 35 1 1 1 1 29 29 29 30 29 29 29 1 1 1 1 1 1 1 1 1 1 1 1 1 1 1 1 1 1 1 1 1 1 1 1 1 1 1 1
35 35 35 39 35 37 35 39 35 35 35 35 35 35 35 35 35 35 35 35 35 35 35 35 35 1 1 1 1 1 1 1 1 1 1 1 1 1 1 1 1 1 1 1 1 1 1 1 1 1 1 1 1 1 1 1 1 1 1 1 1 1 1 1
