29 29 29 29 29 29 29 29 29 29 29 29 29 29 29 29 29 29 29 29 29 29 29 29 29 29 29 29 29 29 29 29 29 29 29 29 29 29 29 29 29 29 29 31 29 29 29 29 29 29 29 29 29 29 29 29 29 29 29 31 29 29 29 29
29 29 29 29 29 29 29 29 29 29 29 29 29 29 29 29 29 29 29 29 29 29 29 29 29 29 29 29 29 30 29 29 29 29 114 114 114 114 114 114 114 114 114 114 114 114 114 114 114 114 114 30 29 29 21 29 106 114 114 114 114 114 29 29
29 29 29 29 29 29 29 29 29 29 29 29 29 29 29 29 29 29 29 29 29 29 29 29 29 29 114 114 114 114 114 114 114 114 114 114 114 114 114 114 114 114 114 114 114 114 114 114 114 114 114 29 29 21 114 100 114 114 114 114 114 114 29 29
29 29 29 29 29 29 29 29 29 29 29 29 29 29 29 29 29 29 29 29 29 29 29 29 29 29 114 114 114 114 114 114 114 114 114 114 114 114 114 114 114 114 114 114 114 114 114 114 114 114 114 29 29 29 21 29 106 114 114 114 114 114 29 29
29 29 29 29 29 29 29 29 29 29 29 29 29 29 29 29 29 29 29 29 29 29 29 29 29 29 114 114 114 114 114 114 114 114 114 114 114 114 29 29 29 29 31 29 29 30 29 114 114 114 114 114 29 29 29 30 29 29 29 114 114 114 29 29
29 29 29 29 29 29 29 29 29 29 29 29 29 29 29 29 29 29 29 29 29 29 29 29 29 30 114 114 114 114 29 30 29 114 114 114 114 29 29 29 29 29 29 29 29 29 29 29 114 114 114 114 114 114 114 114 114 114 114 114 114 114 30 29
29 29 29 29 29 29 29 29 29 29 29 29 29 29 29 29 29 29 29 29 29 29 29 29 29 29 114 114 114 29 29 29 29 29 114 114 114 29 29 30 29 29 29 30 29 29 29 29 114 114 114 114 114 114 114 114 114 114 114 114 114 114 29 29
29 29 29 29 29 29 29 29 29 29 29 29 29 29 29 29 29 29 29 29 29 29 29 29 29 29 114 114 114 29 29 29 29 31 114 114 114 29 29 114 114 114 114 114 114 114 29 29 114 114 114 114 114 114 114 114 114 114 114 114 114 114 31 29
29 29 29 29 29 29 29 29 29 29 29 29 29 29 29 29 29 29 29 29 29 29 29 29 29 29 114 114 114 29 29 29 29 29 114 114 114 114 114 114 114 114 114 114 114 114 114 29 29 30 29 29 29 29 29 29 29 29 29 114 114 114 29 29
29 29 29 29 29 29 29 29 29 29 29 29 29 29 29 29 29 29 29 29 29 29 29 29 29 29 114 114 114 29 29 29 29 29 114 114 114 114 114 114 114 114 114 114 114 114 114 114 114 114 114 114 114 114 114 114 114 114 114 114 114 114 29 29
29 29 29 29 29 29 29 29 29 29 29 29 29 29 29 29 29 29 29 29 29 29 29 29 29 29 29 93 29 29 29 30 29 29 32 29 29 29 30 29 29 29 114 114 114 114 114 114 114 114 114 114 114 114 114 114 114 114 114 114 114 114 29 29
29 29 29 29 29 29 29 29 29 29 29 29 29 29 29 29 29 29 29 29 29 29 111 111 111 111 111 111 111 111 111 111 111 111 111 111 111 111 111 111 111 29 29 114 114 114 114 114 114 114 114 114 114 114 114 114 114 114 114 114 114 114 29 29
29 29 29 29 29 29 29 29 29 29 29 29 29 29 29 29 29 29 29 29 29 30 111 111 111 111 111 111 111 111 111 111 111 111 111 111 111 111 111 111 111 29 29 29 29 30 29 29 29 29 29 29 31 29 29 29 29 29 30 29 29 29 29 29
29 29 29 29 29 29 29 29 29 29 29 29 29 29 29 30 29 29 29 29 29 29 91 38 17 17 17 38 17 17 17 17 91 17 17 17 17 38 17 111 111 29 29 29 29 29 29 29 29 32 29 30 29 29 29 29 29 29 29 29 114 114 114 29
29 29 29 29 29 29 29 29 29 29 29 29 108 108 108 108 108 108 108 108 108 108 108 108 108 108 108 17 115 115 17 17 115 115 17 17 111 111 111 111 111 111 111 111 111 111 111 111 111 111 111 111 111 111 111 111 111 29 29 29 114 114 114 29
29 29 29 29 29 29 29 29 29 29 29 29 108 108 108 108 108 108 108 108 108 108 108 108 108 108 108 90 115 115 17 17 115 115 38 17 111 111 111 111 111 111 111 111 111 111 111 111 111 111 111 111 111 111 111 111 111 29 29 29 31 114 114 29
29 29 29 29 29 29 29 29 29 29 29 29 108 108 17 17 17 38 17 17 17 17 38 17 17 17 17 17 115 115 17 17 115 115 17 17 17 91 17 17 38 17 111 111 17 17 38 17 17 17 91 17 17 38 17 111 111 29 29 29 114 114 114 29
29 29 29 29 29 29 29 29 29 29 29 32 108 108 17 108 108 108 108 108 108 108 17 115 115 115 115 115 115 115 115 115 115 115 115 115 115 115 115 115 115 17 111 111 111 111 111 111 38 111 111 17 17 17 17 111 111 32 29 114 114 114 114 30
29 29 29 29 29 29 29 29 29 29 29 29 108 108 38 108 108 108 108 108 108 108 17 115 115 115 115 115 115 115 115 115 115 115 115 115 115 115 115 115 115 17 111 111 111 111 111 111 17 111 111 17 38 17 17 111 111 29 114 114 114 114 114 29
29 29 29 29 29 29 29 29 29 29 29 29 108 108 17 20 17 17 17 17 38 17 17 17 91 17 17 38 17 17 17 17 17 17 17 17 17 38 17 115 115 17 17 38 17 17 111 111 17 111 111 111 111 111 17 111 111 29 114 114 114 114 114 29
29 29 29 29 29 29 29 29 29 29 29 30 108 108 17 108 108 108 108 108 108 108 108 108 108 108 108 108 108 108 108 108 17 17 17 115 115 115 115 115 115 115 115 115 115 17 111 111 17 111 111 111 111 111 38 111 111 29 114 114 114 114 114 29
29 29 29 29 29 29 29 29 29 29 29 29 108 108 38 108 108 108 108 108 108 108 108 108 108 108 108 108 108 108 108 108 38 17 17 115 115 115 115 115 115 115 115 115 115 17 111 111 17 38 17 17 111 111 17 111 111 29 114 114 114 114 114 29
29 29 29 29 29 29 29 29 29 29 29 29 108 108 17 108 108 17 38 17 17 108 108 35 39 35 91 40 40 40 108 108 17 17 38 115 115 46 42 46 42 46 42 115 115 38 111 111 111 111 111 111 111 111 38 111 111 29 114 114 114 114 114 32
29 29 29 29 29 29 29 29 29 108 108 108 108 108 17 108 108 17 17 17 17 108 108 35 35 35 115 115 40 40 108 108 17 115 115 115 115 115 115 115 115 115 46 115 115 17 111 111 111 111 111 111 111 111 17 111 111 30 29 114 114 114 29 29
29 29 29 29 29 29 29 29 29 108 108 108 108 108 17 108 108 17 108 108 108 108 108 37 115 115 115 115 115 40 108 108 90 115 115 115 115 115 115 115 115 115 42 115 115 17 111 111 42 91 17 38 17 17 17 111 111 29 29 29 29 29 29 29
29 29 29 29 29 29 29 29 29 108 108 17 108 108 38 108 108 17 108 108 108 108 108 35 115 115 36 91 36 40 40 40 40 40 40 40 40 40 40 40 115 115 46 115 115 90 111 111 46 115 115 17 17 17 17 111 111 32 29 29 29 29 29 29
29 29 29 29 29 29 29 29 29 108 108 38 108 108 17 108 108 17 108 108 17 91 35 35 115 115 40 110 110 110 110 110 110 110 110 110 110 110 110 40 115 115 42 115 115 46 42 46 42 115 115 17 17 38 17 111 111 29 29 29 29 29 29 29
29 29 29 29 29 29 29 29 29 108 108 17 108 108 20 91 20 17 108 108 17 112 112 35 115 115 40 110 110 110 110 110 110 110 110 110 110 110 110 40 115 115 46 115 115 42 46 42 46 115 115 90 111 111 111 111 111 29 29 29 29 29 29 29
29 29 29 29 29 29 29 29 30 108 108 17 108 108 108 108 108 108 108 108 17 112 112 39 115 115 40 110 110 12 12 12 11 12 12 12 12 110 110 40 115 115 42 115 115 46 42 46 42 115 115 29 111 111 111 111 111 29 29 29 29 29 29 29
29 29 29 29 29 29 29 29 29 108 108 17 108 108 108 108 108 108 108 108 17 112 112 35 115 115 40 110 110 12 12 109 109 109 109 109 12 110 110 40 115 115 46 115 115 42 46 42 46 115 115 29 29 29 29 30 29 29 29 29 29 29 29 29
29 29 29 30 29 29 29 29 29 91 18 17 38 17 17 108 108 38 108 108 17 112 112 35 115 115 40 110 110 10 13 109 109 109 109 109 12 110 110 40 115 115 42 115 115 46 115 115 115 115 115 29 29 29 29 29 29 29 29 29 29 29 29 29
29 29 29 121 121 121 121 121 121 121 121 17 17 17 20 108 108 17 108 108 38 112 112 37 115 115 40 110 110 12 12 109 109 109 109 109 23 36 91 36 115 115 46 115 115 90 115 115 115 115 115 29 29 29 29 29 29 29 29 29 29 29 29 29
29 29 121 121 121 121 121 121 121 121 121 17 17 38 17 108 108 17 108 108 38 112 112 35 115 115 40 110 110 12 12 12 11 12 23 91 40 115 115 115 115 115 42 115 115 46 42 46 46 115 115 32 29 29 29 29 29 29 29 29 29 29 29 29
32 121 121 121 121 121 121 121 121 121 121 17 108 108 108 108 108 17 108 108 17 112 112 35 115 115 40 110 110 110 110 110 110 110 110 110 40 115 115 115 115 115 46 115 115 42 46 46 46 115 115 29 29 29 29 29 29 29 29 29 29 29 29 29
29 29 121 121 121 121 121 121 121 121 121 17 108 108 108 108 108 17 108 108 17 112 112 35 115 115 40 110 110 110 110 110 110 110 110 110 40 115 115 46 42 46 42 115 115 46 42 46 42 115 115 30 29 29 29 29 29 29 29 29 29 29 29 29
29 29 29 121 121 121 121 121 121 121 121 38 108 108 20 91 20 17 108 108 17 112 112 35 115 115 40 110 110 110 110 110 110 110 110 110 40 115 115 42 46 42 46 115 115 115 115 115 46 115 115 29 29 29 29 29 29 29 29 29 29 29 29 29
29 29 29 29 29 30 29 29 29 91 18 17 108 108 17 108 108 17 108 108 38 112 112 39 115 115 40 40 40 40 40 40 40 40 36 91 36 115 115 115 115 115 115 115 115 115 115 115 42 115 115 29 29 29 29 29 29 29 29 29 29 29 29 29
29 29 29 29 29 29 29 29 29 108 108 108 108 108 38 108 108 17 108 108 17 112 112 35 115 115 115 115 115 115 115 115 115 115 115 115 115 115 115 115 115 115 115 115 115 35 115 115 46 115 115 29 29 29 29 29 29 29 29 29 29 29 29 29
29 29 29 29 29 29 29 29 29 108 108 108 108 108 17 108 108 17 108 108 90 112 112 35 115 115 115 115 115 115 115 115 115 115 115 115 115 115 115 35 39 35 35 115 115 35 115 115 42 115 115 29 29 29 29 29 29 29 29 29 29 29 29 29
29 29 29 29 29 29 29 29 29 29 29 29 108 108 17 108 108 17 17 17 17 112 112 35 35 35 39 35 35 35 49 91 49 35 35 39 35 35 35 35 35 35 35 115 115 39 115 115 46 115 115 29 29 29 29 29 29 29 29 29 29 29 29 29
29 29 29 29 29 29 29 29 29 29 29 29 108 108 17 108 108 38 17 17 17 112 112 112 112 112 112 112 112 112 112 112 35 112 112 112 112 112 112 112 112 35 115 115 115 35 115 115 115 115 115 29 29 29 29 29 29 29 29 29 29 29 29 29
29 29 29 29 29 29 29 29 29 29 29 29 108 108 17 108 108 17 17 17 38 112 112 112 112 112 112 112 112 112 112 112 39 112 112 112 112 112 112 112 112 90 115 115 115 37 115 115 115 115 115 29 29 29 29 29 29 29 29 29 29 29 29 29
29 29 29 29 29 29 29 29 29 29 29 30 108 108 17 108 108 17 17 17 17 17 17 17 91 17 17 17 91 29 112 112 35 112 112 35 37 35 35 112 112 35 35 39 35 35 35 91 35 35 95 29 29 29 29 29 29 29 29 29 29 29 29 29
29 29 29 29 29 29 29 29 29 29 29 29 108 108 38 108 108 108 108 108 17 108 108 108 108 17 17 108 108 29 112 112 112 112 112 35 35 35 39 112 112 112 112 112 112 112 112 112 35 113 113 29 29 29 29 29 29 29 29 29 29 29 29 29
29 29 29 29 29 29 29 29 29 29 29 29 108 108 17 108 108 108 108 108 90 108 108 108 108 17 38 108 108 29 112 112 112 112 112 39 35 35 35 112 112 112 112 112 112 112 112 112 39 113 113 29 29 29 29 29 29 29 29 29 29 29 29 29
29 29 29 29 29 29 29 29 29 29 29 29 108 108 17 17 17 17 108 108 17 17 38 17 17 17 17 108 108 29 29 29 33 95 33 35 35 35 35 35 35 35 35 37 35 35 35 35 35 113 113 30 29 29 29 30 29 29 29 29 29 29 29 29
29 29 29 29 29 29 29 29 29 29 29 32 108 108 108 108 108 20 108 108 108 108 108 108 108 108 108 108 108 29 29 29 113 113 113 113 113 113 113 113 113 113 113 113 113 113 113 113 113 113 113 29 29 29 113 113 113 113 29 29 29 29 29 29
29 29 29 29 29 29 29 29 29 29 29 29 108 108 108 108 108 90 108 108 108 108 108 108 108 108 108 108 108 29 29 29 113 113 113 113 113 113 113 113 113 113 113 113 113 113 113 113 113 113 113 29 113 113 113 113 113 113 113 113 29 29 29 29
29 29 29 29 29 29 29 29 29 29 29 29 29 29 29 30 29 29 29 29 29 29 32 29 29 29 29 29 29 108 108 29 29 29 29 29 29 30 29 29 32 29 29 29 29 29 29 29 29 32 29 113 113 113 113 113 113 113 113 113 29 29 29 29
29 29 29 29 29 29 29 29 29 29 29 29 29 29 29 29 29 29 29 29 29 29 29 29 29 29 29 29 108 108 108 108 29 29 29 29 29 29 29 29 29 29 29 29 29 29 29 29 29 29 29 113 113 113 113 113 113 113 113 113 29 29 29 29
29 29 29 29 29 29 29 29 29 29 29 29 29 29 29 29 29 29 29 29 29 29 29 29 29 29 29 30 108 108 108 108 29 29 29 29 29 29 29 29 29 29 29 29 29 29 29 29 29 29 30 113 113 113 113 113 113 113 113 113 32 29 29 29
29 29 29 29 29 29 29 29 29 29 29 29 29 29 29 29 29 29 29 29 29 29 29 29 29 29 29 29 29 108 108 108 29 29 29 29 29 29 29 29 29 29 29 29 29 29 29 29 29 29 29 113 113 113 113 113 113 113 113 113 29 29 29 29
29 29 29 29 29 29 29 29 29 29 29 29 29 29 29 29 29 29 29 29 29 29 29 29 29 29 29 29 29 108 108 108 30 29 29 29 29 29 29 29 29 29 29 29 29 29 29 29 29 29 29 29 113 113 113 113 113 113 113 29 29 29 29 29
29 29 29 29 29 29 29 29 29 29 29 29 29 29 29 29 29 29 29 29 29 29 29 29 29 29 29 29 29 108 108 108 29 29 29 29 29 29 29 29 29 29 29 29 29 29 29 29 29 29 29 29 29 32 29 29 29 29 29 29 29 29 29 29
29 29 29 29 29 29 29 29 29 29 29 29 29 29 29 29 29 29 29 29 29 29 29 29 29 29 29 29 29 108 108 108 29 29 29 29 29 29 29 29 29 29 29 29 29 29 29 29 29 29 29 29 29 29 29 29 29 29 29 29 29 29 29 29
29 29 29 29 29 29 29 29 29 29 29 29 29 29 29 29 29 29 29 29 29 29 29 29 29 29 29 29 30 108 108 108 32 29 29 29 29 29 29 29 29 29 29 29 29 29 29 29 29 29 29 29 29 29 29 29 29 29 29 29 29 29 29 29
29 29 29 29 29 29 29 29 29 29 29 29 29 29 29 29 29 29 29 29 29 29 29 29 29 29 29 29 29 108 108 108 29 29 29 29 29 29 29 29 29 29 29 29 29 29 29 29 29 29 29 29 29 29 29 29 29 29 29 29 29 29 29 29
29 29 29 29 29 29 29 29 29 29 29 29 29 29 29 29 29 29 29 29 29 29 29 29 29 29 29 108 108 108 108 108 108 108 29 29 29 29 29 29 29 29 29 29 29 29 29 29 29 29 29 29 29 29 29 29 29 29 29 29 29 29 29 29
29 29 29 29 29 29 29 29 29 29 29 29 29 29 29 29 29 29 29 29 29 29 29 29 29 29 108 108 108 108 108 108 108 108 108 29 29 29 29 29 29 29 29 29 29 29 29 29 29 29 29 29 29 29 29 29 29 29 29 29 29 29 29 29
29 29 29 29 29 29 29 29 29 29 29 29 29 29 29 29 29 29 29 29 29 29 29 29 29 29 108 108 108 108 108 108 108 108 108 30 29 29 29 29 29 29 29 29 29 29 29 29 29 29 29 29 29 29 29 29 29 29 29 29 29 29 29 29
29 29 29 29 29 29 29 29 29 29 29 29 29 29 29 29 29 29 29 29 29 29 29 29 29 29 108 108 108 108 108 108 108 108 108 29 29 29 29 29 29 29 29 29 29 29 29 29 29 29 29 29 29 29 29 29 29 29 29 29 29 29 29 29
29 29 29 29 29 29 29 29 29 29 29 29 29 29 29 29 29 29 29 29 29 29 29 29 29 30 108 108 108 108 108 108 108 108 108 29 29 29 29 29 29 29 29 29 29 29 29 29 29 29 29 29 29 29 29 29 29 29 29 29 29 29 29 29
29 29 29 29 29 29 29 29 29 29 29 29 29 29 29 29 29 29 29 29 29 29 29 29 29 29 29 108 108 108 108 108 108 108 29 29 29 29 29 29 29 29 29 29 29 29 29 29 29 29 29 29 29 29 29 29 29 29 29 29 29 29 29 29
29 29 29 29 29 29 29 29 29 29 29 29 29 29 29 29 29 29 29 29 29 29 29 29 29 29 29 29 29 29 29 29 29 29 29 29 29 29 29 29 29 29 29 29 29 29 29 29 29 29 29 29 29 29 29 29 29 29 29 29 29 29 29 29
