0 0 0 0 0 0 0 0 0 0 0 0 0 0 0 0 0 0 0 0 0 0 0 0 0 0 0 0 0 0 0 0 0 0 0 0 0 0 0 0 0 0 0 0 0 0 0 0 0 0 0 0 0 0 0 0 0 0 0 0 0 0 0 0
0 0 49 49 0 0 0 0 21 0 0 0 0 48 48 0 0 0 0 0 0 0 0 40 47 0 43 0 47 40 0 0 0 0 0 0 0 0 0 0 0 0 0 0 0 0 0 0 0 0 0 0 0 0 0 0 0 0 0 0 0 0 0 0
0 0 0 0 0 0 0 0 37 0 0 0 0 0 0 0 0 0 0 0 37 49 0 0 0 116 37 118 0 49 0 0 0 0 0 0 0 0 0 0 0 0 0 57 37 0 0 0 0 0 0 0 0 0 164 0 0 0 118 0 190 0 0 0
0 0 0 0 188 0 0 0 0 0 0 0 190 0 190 0 0 0 0 0 0 0 98 0 188 0 0 0 154 200 0 0 0 0 0 0 0 0 0 0 0 0 0 0 0 0 0 0 0 0 0 201 0 128 37 0 0 190 27 0 118 0 190 0
0 0 0 0 0 0 0 0 37 0 0 0 0 0 0 0 0 0 0 0 0 49 0 58 0 0 0 0 0 58 0 0 0 0 0 0 0 0 0 0 0 0 0 0 0 0 155 0 0 0 0 0 0 0 0 0 154 0 0 0 0 0 0 0
0 0 152 49 152 0 0 0 0 0 0 0 154 0 154 0 0 0 0 0 0 0 0 0 0 0 0 0 0 0 0 0 0 0 0 98 47 54 198 37 0 0 0 0 0 0 0 0 0 0 0 0 0 0 0 0 0 0 0 0 0 0 0 0
0 0 0 0 0 0 0 0 37 0 0 0 0 0 0 0 0 0 0 0 0 0 0 0 0 0 165 0 0 0 0 0 0 0 0 98 0 0 0 0 0 0 0 0 0 0 0 0 0 0 0 0 0 0 0 0 0 0 0 0 0 0 0 0
0 0 0 0 116 0 0 0 0 0 0 0 128 0 0 0 0 0 0 0 0 0 0 0 0 0 0 0 0 0 0 0 0 0 0 0 0 0 0 0 0 0 0 0 0 0 37 0 0 0 0 0 0 0 0 0 0 0 0 0 0 0 0 0
0 0 0 0 0 0 0 0 0 0 0 0 0 0 0 0 0 0 0 0 0 0 0 0 37 0 37 0 37 0 0 0 0 0 0 0 0 0 0 49 0 0 0 0 0 0 0 49 0 0 0 0 0 0 0 0 0 0 0 0 0 0 0 0
0 0 0 0 0 0 0 0 0 0 0 0 0 0 0 0 0 0 0 98 0 0 0 0 0 111 0 0 0 0 0 0 0 98 0 0 0 0 0 0 0 0 0 0 0 0 0 0 0 0 119 0 0 0 37 0 0 0 0 0 0 0 0 0
0 0 0 0 0 0 0 0 0 0 0 0 0 0 0 0 0 0 0 0 0 0 0 0 0 0 0 0 0 0 0 0 0 0 0 0 0 0 37 0 188 0 0 0 0 0 0 0 0 0 0 0 0 0 0 0 0 0 0 0 0 0 0 0
0 0 0 0 0 0 0 181 37 181 0 0 0 0 0 0 0 0 0 0 0 0 0 0 0 0 37 0 0 0 0 0 0 0 0 0 0 0 0 0 0 0 0 49 37 0 180 0 0 0 37 0 0 0 0 0 0 0 0 0 0 0 0 0
0 0 0 0 0 0 0 0 0 0 0 0 0 0 0 0 0 0 47 0 0 49 49 49 0 0 0 111 0 49 49 49 0 0 0 55 0 0 0 0 0 0 0 0 0 0 0 0 0 0 0 0 0 0 37 0 0 0 37 0 0 0 0 0
0 0 0 0 0 0 0 145 0 145 0 0 0 0 0 0 0 47 0 0 37 0 191 49 0 0 0 0 0 49 155 0 37 0 47 0 0 0 0 0 0 0 0 0 0 0 0 0 0 0 0 24 0 0 0 0 0 0 0 0 0 0 0 0
0 0 0 0 0 0 0 0 37 0 0 0 0 0 0 0 0 0 0 0 0 0 0 0 0 0 37 0 0 191 0 0 0 0 0 0 0 0 0 0 0 0 0 0 0 0 0 0 108 0 0 0 0 0 0 0 0 0 0 0 0 0 0 0
0 0 0 0 0 0 0 109 0 0 0 0 51 49 0 0 0 0 116 0 0 0 0 191 0 0 0 0 0 0 0 0 0 0 0 0 0 0 0 0 0 0 0 0 0 0 0 0 0 0 0 0 0 0 0 0 0 0 111 0 0 0 0 0
0 0 0 0 0 0 0 0 0 0 0 0 48 49 0 0 0 0 0 0 37 152 0 0 0 0 0 0 0 0 0 0 37 118 0 0 0 0 0 0 0 0 0 129 66 0 0 0 0 0 0 0 0 37 0 0 0 0 0 0 0 0 0 0
0 0 0 0 0 0 0 109 37 0 0 0 0 0 98 0 0 0 0 55 0 0 0 30 0 0 37 0 0 30 0 118 0 0 0 0 0 0 0 0 0 0 0 0 0 154 0 0 0 0 0 0 0 42 0 0 146 0 0 0 0 0 0 0
0 0 0 0 0 0 0 0 0 0 0 0 0 0 37 0 0 0 0 0 0 0 0 0 0 0 0 0 0 0 0 0 0 0 0 0 0 0 37 0 0 0 0 165 129 0 0 0 0 0 0 0 0 0 0 0 0 0 0 0 0 0 0 0
0 0 0 0 0 0 0 0 0 0 0 0 0 0 0 0 0 0 0 0 146 0 0 0 0 0 0 0 0 0 0 164 0 0 0 0 0 0 0 0 0 0 0 0 0 0 154 0 0 0 0 0 0 0 0 37 0 0 0 0 0 0 0 0
0 0 0 0 0 0 0 0 37 145 0 0 0 0 37 0 0 37 0 0 37 0 0 37 0 0 37 0 0 37 0 0 37 0 0 37 146 0 37 0 0 0 0 0 37 118 0 30 44 0 0 0 0 0 182 0 0 0 54 0 0 0 0 0
0 0 0 0 0 0 0 109 0 0 0 0 0 0 0 0 110 0 0 0 0 200 0 0 0 0 0 0 0 0 0 128 0 0 0 0 0 0 0 0 0 0 0 0 0 0 0 98 0 0 0 0 0 0 0 0 0 0 0 0 0 0 0 0
0 0 54 49 0 0 0 0 0 0 0 0 0 0 37 0 0 0 0 0 0 0 0 0 0 0 0 0 0 0 0 0 0 0 0 0 0 0 37 0 0 0 0 189 0 0 118 0 0 0 0 0 0 0 0 58 54 0 0 0 0 0 0 0
0 0 49 37 0 0 0 0 0 0 0 0 0 0 0 0 0 55 116 0 0 0 0 30 0 0 37 0 0 30 0 0 118 0 0 0 0 0 0 0 0 0 0 0 0 0 0 0 199 0 0 49 37 0 0 0 0 0 0 0 0 0 0 0
0 0 0 0 116 0 0 0 0 0 0 0 0 0 0 0 0 0 0 0 37 0 0 0 0 0 0 0 0 0 0 0 37 0 0 0 0 0 0 0 198 0 0 163 0 163 0 126 0 0 0 0 0 0 0 0 0 0 0 0 0 0 0 0
0 0 0 0 0 42 0 0 0 0 146 49 37 0 0 0 0 0 0 152 0 0 0 189 0 0 0 0 0 0 0 0 0 0 0 47 0 0 0 0 0 37 0 0 0 0 0 0 0 0 0 0 111 0 0 152 0 0 0 0 0 0 0 0
0 0 0 0 0 0 0 0 0 0 0 0 54 0 0 0 0 49 0 0 0 0 0 0 0 0 37 0 0 0 0 153 0 0 0 55 0 0 0 0 0 58 58 0 0 0 0 0 0 0 0 0 0 0 0 0 0 0 0 0 0 0 0 0
0 0 0 0 0 0 37 0 37 0 0 0 0 0 0 0 0 49 0 0 37 189 0 0 0 0 0 0 0 189 37 0 37 0 0 49 0 0 0 0 0 0 0 0 0 54 0 0 0 0 37 0 0 0 0 0 0 0 37 0 0 0 0 0
0 0 0 0 0 0 24 0 0 108 0 0 0 0 0 0 0 49 49 0 0 0 47 47 0 0 0 181 0 0 47 0 0 0 49 49 0 0 0 0 0 0 0 0 0 0 0 0 0 0 0 0 0 0 0 0 0 0 0 0 0 0 0 0
0 0 0 0 0 0 0 0 0 0 0 57 0 0 0 0 0 0 0 0 0 0 0 0 0 0 37 0 0 0 0 0 0 0 0 0 0 0 0 0 0 0 0 0 0 0 0 0 0 0 0 0 190 0 0 0 0 0 119 0 0 0 0 0
0 0 0 0 0 0 0 0 0 0 0 0 0 0 0 0 0 0 0 0 0 0 0 0 0 181 0 0 0 0 0 0 0 0 0 0 0 0 0 0 0 0 0 182 0 0 0 0 0 0 0 0 0 0 0 0 0 0 0 0 0 0 0 0
0 0 0 0 180 0 61 0 0 0 0 47 98 0 0 0 0 0 98 0 0 0 0 0 0 0 0 0 0 0 0 0 0 98 0 0 0 0 0 0 0 0 0 0 0 0 0 0 0 0 0 0 0 0 0 0 0 0 0 0 0 0 0 0
0 0 0 0 0 0 0 0 0 0 0 0 0 0 0 0 0 0 0 0 0 0 0 0 0 0 37 0 0 0 0 0 0 0 0 0 0 0 0 0 0 0 0 0 0 0 0 37 0 0 0 0 0 0 0 37 0 0 0 0 164 0 37 0
0 0 0 37 0 0 0 0 0 0 0 0 0 0 0 0 0 0 0 0 0 0 0 0 0 0 0 0 0 0 0 0 0 0 0 0 0 0 98 0 0 111 0 0 0 0 0 0 0 0 0 0 0 0 0 0 0 0 0 0 0 0 0 0
0 0 0 0 0 0 0 0 0 0 0 0 37 0 154 0 0 0 0 0 0 0 0 180 0 0 199 0 0 182 0 0 0 0 0 0 0 0 47 0 37 0 0 0 0 0 0 0 0 0 0 0 0 0 0 0 0 0 0 0 0 0 0 0
0 0 0 0 0 0 0 0 0 0 0 0 0 0 190 0 0 0 0 0 0 0 0 181 0 0 0 0 0 0 0 0 0 0 0 0 0 0 0 0 0 0 0 0 0 0 0 0 0 0 0 0 0 0 0 0 0 0 0 49 0 0 0 0
0 0 0 109 0 0 0 0 0 0 37 0 0 0 0 0 0 0 0 0 0 0 144 0 0 0 0 0 0 145 0 0 0 0 0 0 0 0 0 0 0 0 0 0 0 0 0 0 0 0 145 0 0 0 0 0 0 54 0 37 0 0 54 0
0 58 37 0 0 0 0 0 0 0 0 0 0 0 0 0 0 0 0 0 109 0 0 0 0 0 0 0 0 0 110 182 0 0 110 37 0 0 0 0 0 0 0 0 0 0 0 0 0 0 0 0 0 0 0 0 0 0 0 0 0 0 0 0
0 0 0 54 0 0 0 0 0 0 37 0 0 0 126 0 64 0 0 0 0 0 0 0 0 0 0 0 0 0 0 0 0 0 0 0 0 0 0 0 0 0 0 0 0 0 0 0 0 0 0 0 0 0 0 0 0 0 0 191 0 0 0 0
0 0 54 47 0 0 0 0 0 0 0 0 0 0 0 0 0 0 0 0 0 0 0 0 0 0 0 0 0 0 0 0 0 0 0 0 0 61 0 0 0 0 0 0 0 0 0 0 0 0 0 0 0 0 0 0 0 0 0 0 0 0 0 0
0 0 0 98 98 0 0 198 0 0 0 0 0 0 0 0 0 0 0 0 0 37 0 49 0 0 0 0 66 0 145 0 0 0 0 0 0 0 0 0 0 0 0 0 0 0 0 0 0 0 0 0 0 0 0 0 0 0 0 65 0 0 0 0
0 0 48 0 0 54 37 0 0 0 0 0 0 0 0 0 0 108 0 0 0 0 0 0 0 0 0 0 0 0 0 0 0 0 0 0 0 0 0 0 0 0 0 0 0 0 0 64 0 0 118 0 0 0 0 0 0 0 0 0 0 0 0 0
0 0 56 0 0 0 0 0 0 0 0 0 0 0 0 0 0 0 0 0 0 0 0 0 0 0 0 54 37 0 0 0 0 0 0 0 0 0 0 0 0 0 0 0 129 0 0 0 0 0 0 0 0 0 0 0 0 0 0 0 0 0 0 0
0 0 0 0 0 0 0 0 0 0 0 0 0 0 0 0 0 0 0 0 0 0 0 0 0 0 0 54 109 0 0 0 0 0 0 0 0 0 0 0 0 54 0 0 0 0 0 0 164 54 0 0 37 0 0 0 0 0 0 0 0 0 0 0
0 0 0 0 0 0 0 0 0 54 0 37 0 0 0 0 0 0 0 0 0 0 0 0 0 0 0 0 0 0 0 0 0 0 0 0 0 0 0 0 0 0 0 0 0 0 0 0 0 0 0 0 0 0 0 0 0 0 0 0 0 0 0 0
0 0 0 0 0 0 0 0 0 0 0 0 0 0 0 0 0 0 0 0 0 0 0 0 0 0 0 0 0 0 54 0 180 0 0 0 0 0 0 0 0 0 0 0 0 0 190 0 0 0 0 0 47 98 0 0 0 0 70 70 70 154 49 0
0 0 0 0 0 0 0 0 0 0 59 0 0 0 65 0 108 0 0 0 0 0 0 0 0 0 0 0 0 0 0 0 0 0 0 0 37 0 0 0 0 0 65 0 0 0 0 0 0 0 0 0 0 0 0 0 0 0 70 0 0 0 0 0
0 0 0 0 0 0 0 0 0 0 0 0 0 0 0 0 0 0 0 0 0 0 0 0 49 49 0 116 191 0 0 0 0 0 0 0 0 0 0 0 0 0 0 0 0 70 70 70 70 70 0 0 0 0 0 0 70 70 70 0 188 70 0 0
0 0 0 0 0 0 0 0 0 0 0 0 0 0 0 0 66 37 0 0 0 0 0 0 0 0 0 0 152 0 0 0 0 0 0 0 0 0 0 0 0 0 0 70 70 70 0 0 0 70 70 0 0 0 49 0 70 0 0 0 152 70 118 0
0 0 0 0 0 0 0 0 0 0 0 0 0 0 0 0 0 0 0 0 0 0 0 0 0 0 0 0 0 66 37 0 0 0 0 0 0 0 0 49 37 0 0 70 0 0 0 70 70 70 70 70 70 0 0 0 70 70 70 0 0 70 0 0
0 0 0 0 0 0 0 0 0 0 0 0 0 0 0 0 0 0 0 0 0 0 0 0 0 0 0 0 0 0 0 0 0 0 0 0 0 0 0 54 49 0 0 70 0 0 70 70 0 0 0 0 0 0 0 0 0 0 70 0 0 70 70 0
0 0 0 0 0 0 0 0 0 0 0 0 0 0 0 0 0 0 0 0 0 0 0 0 0 53 0 0 0 0 0 0 0 0 0 0 0 0 0 0 0 0 0 70 0 70 70 0 0 70 70 70 70 70 0 191 0 0 70 0 0 0 70 0
0 0 0 0 0 0 0 0 126 0 0 0 0 0 0 0 0 0 0 0 0 0 0 0 0 0 116 0 0 0 0 0 0 0 0 37 0 0 0 0 0 0 70 70 0 70 70 70 70 70 0 0 0 70 0 70 0 70 70 70 0 0 70 0
0 0 0 0 0 0 0 0 0 0 0 0 0 0 0 0 0 0 0 0 0 0 55 0 0 0 0 0 0 0 0 0 23 0 0 0 0 0 0 0 0 0 70 0 0 0 0 70 0 0 0 0 0 70 70 70 70 70 70 70 70 70 70 0
0 0 0 0 0 37 0 0 0 0 0 0 0 0 0 0 0 0 0 0 0 0 0 0 0 0 0 0 0 0 37 0 0 0 0 0 0 0 0 0 0 0 70 70 70 70 70 70 0 0 70 190 0 70 0 0 0 70 70 70 0 0 0 0
0 0 0 0 0 0 0 0 0 0 0 0 0 0 0 0 0 0 0 0 0 0 0 0 0 0 0 0 0 0 0 0 0 0 0 0 0 0 0 49 0 0 0 0 0 70 0 0 0 70 70 0 0 0 0 0 0 0 153 0 0 0 0 0
0 0 0 0 0 0 0 0 0 0 0 0 0 0 0 0 0 0 0 0 0 0 0 0 0 0 162 0 0 0 0 0 0 0 0 0 0 0 0 0 0 0 0 0 0 70 0 70 70 70 0 0 70 70 70 70 70 0 0 0 49 154 56 0
0 0 0 0 0 0 0 0 0 0 0 0 0 0 0 0 54 0 0 0 0 0 0 0 0 0 0 0 0 0 0 37 49 0 0 0 0 0 37 0 0 0 70 70 70 70 0 70 0 70 70 70 70 70 70 70 70 190 49 118 37 49 56 0
0 0 0 0 0 0 0 0 0 0 0 0 0 0 0 0 0 0 0 0 0 0 0 0 0 0 0 0 0 0 0 0 0 0 0 0 0 0 0 0 0 0 70 0 0 70 0 70 0 0 0 0 70 70 70 70 70 0 0 0 49 190 56 0
0 0 0 0 0 0 0 0 0 0 37 0 0 60 0 0 0 0 0 0 0 0 0 37 0 0 0 0 0 0 0 181 0 0 0 0 0 0 0 0 0 0 70 0 0 70 0 70 70 70 0 0 0 0 0 0 0 0 70 0 0 0 0 0
0 0 0 0 0 0 0 0 0 61 0 0 0 0 0 0 0 0 0 0 0 0 0 0 0 0 0 0 0 0 0 0 0 0 0 0 0 0 0 0 0 0 70 0 0 70 0 0 0 70 70 190 0 0 0 70 70 70 70 70 70 70 154 0
0 0 0 0 0 0 198 0 0 0 0 0 0 0 0 0 0 0 0 200 0 0 0 0 0 0 0 0 126 0 0 0 0 0 0 0 0 116 70 70 70 70 70 0 0 70 70 0 0 70 0 0 0 0 0 70 0 0 0 0 70 70 70 0
0 0 0 0 0 0 0 0 0 0 0 0 0 0 0 0 0 0 0 0 0 0 0 0 0 0 0 0 0 0 0 0 0 0 0 0 49 152 70 70 0 0 0 0 0 0 70 70 70 70 70 70 70 70 70 70 70 70 70 70 70 70 190 0
0 0 0 0 0 0 0 0 0 0 0 0 0 0 0 0 0 0 0 0 0 0 0 0 0 0 0 0 0 0 0 0 0 0 0 0 0 0 0 0 0 0 0 0 0 0 0 0 0 0 0 0 0 0 0 0 0 0 0 0 0 0 0 0
