36 45 45 45 44 44 45 44 13 44 45 45 44 45 44 45 36 36 36 36 36 36 42 42 42 42 33 42 42 42 42 42 29 29 29 29 29 29 29 29 29 29 29 29 29 31 29 29 29 29 29 29 29 29 29 29 29 29 29 29 29 29 29 29
36 44 120 120 120 120 120 120 120 120 120 120 120 120 120 45 36 36 42 42 42 42 42 111 111 42 111 42 111 111 42 42 29 29 29 29 29 29 29 29 29 29 29 29 113 113 113 113 113 29 29 29 29 29 29 42 42 42 42 42 42 42 42 42
36 45 44 44 45 44 45 120 120 120 44 45 45 44 45 45 36 36 42 111 111 111 42 111 111 111 111 111 111 111 42 42 29 29 29 29 29 29 29 29 29 29 29 113 113 29 29 29 113 113 32 29 29 113 106 42 123 123 123 123 123 42 21 42
36 44 120 120 120 120 120 120 120 120 120 120 120 120 120 45 36 36 42 111 111 111 42 111 111 111 111 111 111 111 42 42 29 29 29 29 29 29 29 113 113 113 113 113 113 113 113 29 29 113 29 106 113 106 113 94 123 123 123 123 123 100 124 21
36 45 44 45 44 45 44 120 120 120 44 44 45 45 45 45 36 36 42 111 42 111 42 111 111 42 111 42 111 111 42 42 29 29 29 29 29 29 29 113 113 29 29 29 29 29 106 32 29 113 29 113 29 113 113 42 123 123 123 123 123 42 21 42
36 45 120 120 120 120 120 120 120 120 120 120 120 120 120 45 36 36 42 111 42 42 42 42 42 42 91 42 42 42 42 29 29 113 113 29 113 113 106 113 113 113 29 29 29 29 113 29 29 113 113 113 29 29 29 42 42 42 42 42 42 42 42 42
36 45 44 45 44 45 44 120 120 120 44 45 44 44 45 45 36 36 111 111 111 36 34 34 34 109 109 109 34 34 34 34 29 29 29 29 29 29 29 29 29 113 29 29 29 29 113 113 29 29 29 29 29 29 29 29 29 29 29 29 29 29 29 29
36 45 120 120 120 120 120 120 120 120 120 120 120 120 120 45 36 36 111 111 36 36 36 34 34 109 109 109 34 34 36 36 29 29 113 113 29 29 29 29 29 113 29 31 113 113 113 113 29 29 113 113 113 113 29 29 29 29 29 29 29 29 29 29
36 45 44 44 45 45 44 120 120 120 44 45 45 45 45 44 36 36 111 36 36 36 36 40 109 109 109 109 109 40 29 29 29 29 113 113 29 29 113 113 29 113 29 29 113 29 29 113 29 29 113 29 29 113 113 29 29 29 29 29 29 29 29 29
36 36 36 36 36 34 34 91 34 91 34 34 36 36 36 36 36 36 111 36 111 111 36 36 34 109 109 109 34 36 29 113 113 29 113 29 29 29 113 29 29 113 29 29 113 30 29 29 29 29 106 29 29 29 113 113 113 113 113 113 113 113 29 29
36 36 36 36 36 34 34 108 108 108 34 34 36 36 36 36 36 36 36 36 111 36 36 36 34 109 109 109 34 36 29 29 113 29 29 29 29 29 113 113 106 113 29 29 113 29 29 31 29 29 113 29 32 29 113 29 29 29 29 29 29 113 29 29
36 36 36 36 36 34 34 106 108 106 34 34 36 36 36 36 34 34 34 34 91 34 34 34 34 109 109 109 34 34 34 34 91 34 34 34 34 29 113 29 29 29 29 113 113 113 106 113 113 113 113 113 113 113 113 113 113 113 113 29 113 113 29 29
36 36 36 36 36 34 34 108 108 108 34 34 36 36 36 36 34 109 109 109 109 109 109 109 34 109 109 109 34 109 109 109 109 109 109 109 34 29 113 29 29 29 29 29 113 29 29 30 29 29 29 29 31 29 113 29 29 29 113 113 113 29 29 29
36 36 36 36 36 34 34 106 108 106 34 34 36 36 36 36 34 109 109 109 109 109 106 109 34 109 109 109 34 109 106 109 109 109 109 109 34 29 113 113 113 113 113 113 113 29 29 29 29 29 29 113 113 113 113 113 29 29 113 29 29 29 29 29
36 36 36 36 36 34 34 108 108 108 34 36 36 36 36 36 34 109 109 109 109 109 109 109 34 109 109 109 34 106 109 109 109 109 109 109 34 29 29 29 29 29 29 29 29 29 29 29 106 113 113 113 113 29 29 113 113 113 113 113 29 29 29 29
36 36 36 36 36 34 34 106 108 108 34 36 109 109 109 36 34 109 106 109 109 109 109 106 34 109 109 109 34 109 109 109 109 109 109 109 34 29 29 29 29 29 36 36 36 36 29 29 113 29 29 113 113 113 29 29 29 29 106 113 29 29 29 29
36 36 36 36 36 34 34 108 108 108 34 36 109 109 109 36 34 109 109 109 109 106 109 109 34 109 109 109 34 109 109 109 109 106 109 109 34 36 36 36 36 36 36 106 112 36 36 29 113 113 29 29 29 113 29 32 29 29 113 113 29 29 29 29
36 36 36 36 36 34 34 106 108 108 34 36 36 36 40 36 34 109 109 109 109 109 109 109 109 109 109 109 109 109 109 106 109 109 109 109 34 36 40 36 36 36 36 112 112 106 36 29 29 113 113 113 113 113 113 113 106 113 113 29 29 29 29 29
36 36 36 36 36 34 34 108 108 108 34 34 34 34 109 34 34 34 34 34 34 34 34 109 109 109 109 109 109 109 34 34 34 34 34 34 34 34 109 34 34 34 36 106 106 36 36 36 29 29 29 29 29 29 29 113 29 29 29 29 29 29 29 29
36 36 36 36 36 34 34 108 108 108 108 34 109 109 109 109 109 109 109 109 109 109 109 109 109 109 109 109 109 109 109 109 109 109 109 109 109 109 109 109 109 92 112 112 112 112 106 36 36 36 29 29 29 30 29 113 29 29 29 29 29 29 29 29
36 36 36 36 36 34 34 108 108 106 108 90 109 109 109 109 109 109 109 109 109 109 109 109 109 109 109 109 109 109 109 109 109 109 109 109 109 109 109 109 109 36 112 112 112 106 112 112 112 36 36 29 113 113 106 113 113 113 113 29 29 29 29 29
19 19 19 19 19 19 34 106 108 108 108 34 109 109 109 109 109 109 109 109 109 109 109 109 109 109 109 109 109 109 109 109 109 109 109 109 109 109 109 109 109 92 112 112 112 112 112 36 112 112 36 31 113 29 29 29 29 29 29 29 29 29 29 29
19 19 141 141 25 19 34 34 34 34 34 34 34 34 109 34 34 34 34 34 34 34 34 109 109 109 109 109 109 109 34 34 34 34 34 34 34 34 109 34 34 34 36 106 112 112 106 36 112 36 29 29 113 29 29 113 113 29 29 29 29 29 29 29
19 19 141 141 19 19 36 36 36 36 36 36 36 36 40 36 34 109 106 109 109 109 109 109 109 109 109 109 109 109 109 109 106 109 109 109 34 36 40 36 36 36 36 112 112 112 36 36 106 36 29 113 113 113 113 113 113 29 29 29 29 29 29 29
19 19 19 141 141 19 19 19 19 19 19 19 19 19 19 36 34 109 109 109 109 109 109 109 34 109 109 109 34 109 109 109 109 109 109 109 34 36 36 36 106 112 112 106 112 106 36 106 112 36 29 29 113 29 29 29 113 29 29 29 29 29 29 29
19 19 25 141 141 141 19 19 19 141 106 141 141 19 19 36 34 109 109 106 109 109 109 106 34 109 109 109 34 109 109 109 109 109 109 109 34 36 36 36 112 112 112 36 36 36 36 36 36 36 29 29 106 31 29 113 113 29 29 29 29 29 29 29
19 19 19 19 141 141 141 19 141 141 19 19 141 25 19 36 34 109 109 109 109 109 109 109 34 109 109 109 34 109 109 106 109 109 109 109 34 36 36 36 112 112 112 36 29 29 29 29 29 29 29 113 113 29 29 113 29 29 29 29 29 29 29 29
19 19 19 19 19 19 141 141 141 19 19 19 19 19 19 36 34 109 109 109 109 106 109 109 34 109 109 109 34 106 109 109 109 109 109 109 34 36 36 36 36 36 36 36 29 113 113 113 113 113 113 113 29 29 113 113 113 113 113 29 29 29 29 29
19 19 19 19 19 19 141 141 141 106 141 141 19 19 19 36 34 109 109 109 109 109 109 109 34 109 109 109 34 109 109 109 109 109 109 109 34 29 29 29 29 29 29 29 29 29 29 29 29 29 113 29 29 29 29 29 29 29 113 29 29 29 29 29
19 19 19 19 19 141 141 141 19 19 141 141 141 25 19 36 34 34 34 91 34 34 34 34 34 109 109 109 34 34 34 34 91 34 34 34 34 29 29 29 29 29 29 29 29 29 29 29 29 32 113 113 113 113 113 113 29 29 106 29 29 29 29 29
19 19 19 19 141 141 19 19 19 19 19 141 141 19 19 19 19 19 19 141 19 19 36 36 34 109 109 109 34 36 29 29 113 29 29 29 29 29 29 29 29 113 113 106 113 113 29 29 29 29 113 29 29 29 29 113 29 29 113 29 29 29 29 29
19 25 141 141 106 141 141 19 19 19 25 141 19 141 141 141 141 141 19 141 141 19 36 34 34 109 109 109 34 34 29 113 113 29 113 113 113 113 113 29 113 113 29 29 29 113 113 113 29 29 113 30 29 29 29 113 29 29 113 29 29 29 29 29
19 19 141 19 19 19 141 25 19 19 19 141 141 19 19 19 19 25 19 19 19 19 36 34 34 109 109 109 34 34 29 29 29 29 29 29 29 113 113 29 29 113 32 29 29 29 113 113 113 113 113 29 29 29 29 113 113 113 113 113 106 113 113 29
19 19 141 141 141 19 141 19 19 19 19 19 141 19 19 19 19 19 19 19 19 19 19 19 34 109 109 109 34 36 29 29 29 29 29 29 29 29 30 29 113 106 31 29 29 29 29 113 29 31 29 29 29 29 113 113 29 29 29 29 29 29 113 29
19 19 19 141 19 25 141 141 19 19 141 141 141 141 106 19 19 19 19 19 19 19 19 141 90 109 109 109 90 113 29 29 29 29 29 113 113 113 113 113 113 113 29 29 29 29 29 113 29 29 29 29 29 29 113 113 29 29 29 29 29 29 113 29
19 25 19 141 19 19 19 141 141 141 141 141 141 141 106 19 19 19 19 19 19 19 19 141 19 34 34 34 29 113 29 29 29 29 31 113 29 29 113 113 113 113 29 29 29 29 29 113 113 113 113 29 29 29 29 113 29 29 29 113 29 113 113 29
19 141 141 141 19 19 19 19 19 19 141 19 19 19 19 19 19 19 19 19 141 141 141 141 19 34 34 34 29 113 29 32 29 29 29 113 29 29 29 29 29 113 113 113 29 29 29 29 29 29 106 29 29 29 29 113 29 113 113 113 29 29 113 29
19 141 141 19 19 19 19 19 19 141 141 19 19 19 19 19 19 19 19 19 141 19 19 19 19 19 19 29 29 113 113 113 113 113 113 113 29 29 29 29 29 29 29 113 113 29 29 29 29 29 113 29 29 29 29 113 29 29 29 113 29 29 29 29
19 19 141 141 19 19 19 19 141 141 141 141 141 141 106 141 141 19 19 25 141 19 19 19 19 19 19 29 29 29 29 113 29 29 29 113 113 113 29 29 29 29 29 29 113 113 29 29 29 29 113 113 113 113 113 113 29 29 29 106 29 29 29 29
19 25 141 141 19 19 19 19 141 19 141 19 19 19 19 19 141 19 19 19 141 141 19 19 19 29 29 29 29 29 113 113 29 29 29 29 29 113 113 113 29 29 29 29 29 113 113 113 29 29 29 29 29 29 29 29 29 29 29 113 29 29 29 29
19 19 19 19 19 141 141 106 141 19 141 141 141 141 19 19 141 141 19 141 141 141 141 141 19 29 29 29 113 113 106 29 29 29 29 29 29 113 29 113 113 29 29 29 29 29 29 113 29 29 29 29 29 29 29 29 29 29 113 113 29 29 29 29
19 19 141 141 19 141 141 141 19 19 19 19 19 141 19 19 141 106 141 141 19 19 141 19 19 29 29 29 113 29 29 29 29 29 29 113 113 113 29 29 113 113 29 29 29 29 29 113 113 113 106 113 113 29 29 29 29 113 113 113 29 29 29 29
19 19 141 141 19 19 19 25 19 19 19 19 19 141 19 19 19 19 25 19 19 19 141 19 29 29 29 113 113 113 113 113 113 113 113 113 29 29 29 29 29 113 29 29 106 29 29 113 29 29 29 29 113 29 29 29 113 113 113 29 29 29 29 29
19 19 19 19 19 19 19 19 19 25 19 141 141 141 25 19 19 19 19 19 19 141 141 25 29 29 29 113 106 29 29 29 29 29 29 29 29 29 29 29 29 113 29 29 113 29 29 113 106 113 29 29 113 113 113 113 113 29 29 29 29 29 29 29
19 19 19 19 19 19 19 19 19 141 141 141 19 19 19 19 19 19 19 19 19 141 141 19 29 29 29 29 29 29 29 29 29 29 29 29 29 29 29 29 29 29 29 29 113 29 29 29 29 29 29 29 113 29 29 29 29 29 29 29 29 29 29 29
19 19 19 19 19 19 19 19 19 19 141 141 141 141 141 19 19 19 19 19 141 141 19 19 29 29 29 29 29 29 113 113 106 113 113 113 29 29 29 29 29 29 29 113 113 113 113 113 113 113 113 113 113 30 113 113 29 29 113 113 113 106 113 29
19 19 19 19 19 19 19 19 19 19 141 141 141 141 141 141 141 141 141 141 141 19 19 29 29 29 29 29 29 29 29 29 29 29 113 113 113 113 113 29 29 113 113 113 29 29 29 29 29 29 29 29 29 29 113 29 29 29 113 29 29 29 29 29
19 19 19 19 19 19 19 19 19 19 19 19 19 19 19 19 19 141 141 19 25 19 19 29 113 113 113 113 113 113 29 29 29 29 113 113 29 29 113 113 113 113 29 29 29 113 113 113 113 113 29 29 29 29 113 29 113 113 113 29 106 113 29 29
19 19 19 19 19 19 19 19 19 19 19 19 19 25 141 141 141 141 19 19 19 19 19 29 29 29 29 113 113 113 113 29 29 113 113 29 29 29 29 29 113 29 29 113 113 113 29 29 29 113 113 29 29 29 113 29 113 29 29 29 106 113 106 29
19 19 19 19 19 19 19 19 19 19 19 19 19 19 141 141 19 141 141 19 19 19 19 29 29 29 29 29 113 113 113 113 113 113 29 29 29 29 29 113 113 29 29 113 29 29 29 113 113 113 113 113 113 113 113 29 113 113 113 29 29 113 29 29
19 19 19 19 19 19 19 19 19 19 19 141 141 141 141 141 19 19 141 141 19 19 19 19 29 29 29 29 29 113 113 29 29 29 29 29 29 29 29 113 113 29 29 113 29 29 113 113 29 29 29 29 29 29 29 29 29 29 113 29 29 113 113 29
19 19 19 19 19 19 19 19 19 141 141 141 141 19 141 141 19 19 19 141 141 141 19 19 29 113 113 29 29 29 113 113 113 29 29 113 29 29 29 29 29 29 29 113 29 113 113 29 29 113 113 113 113 113 29 106 29 29 113 29 29 29 113 29
19 19 19 19 19 141 141 141 106 141 141 141 19 19 141 19 19 19 19 19 141 141 19 19 29 29 106 113 29 29 29 29 113 113 113 113 113 113 113 29 29 29 113 113 29 113 113 113 113 113 29 29 29 113 29 113 29 113 113 113 29 29 113 29
19 19 19 19 141 141 141 19 19 19 25 19 19 19 25 19 19 19 19 25 141 141 141 19 29 29 29 113 113 113 29 113 113 113 113 113 113 113 113 29 29 29 113 29 29 29 29 113 29 29 29 29 29 113 113 113 113 113 113 113 113 113 113 29
19 19 19 25 141 141 19 19 19 19 19 19 19 19 19 19 19 19 19 19 19 19 25 19 29 29 29 29 113 113 113 113 113 113 29 29 29 113 113 113 29 29 113 113 113 113 113 113 29 29 113 106 29 113 29 29 29 113 113 113 29 29 29 29
19 19 19 19 141 141 141 19 19 19 19 19 19 19 19 19 19 19 19 19 19 19 19 19 29 29 29 29 29 29 113 113 29 29 29 29 29 29 113 113 29 29 29 29 29 113 29 29 29 113 113 29 29 29 29 29 29 29 106 29 29 29 29 29
19 19 19 19 141 141 141 141 141 141 19 19 19 19 25 19 19 19 29 29 29 29 29 29 29 113 113 113 113 113 113 113 29 29 29 29 29 29 113 29 29 29 29 29 29 113 29 113 113 113 29 29 113 113 113 113 113 29 29 29 113 106 113 29
19 19 19 19 19 19 141 141 141 141 141 19 141 141 141 141 141 19 29 29 29 29 29 29 113 113 29 29 29 113 113 113 113 29 29 29 29 29 113 113 29 29 113 113 113 113 29 113 29 113 113 113 113 113 113 113 113 106 113 106 113 113 113 29
19 19 19 19 19 19 19 25 19 141 141 141 141 141 19 19 19 19 29 29 29 29 113 113 113 113 29 29 29 29 29 113 29 29 29 29 29 113 113 113 113 29 113 29 29 113 29 113 29 29 29 29 113 113 113 113 113 29 29 29 113 106 113 29
19 19 19 19 19 19 19 19 19 141 141 141 141 141 19 29 29 29 29 29 29 113 113 113 113 29 29 29 29 29 29 106 29 29 29 113 113 113 113 113 113 29 113 29 29 113 29 113 113 113 29 29 29 29 29 29 29 29 113 29 29 29 29 29
19 19 19 19 19 19 19 19 141 141 141 19 19 19 19 29 29 29 29 29 113 113 113 113 113 29 29 29 29 29 29 113 113 113 113 113 29 29 29 29 29 29 113 29 29 113 29 29 29 113 113 106 29 29 29 113 113 113 113 113 113 113 106 29
19 19 19 19 19 19 106 141 141 141 141 141 141 19 19 19 29 113 113 113 113 113 29 29 113 113 113 113 106 113 113 113 29 29 29 29 29 106 113 113 113 113 113 29 29 113 113 29 29 113 29 29 29 29 29 113 29 29 29 29 113 113 113 29
19 19 19 19 19 19 19 19 19 25 19 19 141 141 141 90 113 113 113 29 29 29 29 29 29 29 29 29 29 29 29 29 29 29 29 29 113 106 113 113 29 29 29 29 29 29 113 113 113 113 113 113 113 113 113 113 113 113 113 113 113 113 106 29
19 19 19 19 19 19 19 19 19 19 19 19 19 19 19 19 29 29 29 29 29 29 29 29 29 29 29 29 29 29 29 29 29 29 29 29 29 29 29 29 29 29 29 29 29 29 29 29 29 29 29 29 29 29 29 29 29 29 29 29 29 29 29 29
