29 29 29 29 29 29 29 29 29 29 29 29 29 29 29 29 29 29 29 29 29 29 29 29 29 29 29 29 29 29 29 29 29 29 29 29 29 29 29 29 29 29 29 29 29 29 29 29 29 29 29 29 29 29 29 29 29 29 29 29 29 29 29 29
29 29 29 29 29 29 29 29 29 29 29 29 29 29 29 29 29 29 29 29 29 29 29 29 29 29 29 29 29 29 29 29 29 29 29 29 29 29 29 29 29 29 29 29 29 29 29 29 29 29 29 29 29 29 29 29 29 29 29 29 29 29 29 29
29 29 29 29 29 29 29 29 29 29 29 29 29 29 29 29 29 29 29 29 29 29 29 29 29 29 29 29 29 29 29 29 29 29 29 29 29 29 29 29 29 29 29 29 29 29 29 29 29 29 29 29 29 29 29 29 29 29 29 29 29 29 29 29
29 29 29 29 29 29 29 29 29 29 29 29 29 29 29 29 29 29 29 29 29 29 29 29 29 29 29 29 29 29 29 29 29 29 29 29 29 29 29 29 29 29 29 29 29 29 29 29 29 29 29 29 29 29 29 29 29 29 29 29 29 29 29 29
29 29 29 29 29 29 29 29 32 29 29 29 29 30 29 29 29 31 29 29 29 29 29 29 29 29 29 29 29 29 29 29 29 29 29 30 29 29 29 29 29 29 29 29 29 29 29 29 29 29 29 29 29 30 29 29 29 29 31 29 29 29 29 29
29 29 29 29 29 29 29 108 108 108 108 108 108 108 108 108 108 108 108 108 108 108 108 30 29 29 29 29 29 29 29 108 108 108 108 108 108 108 108 108 108 29 29 29 29 29 29 29 29 29 29 29 108 108 108 108 108 108 108 108 108 29 29 29
29 29 29 29 29 30 108 108 108 108 108 108 108 108 108 108 108 108 108 108 108 108 108 108 29 29 29 29 29 29 108 108 108 108 108 108 108 108 108 108 108 108 29 29 29 29 29 29 29 29 32 108 108 108 108 108 108 108 108 108 108 108 29 29
29 29 29 29 29 29 108 108 108 108 108 108 108 108 108 108 108 108 108 108 108 108 108 108 29 31 29 32 30 29 108 108 108 108 108 108 108 108 108 108 108 108 29 30 29 29 29 31 29 29 29 108 108 108 108 108 108 108 108 108 108 108 29 29
29 29 29 29 29 31 108 108 108 2 1 2 1 2 2 2 1 2 1 2 1 108 108 108 108 108 108 108 108 108 108 108 108 2 1 2 1 2 1 108 108 108 108 108 108 108 108 108 108 108 108 108 108 108 1 2 1 2 1 108 108 108 30 29
29 29 29 29 29 29 108 108 108 1 110 110 110 2 1 2 110 110 110 2 2 108 106 108 108 108 108 108 108 108 108 108 108 1 112 112 112 112 2 108 108 108 108 108 108 108 108 108 108 108 108 108 108 108 2 113 113 113 2 108 108 108 29 29
29 29 29 29 29 29 108 108 108 2 110 110 110 1 6 1 110 110 110 1 1 108 108 108 108 108 108 108 108 108 108 108 108 2 112 112 112 112 1 108 108 108 108 108 108 108 108 108 108 108 108 108 108 108 1 113 113 113 1 108 108 108 29 29
29 29 29 29 29 29 108 108 108 1 110 110 110 110 110 110 110 110 110 6 1 2 1 2 6 2 1 2 1 2 6 2 1 2 1 1 112 112 1 2 1 2 1 2 1 2 1 2 1 2 1 2 1 2 1 6 2 1 2 108 108 108 32 29
29 29 29 29 29 30 108 108 108 2 110 110 110 110 110 110 110 110 110 1 110 110 110 110 110 110 110 110 110 110 110 110 110 110 110 2 112 112 112 1 112 112 112 112 112 112 3 113 113 113 113 113 113 113 2 106 113 113 1 108 108 108 29 29
29 29 29 29 29 29 108 108 108 1 3 91 3 1 110 110 110 110 110 2 110 106 110 110 110 110 110 110 110 110 110 110 110 110 110 6 112 112 112 90 112 112 112 112 112 112 90 113 113 113 113 113 113 113 1 113 113 113 2 108 108 108 29 29
29 29 29 29 29 29 108 108 108 2 109 109 109 1 2 1 91 2 1 1 40 40 40 36 91 36 40 40 40 36 91 36 40 110 110 2 112 112 112 1 112 112 112 112 112 112 3 113 113 113 113 113 113 113 2 113 113 113 1 108 106 108 31 29
29 29 29 29 108 108 108 108 108 1 109 109 109 1 110 110 110 110 110 110 36 110 110 110 110 110 110 36 110 110 110 110 36 110 110 1 112 112 112 1 106 112 112 112 112 112 1 2 1 2 91 1 91 2 1 113 113 113 2 108 108 108 29 29
29 29 30 108 108 108 108 108 108 2 109 109 109 2 110 110 110 110 110 110 90 110 110 110 110 110 110 90 110 110 110 110 90 110 110 2 28 91 28 1 112 112 112 112 112 112 112 112 112 1 113 113 113 113 113 113 113 113 1 108 108 108 29 29
29 29 29 108 108 108 108 108 108 1 109 109 109 1 110 110 110 110 110 110 36 110 110 110 110 110 110 36 110 110 110 110 36 110 110 1 111 111 111 2 112 112 112 112 112 112 112 112 112 2 113 113 113 113 113 113 113 113 2 108 108 108 30 29
29 29 31 108 108 108 2 1 2 1 109 109 109 3 1 2 1 2 1 2 40 40 40 40 40 40 40 40 40 40 40 40 40 110 110 2 111 111 111 1 112 112 112 112 112 112 112 112 112 1 113 113 113 1 2 1 2 1 1 108 108 108 29 29
29 29 29 108 108 108 1 109 109 109 109 109 109 109 109 109 109 109 44 1 110 110 110 110 110 110 110 110 110 110 110 110 110 110 110 6 111 111 111 2 1 2 1 2 1 1 91 1 2 1 113 113 113 2 108 108 108 108 108 108 108 108 29 29
29 29 29 108 108 108 6 109 109 109 109 109 109 109 109 109 106 109 45 3 110 106 110 110 110 110 110 110 110 110 110 110 110 110 110 2 111 111 111 1 114 114 114 114 1 113 113 113 113 113 113 113 113 1 108 108 108 108 108 108 108 108 29 29
29 29 29 108 108 108 1 109 109 45 44 45 91 44 45 44 109 109 44 1 91 3 2 1 2 1 2 1 2 1 2 1 2 1 2 1 111 111 111 6 114 114 114 114 2 113 113 113 113 113 113 113 113 2 108 108 108 108 108 108 108 29 29 29
29 30 108 108 108 108 2 109 109 44 109 109 109 109 109 45 109 109 45 2 111 111 111 111 111 111 111 111 111 111 111 3 106 111 111 111 111 111 111 1 114 114 114 114 1 113 113 113 113 113 113 113 113 1 108 108 108 29 31 29 29 29 29 29
29 108 108 108 108 108 1 44 45 45 109 109 109 109 109 44 109 109 44 1 111 111 111 111 111 111 111 111 111 111 111 90 111 111 111 111 111 111 111 2 6 2 1 2 1 113 113 113 113 113 1 113 113 2 108 108 108 29 29 29 29 29 29 29
32 108 108 108 108 108 2 109 109 44 109 109 109 109 109 45 109 109 45 1 4 1 2 111 111 111 111 111 111 111 111 3 106 111 111 111 111 111 111 1 114 114 114 106 1 113 113 113 113 113 2 113 113 1 108 106 108 29 29 29 29 29 29 29
29 108 108 108 2 1 1 109 109 45 44 45 91 45 44 44 44 45 44 45 45 45 44 1 2 1 2 1 2 1 2 1 2 1 2 1 2 4 2 1 114 114 114 114 2 113 113 113 113 113 1 113 113 2 108 108 108 30 29 29 29 29 29 29
29 108 108 108 1 44 45 109 109 44 109 109 109 109 45 45 108 108 108 108 108 108 108 44 35 35 35 35 35 39 35 35 37 35 35 35 39 35 35 114 114 114 114 114 1 2 3 91 3 1 2 106 113 1 108 108 108 29 29 32 29 29 29 29
31 108 108 108 2 45 109 109 109 45 109 109 109 109 44 108 108 106 106 106 106 106 108 45 37 114 114 114 114 114 114 114 114 114 114 114 114 114 49 114 114 114 114 114 114 114 114 114 114 114 1 113 113 2 108 108 108 108 108 108 108 29 29 29
29 108 108 108 1 44 109 109 109 44 109 109 109 109 45 108 108 108 108 108 108 108 108 44 35 114 114 114 114 114 114 114 114 114 114 114 114 114 39 114 114 114 114 114 114 114 114 114 114 114 6 113 113 1 108 108 108 108 108 108 108 108 29 29
29 108 106 108 2 45 109 109 109 45 109 109 109 109 44 108 108 106 108 108 108 106 45 33 114 114 114 114 35 35 39 106 35 35 114 114 114 114 90 114 114 114 114 114 114 114 114 114 114 114 1 1 2 2 108 108 108 108 108 108 108 108 29 29
29 108 108 108 1 44 109 109 109 44 106 109 109 109 45 108 108 108 108 108 108 108 108 90 114 114 114 114 39 35 35 35 35 35 114 114 114 114 35 2 1 2 1 2 1 2 1 2 1 2 1 113 113 1 2 1 2 1 2 108 108 108 30 29
29 108 108 108 2 44 45 44 45 45 109 109 109 109 44 108 108 45 108 108 108 106 108 44 35 35 37 35 2 1 2 1 2 1 35 35 37 35 35 1 2 1 2 1 2 1 2 1 2 1 1 113 113 113 113 113 113 113 1 108 108 108 29 29
30 108 108 108 1 2 1 2 1 44 45 44 91 44 45 44 45 45 45 44 45 44 45 44 45 44 45 44 108 108 108 108 108 1 2 1 2 1 2 1 108 108 108 108 108 108 108 108 108 1 2 1 2 1 2 1 2 1 2 108 108 108 29 29
29 108 108 108 108 108 108 108 108 30 32 108 108 108 108 108 108 108 108 108 108 108 108 108 108 108 108 108 108 108 108 108 108 108 108 108 108 108 108 108 108 106 108 108 108 108 108 108 108 108 108 108 108 108 108 108 108 108 108 108 108 108 31 29
29 29 108 108 108 108 108 108 108 13 29 108 108 108 108 108 108 108 108 108 108 108 108 108 106 108 108 108 108 108 108 108 108 108 108 108 108 108 108 108 108 108 108 108 108 108 108 108 108 108 108 108 108 108 108 108 108 108 108 108 108 108 29 29
29 29 108 108 108 108 108 108 108 29 31 108 108 108 108 108 108 108 108 108 108 108 108 108 108 108 108 108 108 1 2 1 108 108 108 108 108 108 108 108 108 1 1 2 1 2 1 2 1 2 1 2 1 2 1 2 1 108 108 108 108 29 29 29
29 29 29 29 29 29 30 29 29 32 108 108 108 108 108 1 2 1 2 1 2 1 2 1 2 1 2 1 2 1 119 4 1 2 1 2 1 2 1 2 1 17 17 17 17 17 17 17 17 17 17 17 17 17 17 17 17 29 29 30 29 29 29 29
29 29 108 108 108 108 108 108 108 108 108 108 108 108 108 42 42 46 42 1 120 120 120 6 120 120 120 120 120 1 119 119 119 119 119 119 119 119 1 17 17 116 116 116 116 116 116 116 116 20 116 116 116 116 116 116 18 108 108 108 108 108 29 29
29 29 108 108 108 108 108 106 108 108 108 108 108 108 108 46 122 122 42 4 120 120 120 90 120 120 120 120 120 90 119 119 119 119 119 119 119 119 6 17 116 116 116 116 116 116 116 116 116 90 116 116 116 116 116 116 92 108 108 108 108 108 108 29
29 108 108 108 108 108 108 108 108 108 108 108 108 108 108 42 122 122 46 1 120 120 120 6 120 120 120 120 120 2 119 119 119 119 119 119 119 119 1 17 116 116 116 116 116 116 116 116 116 20 116 116 116 116 116 116 18 108 108 108 106 108 108 31
29 108 108 108 42 46 42 46 42 46 42 46 42 46 42 46 122 122 42 2 120 120 120 1 120 120 120 120 120 1 119 119 119 119 1 2 1 2 8 17 116 116 116 116 116 116 116 116 116 17 17 17 17 17 17 17 17 2 1 2 108 108 108 29
31 108 108 108 42 123 123 123 42 122 122 122 106 122 122 122 122 122 46 1 120 120 120 2 2 1 2 1 2 6 119 119 119 119 2 8 9 8 8 17 116 116 116 116 116 116 116 116 116 17 117 117 117 117 17 2 1 2 6 2 108 108 108 29
29 108 108 108 46 123 123 123 94 122 122 122 106 122 106 122 122 122 42 2 120 120 120 1 119 119 119 119 119 119 119 119 119 119 28 8 119 119 9 17 17 17 17 18 116 116 116 116 116 17 117 117 117 117 17 1 108 108 108 108 108 108 108 29
29 108 108 108 42 123 123 123 42 122 122 122 106 122 122 122 122 122 46 6 120 120 120 6 119 119 119 119 119 119 119 119 119 119 90 119 119 119 8 9 8 9 8 8 91 18 17 17 17 17 117 117 117 117 17 2 108 108 108 108 108 108 108 30
29 108 108 108 46 123 123 123 46 46 42 46 42 46 42 91 46 91 42 1 2 91 1 1 119 119 119 119 119 119 119 119 119 119 28 8 119 119 119 119 119 119 119 9 117 117 117 117 117 117 117 117 117 117 17 1 108 108 108 108 108 108 29 29
32 108 108 108 42 123 123 123 42 42 42 42 42 46 122 122 122 122 46 1 121 121 121 1 119 119 119 119 119 119 119 119 119 119 1 9 119 119 119 119 119 119 119 8 117 117 117 117 117 117 117 117 117 117 17 2 108 108 108 31 29 32 29 29
29 108 108 108 46 123 123 123 123 46 21 21 42 42 122 122 122 122 42 2 121 121 121 2 1 1 2 1 2 1 91 2 1 2 1 8 119 119 119 119 119 119 119 9 117 117 117 117 117 117 117 117 117 117 17 1 108 108 108 29 29 29 29 29
29 108 108 108 42 123 123 123 123 100 123 106 21 46 122 122 122 122 46 1 121 121 121 121 121 1 119 119 119 119 119 119 119 119 1 8 41 91 41 9 8 8 8 9 8 9 8 9 8 91 9 91 8 91 8 2 108 108 108 108 108 108 30 29
30 108 108 108 46 123 123 123 123 46 21 21 42 42 122 122 122 122 42 2 121 121 121 121 121 6 119 119 119 119 119 119 119 119 119 119 119 119 119 90 118 118 118 1 118 118 118 8 117 117 117 117 117 117 9 1 108 108 108 108 108 108 108 29
29 108 108 108 42 123 123 123 42 42 42 42 42 46 122 122 122 122 46 3 121 121 121 121 121 1 119 119 119 119 119 119 119 119 119 119 119 119 119 2 118 118 118 90 118 118 118 9 117 117 117 117 117 117 8 2 108 108 108 108 108 108 108 29
29 108 108 108 46 123 123 123 46 42 46 42 46 42 46 91 42 91 42 2 121 121 121 121 121 2 1 2 1 3 1 2 2 119 119 119 119 119 119 1 118 118 118 1 118 118 118 8 117 117 117 117 117 117 9 2 1 2 1 6 108 106 108 29
29 108 108 108 42 42 46 42 42 42 122 122 122 122 122 122 122 122 46 1 121 121 121 121 121 121 121 121 121 121 121 121 6 2 1 2 1 2 1 2 118 118 118 6 118 118 118 8 9 8 9 8 117 117 8 9 8 9 8 2 108 108 108 29
31 108 108 108 108 108 108 108 108 46 122 122 122 122 122 122 122 122 42 2 121 121 121 121 121 121 121 121 121 121 121 121 2 118 118 118 118 118 118 118 118 118 118 90 118 118 118 118 118 118 118 90 117 117 117 117 117 117 8 1 108 108 108 31
29 108 108 108 108 108 108 108 108 42 42 46 42 46 122 122 122 122 46 1 121 121 121 121 121 121 121 121 121 121 121 121 6 118 118 118 118 118 118 118 118 118 118 6 118 118 118 118 118 118 118 9 8 9 8 9 8 9 8 2 108 108 108 29
29 29 108 108 108 108 108 108 108 108 108 108 108 42 122 122 122 122 42 1 2 1 6 91 6 2 2 2 3 2 2 2 2 118 118 118 118 118 118 118 118 118 118 1 118 118 1 2 1 2 1 2 1 2 1 2 1 2 1 1 108 108 108 30
29 29 29 29 30 29 108 108 108 106 108 108 108 46 122 122 122 122 46 42 121 121 121 121 121 121 1 2 1 2 1 2 1 2 1 2 1 2 1 2 3 2 91 2 118 118 2 1 2 108 108 108 108 108 108 108 108 108 108 2 108 108 108 29
29 29 108 108 108 29 29 108 108 108 108 108 108 42 122 122 122 122 122 90 121 121 121 121 121 121 3 108 108 108 108 108 108 108 108 108 108 108 2 118 118 118 118 118 118 118 1 108 108 108 108 108 108 108 108 108 108 108 108 1 108 108 108 29
29 108 108 108 108 108 29 29 32 29 108 108 108 46 122 122 122 122 122 46 121 121 121 121 121 121 1 108 108 108 108 108 108 108 108 108 108 108 1 118 118 118 118 118 118 118 2 108 108 108 108 108 108 108 108 108 108 108 108 2 108 108 108 32
29 108 108 108 108 108 108 108 29 31 108 108 108 42 42 46 42 46 42 42 121 121 121 121 121 121 2 108 108 108 108 108 108 108 108 108 108 108 2 2 1 2 4 2 1 2 1 108 108 108 29 31 29 30 29 29 108 108 108 6 108 108 108 31
29 108 108 108 108 108 29 29 29 29 108 108 108 108 108 108 108 108 108 2 1 2 1 3 1 2 1 108 108 108 29 31 30 29 29 108 108 108 108 108 108 108 108 108 108 108 108 108 108 108 29 29 108 108 108 32 108 106 108 108 108 108 108 29
29 108 108 108 108 108 29 108 108 30 108 108 108 108 108 108 108 108 108 108 108 108 108 108 108 108 108 108 108 108 29 29 29 29 29 108 108 108 108 108 108 108 108 106 108 108 108 108 108 108 29 29 108 108 108 29 108 108 108 108 108 108 108 29
29 108 108 108 108 108 108 108 108 108 29 108 108 108 108 108 108 108 108 108 108 108 106 108 108 108 108 108 108 108 32 29 29 29 29 29 108 108 108 108 108 108 108 108 108 108 108 108 108 29 29 108 108 108 108 29 29 108 108 108 108 108 29 29
29 29 108 108 108 108 108 108 108 108 29 29 29 31 29 29 108 108 108 108 108 108 108 108 108 108 108 108 108 29 29 29 29 29 29 29 30 29 29 29 31 29 29 32 29 29 30 29 29 29 108 108 108 108 108 108 29 29 31 29 30 29 29 29
29 29 29 29 29 29 29 29 29 29 29 29 29 29 29 29 32 29 29 29 29 31 29 29 29 30 29 29 29 29 29 29 29 29 29 29 29 29 29 29 29 29 29 29 29 29 29 29 29 29 29 29 29 29 29 29 29 29 29 29 29 29 29 29
