0 0 0 0 0 0 0 0 0 0 0 0 0 0 0 0 0 0 0 0 0 0 0 0 0 0 0 0 0 0 0 0 0 0 0 0 0 0 0 0 0 0 0 0 0 0 0 0 0 0 0 0 0 0 0 0 0 0 0 0 0 0 0 0
0 0 0 0 0 0 0 0 0 0 0 0 0 0 0 0 0 0 0 0 0 0 0 0 0 0 0 0 0 0 0 0 0 0 0 0 0 0 0 0 0 0 0 0 0 0 0 0 0 0 0 0 0 0 0 0 0 0 0 0 0 0 0 0
0 0 0 0 0 0 0 0 0 0 0 0 0 0 0 0 0 0 0 0 0 0 0 0 0 0 0 0 0 0 0 0 0 0 0 0 0 0 0 0 0 0 0 0 0 0 0 0 0 0 0 0 0 0 0 0 0 0 0 0 0 0 0 0
0 0 0 0 0 0 0 0 0 0 0 0 0 0 0 0 0 0 0 0 0 0 0 0 0 0 0 0 0 0 0 0 0 0 0 0 0 0 0 0 0 0 0 0 0 0 0 0 0 0 0 0 0 0 0 0 0 0 0 0 0 0 0 0
0 0 0 0 0 0 0 0 0 0 0 0 0 0 0 0 0 0 0 0 0 0 0 0 0 0 0 0 0 0 0 0 0 0 0 0 0 0 0 0 0 0 0 0 0 0 0 0 0 0 0 0 0 0 0 0 0 0 0 0 0 0 0 0
0 0 0 0 0 0 0 53 0 0 0 0 0 0 0 0 0 0 0 0 0 0 0 0 0 0 0 0 0 0 0 0 0 0 0 0 0 0 0 0 0 0 0 0 0 0 0 0 0 0 0 0 0 0 0 0 0 0 0 0 0 0 0 0
0 0 0 0 0 0 0 0 0 0 37 0 0 0 0 0 37 0 0 0 0 0 0 53 0 0 0 0 0 0 0 0 0 0 0 37 0 0 0 0 0 0 0 0 0 0 0 0 0 0 0 0 0 0 37 0 0 0 0 37 0 0 0 0
0 0 0 0 0 0 0 0 0 0 0 0 0 0 0 0 0 0 0 0 0 0 37 0 0 0 0 0 0 0 0 0 0 0 0 0 0 0 0 0 0 0 0 0 0 0 0 0 0 0 0 0 0 0 0 0 0 0 0 0 0 0 0 0
0 0 0 0 0 0 0 37 0 0 0 0 0 0 0 0 0 0 0 0 0 0 0 0 0 0 0 0 0 0 0 37 0 0 0 0 0 0 0 0 37 0 0 0 0 0 0 0 0 0 0 0 0 0 0 0 0 0 0 0 0 0 0 0
0 0 0 0 0 0 0 0 0 0 31 0 53 0 0 0 53 0 31 0 0 0 117 0 0 0 37 0 0 0 0 0 0 0 31 53 0 31 0 0 0 0 0 0 37 0 0 0 0 0 0 37 0 0 0 0 49 49 0 0 37 0 0 0
0 0 0 0 0 0 0 0 0 0 0 0 0 0 0 0 0 0 0 0 0 53 0 0 0 0 0 0 0 0 0 0 0 0 53 0 37 0 0 0 0 0 0 0 0 0 0 0 0 0 0 0 0 0 0 0 49 49 0 0 0 0 0 0
0 0 0 0 0 0 0 0 0 0 0 37 0 0 0 90 37 96 0 0 0 0 0 0 0 0 0 0 0 0 0 0 0 0 0 0 0 0 0 0 0 0 0 0 0 0 0 0 0 0 0 0 0 0 0 98 0 0 0 0 0 0 0 0
0 0 0 0 0 0 0 37 0 0 0 0 0 0 0 121 200 0 0 0 31 0 0 0 0 0 0 0 0 0 0 0 0 0 31 0 0 0 0 0 49 0 0 0 0 0 0 0 0 0 90 0 96 31 0 119 37 31 0 0 0 0 0 0
0 0 0 0 0 0 0 0 0 0 0 0 0 0 0 92 168 94 31 0 31 198 0 0 37 0 0 0 0 0 37 0 0 0 52 0 90 174 94 0 0 37 0 0 37 0 0 0 0 0 121 200 49 47 0 90 47 96 0 0 0 0 0 0
0 0 0 0 0 0 0 0 0 0 31 0 31 0 0 0 0 0 0 0 0 0 0 0 0 0 0 0 0 0 0 0 0 0 0 0 0 0 0 0 0 90 0 96 0 0 0 0 0 0 92 168 94 31 0 49 201 47 0 0 117 0 0 0
0 0 0 0 0 0 0 0 0 0 0 0 0 0 31 0 0 0 0 0 0 0 0 90 0 96 31 0 31 0 54 0 0 0 96 0 0 37 31 0 117 0 200 0 0 0 0 0 0 0 0 0 0 0 0 92 168 94 0 0 0 0 0 0
0 0 0 0 0 0 0 37 0 0 0 37 0 0 0 0 37 0 0 0 0 0 0 121 0 37 0 0 0 0 37 0 0 37 139 0 0 0 0 0 0 92 168 94 0 0 0 0 52 0 0 0 0 0 0 0 37 0 0 0 37 0 0 0
0 0 0 0 0 0 0 0 0 0 0 0 0 0 31 0 0 0 0 0 0 0 0 92 168 94 31 0 31 0 54 0 0 0 92 0 26 0 26 0 0 37 0 0 37 0 0 0 0 0 0 37 0 0 0 0 0 31 0 0 0 0 0 0
0 0 0 0 0 0 0 0 0 0 90 0 96 0 0 0 0 0 0 0 0 0 0 0 0 0 0 0 0 0 0 0 0 0 0 0 0 37 0 0 31 0 0 0 0 0 0 0 31 0 0 0 0 0 0 0 0 0 0 0 0 0 0 0
0 0 0 0 0 0 0 31 0 0 121 201 37 0 0 0 0 26 0 0 31 49 0 0 0 0 0 37 0 0 0 0 0 0 52 0 0 0 0 0 0 0 0 0 0 0 0 0 0 0 0 0 0 0 0 0 0 0 0 0 0 0 0 0
0 0 0 0 37 0 0 0 0 0 92 0 94 0 0 0 164 0 0 0 37 162 0 0 0 0 0 0 0 0 0 0 0 0 31 0 0 0 0 0 53 0 48 48 0 0 37 0 0 0 0 0 0 0 0 0 0 0 0 37 0 53 0 0
0 0 0 0 0 0 0 37 49 0 0 0 0 0 0 0 0 0 0 0 0 0 0 0 0 0 0 0 0 0 0 0 0 0 0 0 0 0 0 0 0 0 48 48 0 0 90 0 96 0 37 0 0 0 0 37 0 0 0 0 0 0 0 0
0 0 0 0 0 0 0 47 31 0 31 0 96 0 31 0 53 53 0 0 37 0 0 0 0 90 0 96 0 0 0 0 191 0 0 0 90 37 96 0 0 0 55 55 0 0 121 199 0 0 0 0 0 0 0 0 0 0 0 0 0 0 0 0
0 0 0 0 0 0 0 98 0 0 0 37 139 37 0 0 37 49 0 0 0 0 0 0 0 121 200 0 0 37 0 0 0 37 0 0 0 0 0 0 98 0 0 0 0 0 92 0 94 0 0 0 0 0 0 0 0 0 0 0 0 0 0 0
0 0 0 0 0 53 0 0 49 0 53 0 92 0 53 0 47 31 0 0 0 0 0 0 0 92 0 94 0 0 0 0 117 0 0 0 92 168 94 0 0 0 53 119 0 0 37 0 0 0 0 0 0 0 0 117 0 0 0 0 0 0 0 0
0 0 37 0 0 0 0 0 49 0 0 0 0 0 0 0 0 0 0 0 0 0 0 0 0 0 0 0 0 0 0 0 0 0 0 0 0 0 0 0 0 37 49 49 0 31 0 0 0 31 0 34 0 0 0 0 0 0 0 0 0 0 0 0
0 0 0 0 0 0 0 0 49 0 34 0 37 0 0 0 34 55 48 43 48 0 34 0 0 0 0 0 0 0 0 0 0 0 0 0 0 0 0 31 90 0 96 0 0 0 0 0 0 0 0 153 0 0 0 37 0 0 0 0 0 0 0 0
0 0 0 0 0 0 49 49 49 0 0 90 0 96 0 49 55 165 201 119 191 155 0 0 0 53 0 0 0 0 0 0 0 0 0 0 0 0 0 0 0 198 0 0 0 0 0 0 0 47 0 37 53 0 0 0 0 0 0 0 0 0 0 0
0 0 0 0 0 0 49 49 49 0 0 121 0 0 0 49 54 54 37 54 37 0 48 0 0 0 0 0 0 0 0 37 0 0 90 0 96 0 0 0 92 168 94 0 0 0 0 37 0 47 0 53 26 0 0 0 0 0 37 0 0 0 0 0
0 0 165 0 0 0 49 48 48 0 0 92 168 94 0 49 49 126 0 49 0 183 0 0 0 0 0 0 0 0 0 117 0 0 0 198 0 37 0 37 0 0 0 0 0 0 0 0 0 31 0 98 0 0 53 0 0 0 0 0 0 0 0 0
0 0 0 0 0 0 51 48 48 0 198 0 0 0 0 0 34 0 37 49 37 0 37 0 37 0 0 34 0 0 0 0 0 0 92 168 94 0 0 0 0 0 0 0 0 0 0 0 0 0 0 0 48 0 0 0 0 0 0 0 0 0 0 0
0 0 37 0 0 0 0 0 0 0 34 37 0 34 0 0 0 98 0 0 0 108 0 0 0 0 0 0 0 0 0 0 0 0 0 0 0 0 0 0 0 0 0 0 0 0 0 0 0 0 0 0 48 49 49 49 49 26 0 0 37 0 0 0
0 0 0 0 0 0 0 0 0 0 0 0 0 0 0 0 0 98 0 0 0 0 0 0 0 0 0 0 0 0 0 0 0 0 0 0 0 0 0 0 0 0 0 0 0 0 0 0 0 0 0 0 0 0 0 0 0 0 0 0 0 0 0 0
0 0 0 0 0 0 0 49 49 0 0 0 49 0 49 0 0 0 0 0 0 0 0 0 0 0 0 0 0 0 37 0 0 0 0 0 0 0 49 49 0 116 0 0 0 37 0 0 0 0 0 0 37 0 0 0 0 0 0 0 0 0 0 0
0 0 0 37 0 0 37 0 22 0 0 0 49 0 49 0 0 0 0 0 0 0 37 0 116 0 0 0 0 0 0 0 0 0 0 0 0 37 49 49 0 0 0 0 0 0 0 0 0 0 0 0 0 0 0 0 0 0 37 0 0 0 0 0
0 0 0 0 0 0 0 49 49 0 0 0 0 37 0 0 0 0 0 0 0 0 0 0 0 0 0 0 0 0 0 0 0 0 0 0 0 0 49 49 0 0 0 0 0 0 0 0 0 0 0 0 0 0 0 0 0 0 0 0 0 0 0 0
0 0 98 0 0 0 0 0 0 0 0 0 0 0 0 0 0 0 0 0 0 0 0 0 0 0 0 0 0 0 31 0 0 0 0 0 0 0 0 0 0 0 0 0 0 0 0 0 0 0 0 0 0 0 0 0 0 0 0 98 0 0 0 0
0 0 0 0 0 0 0 0 0 0 0 0 0 0 0 0 0 0 0 0 31 0 0 0 31 90 112 96 0 0 0 0 0 0 0 0 0 31 0 0 0 31 49 0 0 0 0 0 0 0 31 90 0 96 0 0 0 0 0 0 0 0 0 0
0 0 0 0 0 37 0 116 0 0 0 37 0 0 0 0 31 31 0 0 0 37 0 0 37 121 198 37 0 0 0 37 0 0 0 0 37 54 0 0 31 90 112 96 90 112 96 0 37 0 37 121 200 0 37 0 0 0 37 0 0 0 0 0
0 0 0 0 0 0 0 0 0 0 0 0 0 0 0 0 0 53 0 0 90 0 96 0 0 92 168 94 0 0 0 0 0 0 0 0 0 31 0 0 49 121 200 37 121 200 0 0 0 0 31 92 168 94 0 0 0 0 0 0 119 0 0 0
0 0 37 0 0 0 0 0 0 0 0 0 0 0 0 0 49 49 0 0 121 199 0 0 31 0 0 0 0 0 0 0 0 0 0 0 0 0 0 0 49 92 168 94 92 168 94 0 0 0 0 0 0 0 0 0 0 0 0 0 0 0 0 0
0 0 0 0 0 54 0 53 0 31 0 0 108 0 0 0 0 0 0 0 92 168 94 0 0 0 0 0 0 0 0 0 0 0 0 0 0 0 0 0 31 0 0 0 0 0 0 0 0 0 90 0 96 31 0 0 0 0 0 0 0 37 0 0
0 0 0 0 0 108 0 37 0 0 37 0 198 0 116 0 37 0 0 0 0 37 0 0 31 0 0 0 90 0 96 0 0 0 0 0 31 31 0 0 0 0 0 0 37 0 0 0 31 0 121 200 0 49 0 0 0 0 0 0 0 0 0 0
0 0 0 0 0 144 0 0 0 31 0 0 162 0 0 0 0 0 0 0 0 0 0 0 54 37 0 0 121 201 37 0 37 0 0 0 0 0 0 0 0 0 0 0 0 0 0 0 0 0 92 168 94 0 0 0 0 0 37 0 0 0 0 0
0 0 0 0 0 0 0 0 0 0 0 0 0 0 0 0 0 0 0 0 0 0 0 0 0 0 0 0 92 168 94 0 0 0 0 0 0 0 90 0 96 0 54 0 0 0 0 0 0 0 0 0 0 0 0 0 0 0 0 0 0 0 0 0
0 0 0 0 0 0 37 0 0 0 0 0 0 0 0 0 37 0 0 0 0 0 0 0 31 0 0 0 0 0 0 0 0 31 0 0 0 0 121 200 0 44 0 0 0 37 0 0 0 0 0 37 0 0 0 0 0 0 0 0 0 0 0 0
0 0 37 0 0 127 127 0 26 0 0 0 0 0 90 0 96 0 0 0 0 37 0 0 0 0 0 0 0 0 0 0 0 0 0 0 0 0 92 168 94 0 54 0 31 0 0 0 0 0 0 0 0 0 0 0 0 0 0 0 0 0 0 0
0 0 0 0 0 163 163 37 0 0 0 154 0 0 121 201 0 0 0 0 0 0 0 0 54 0 31 0 90 112 96 0 0 0 0 0 0 0 0 0 0 0 0 0 0 0 0 0 0 0 0 0 0 0 0 0 0 37 0 0 0 0 0 0
0 0 0 0 0 49 55 49 26 0 0 0 0 0 92 168 94 0 0 0 0 0 0 0 0 0 37 54 121 198 37 0 0 0 0 0 0 0 0 0 0 0 31 0 54 0 26 0 0 0 90 0 96 0 0 0 0 0 0 0 0 0 0 0
0 0 0 0 0 189 117 189 0 0 0 0 0 0 53 0 37 0 0 0 0 90 112 96 0 0 31 0 92 168 94 0 0 37 0 0 0 37 0 0 0 0 0 0 0 37 0 0 0 37 121 199 37 0 0 0 0 0 0 0 0 37 0 0
0 0 0 0 0 0 0 0 0 0 0 0 0 0 0 0 0 0 0 0 0 121 199 0 0 0 0 0 0 0 0 0 0 0 0 0 0 0 31 0 0 37 0 0 0 0 0 0 0 0 92 168 94 0 0 0 0 0 0 0 0 119 0 0
0 0 0 0 0 0 0 0 0 0 31 0 0 0 0 0 37 0 0 0 0 92 168 94 0 0 0 0 0 49 0 31 0 0 0 0 0 0 0 0 0 0 0 0 90 0 96 0 0 0 0 0 0 0 0 0 0 0 0 0 0 0 0 0
0 0 37 0 0 0 0 0 0 0 54 0 0 0 90 112 96 0 0 0 0 0 0 37 0 0 0 0 0 37 0 54 0 31 47 0 0 0 0 90 112 96 0 0 121 198 0 0 37 0 0 0 37 0 48 49 49 31 0 0 0 0 0 0
0 0 0 0 0 0 37 0 0 0 0 0 0 0 121 201 0 0 0 0 31 0 0 0 0 0 0 0 0 49 0 31 0 49 37 54 0 0 37 121 198 0 0 0 92 168 94 0 0 0 31 0 0 0 0 0 0 0 0 0 0 0 0 0
0 0 0 0 0 0 0 0 0 0 0 0 0 0 92 168 94 0 0 0 0 0 0 0 0 0 0 0 0 0 0 0 0 31 47 0 0 0 0 92 168 94 0 0 0 0 0 0 0 0 0 0 0 0 0 0 0 0 0 0 0 0 0 0
0 0 0 0 0 0 0 0 0 118 0 0 0 0 0 0 0 0 0 0 0 0 0 37 0 26 0 0 0 0 0 0 0 0 0 0 0 0 0 0 0 0 0 0 0 0 0 0 0 0 0 0 0 0 0 0 0 0 0 0 0 0 0 0
0 0 49 49 49 0 0 0 0 0 0 37 0 0 0 0 0 37 0 0 37 90 0 96 0 53 0 0 0 0 0 0 0 0 0 0 0 0 0 49 48 0 37 0 37 0 0 0 0 0 0 0 0 37 0 0 0 0 0 0 0 37 0 0
0 49 49 49 49 49 0 0 0 0 0 0 0 0 31 0 0 0 0 0 0 121 199 0 0 53 0 0 0 0 0 0 37 0 0 0 0 0 0 49 47 0 0 0 0 31 0 0 0 37 0 0 0 0 0 0 0 0 0 0 0 0 0 0
0 0 48 51 48 0 54 54 0 0 0 0 0 0 0 0 0 0 0 0 31 92 168 94 0 31 0 0 0 0 0 0 0 0 0 0 0 0 0 0 0 0 0 0 0 0 0 0 0 0 0 0 98 0 0 0 0 37 0 0 0 0 0 0
0 0 0 48 0 0 0 0 0 0 0 0 0 0 0 0 0 0 0 0 0 0 0 0 0 0 0 0 37 0 0 0 0 0 0 0 0 0 0 0 0 0 0 0 0 0 0 0 0 0 0 0 0 0 0 0 0 117 0 0 0 0 0 0
0 0 0 0 0 0 0 0 0 98 0 0 37 0 0 0 0 0 0 0 0 0 0 0 0 0 0 0 0 0 0 0 0 0 0 0 0 37 0 0 0 0 0 118 0 37 0 0 0 0 0 0 0 0 0 0 0 0 0 0 37 0 0 0
0 0 0 0 0 0 0 0 0 0 0 0 0 0 0 0 0 37 0 0 0 0 118 0 0 37 0 0 0 0 0 0 0 0 0 0 0 0 0 0 0 0 0 0 0 0 0 0 0 0 0 49 49 49 49 0 0 0 0 0 0 0 0 0
0 0 0 0 0 0 0 0 0 0 0 0 0 0 0 0 0 0 0 0 0 0 0 0 0 0 0 0 0 0 0 0 0 0 0 0 0 0 0 0 0 0 0 0 0 0 0 0 0 0 49 49 49 49 49 49 0 0 0 0 0 0 0 0
0 0 0 0 0 0 0 0 0 0 0 0 0 0 0 0 0 0 0 0 0 0 0 0 0 0 0 0 0 0 0 0 0 0 0 0 0 0 0 0 0 0 0 0 0 0 0 0 0 0 0 0 0 0 0 0 0 0 0 0 0 0 0 0
