1 1 1 1 1 1 1 1 1 1 1 1 1 1 1 1 1 1 1 1 1 1 1 1 1 1 1 1 1 1 1 1 1 1 1 1 1 1 1 1 1 1 1 1 1 1 1 1 1 1 1 1 1 1 1 1 1 1 1 1 1 1 1 1
1 1 1 1 1 1 1 1 1 1 1 1 1 1 1 1 1 1 1 1 1 1 1 1 1 1 1 1 1 1 1 1 1 1 1 1 1 1 1 1 1 1 1 1 1 1 1 1 1 1 1 1 1 1 1 1 1 1 1 1 1 1 1 1
1 1 1 1 1 1 1 1 1 1 1 1 1 1 1 1 1 1 1 1 1 1 1 1 1 1 1 1 1 1 1 1 1 1 1 1 1 1 1 1 1 1 1 1 1 1 1 1 1 1 1 1 1 1 1 1 1 1 1 1 1 1 1 1
1 1 1 1 1 1 1 1 1 1 1 1 1 1 1 1 1 1 1 1 1 1 1 1 1 1 1 1 1 1 1 1 1 1 1 1 1 1 1 1 1 1 1 1 1 1 1 1 1 1 1 1 1 1 1 1 1 1 1 1 1 1 1 1
1 1 1 1 1 1 1 1 1 1 1 1 1 1 1 1 1 1 1 1 1 1 1 1 1 1 1 1 1 1 1 1 1 1 1 1 1 1 1 1 1 1 1 1 1 1 1 1 1 1 1 1 1 1 1 1 1 1 1 1 1 1 1 1
1 1 1 1 1 1 1 1 1 1 1 1 1 1 1 1 1 1 1 1 1 1 1 1 1 1 1 1 1 1 1 1 1 1 1 1 1 1 1 1 1 1 1 1 1 1 1 1 1 1 1 1 1 1 1 1 1 1 1 1 1 1 1 1
1 1 1 1 1 1 1 1 1 1 1 1 1 1 1 1 1 1 1 1 1 1 1 1 1 1 1 1 1 1 1 1 1 1 1 1 1 1 1 1 1 1 1 1 1 1 1 1 1 1 1 1 1 1 1 1 1 1 1 1 1 1 1 1
1 1 1 1 1 1 1 1 1 1 1 1 1 1 1 1 1 1 1 1 1 1 1 1 1 1 1 1 1 1 1 1 1 1 1 1 1 1 1 1 1 1 1 1 1 1 1 1 1 1 1 1 1 1 1 1 1 1 1 1 1 1 1 1
1 1 1 1 1 1 1 1 1 1 1 1 1 1 1 1 1 1 1 1 1 1 1 1 1 1 1 1 1 1 1 1 1 1 1 1 1 1 1 1 1 1 1 1 1 1 1 1 1 1 1 1 1 1 1 1 1 1 1 1 1 1 1 1
1 1 1 1 1 1 1 1 1 1 1 1 1 1 1 1 1 1 1 1 1 1 1 1 1 1 1 1 1 1 1 1 1 1 1 1 1 1 1 1 1 1 1 1 1 1 1 1 1 1 1 1 1 1 1 1 1 1 1 1 1 1 1 1
1 1 1 1 1 1 1 1 1 1 1 1 1 1 1 1 1 1 1 1 1 1 1 1 1 1 1 29 29 29 1 1 1 1 1 1 1 1 1 1 1 1 1 1 1 1 1 1 1 1 1 1 1 1 1 1 1 1 1 1 1 1 1 1
1 1 1 1 1 1 1 1 1 1 1 1 1 1 1 1 1 1 1 1 1 1 1 1 1 1 1 29 106 29 1 1 1 1 1 1 1 1 1 1 1 1 1 1 1 1 1 1 1 1 1 1 1 1 1 1 1 1 1 1 1 1 1 1
1 1 1 1 1 1 1 1 1 1 1 1 1 1 1 1 1 1 1 1 1 1 1 1 1 1 1 29 113 29 1 1 1 1 1 1 1 1 1 1 1 1 1 1 1 1 1 1 1 1 1 1 1 1 1 1 1 1 1 1 1 1 1 1
1 1 1 1 1 1 1 1 1 1 1 1 1 1 1 1 1 1 1 1 1 1 1 29 29 29 31 29 106 29 29 30 29 29 29 1 1 1 1 1 1 1 1 1 1 1 1 1 1 1 1 1 1 1 1 1 1 1 1 1 1 1 1 1
1 1 1 1 1 1 1 1 1 1 1 1 1 1 1 1 1 1 1 29 29 29 29 29 113 113 113 113 113 113 113 113 113 113 29 32 29 29 1 1 1 1 1 1 1 1 1 1 1 1 1 1 1 1 1 1 1 1 1 1 1 1 1 1
1 1 1 1 1 1 1 1 1 1 1 1 1 1 1 1 29 29 29 32 29 113 113 113 113 113 113 113 113 113 113 113 113 113 113 113 113 29 31 29 29 1 1 1 1 1 1 1 1 1 1 1 1 1 1 1 1 1 1 1 1 1 1 1
1 1 1 1 1 1 1 1 1 1 1 1 1 1 1 1 29 113 113 113 113 113 113 113 113 113 29 30 29 29 113 113 113 113 113 113 113 113 113 113 29 29 1 1 1 1 1 1 1 1 1 1 1 1 1 1 1 1 1 1 1 1 1 1
1 1 1 1 1 1 1 1 1 1 1 1 1 1 1 1 30 113 113 113 113 113 113 113 113 29 29 29 29 29 113 113 113 113 113 113 113 113 113 113 113 29 29 1 1 1 1 1 1 1 1 1 1 1 1 1 1 1 1 1 1 1 1 1
1 1 1 1 1 1 1 1 1 1 1 1 1 1 1 29 29 113 113 113 113 113 113 113 29 29 29 29 29 113 113 113 113 113 29 29 113 113 113 113 113 113 29 29 29 29 1 1 1 1 1 1 1 1 1 1 1 1 1 1 1 1 1 1
1 1 1 1 1 1 1 1 1 1 1 1 1 1 1 31 113 113 113 113 113 113 113 113 29 30 29 113 113 113 113 113 113 113 29 31 113 113 113 113 113 113 106 113 106 32 1 1 1 1 1 1 1 1 1 1 1 1 1 1 1 1 1 1
1 1 1 1 1 1 1 1 1 1 1 1 1 1 1 29 113 113 113 113 113 113 113 113 113 113 113 113 113 113 113 113 113 113 113 113 113 113 113 113 113 113 29 29 29 29 1 1 1 1 1 1 1 1 1 1 1 1 1 1 1 1 1 1
1 1 1 1 1 1 1 1 1 1 1 1 29 29 29 29 113 113 113 113 113 113 113 113 113 113 113 113 113 113 113 113 113 113 113 113 113 113 113 113 113 113 31 1 1 1 1 1 1 1 1 1 1 1 1 1 1 1 1 1 1 1 1 1
1 1 1 1 1 1 1 1 1 1 1 1 31 106 113 106 113 113 113 29 29 29 113 113 113 113 113 113 113 113 113 113 113 113 113 113 113 113 113 113 113 113 29 29 29 29 29 29 29 1 1 1 1 1 1 1 1 1 1 1 1 1 1 1
1 1 1 1 1 1 1 1 1 1 1 1 29 29 29 29 113 113 113 113 29 29 29 31 113 113 113 113 113 113 113 113 113 29 29 29 29 29 113 113 113 113 30 113 113 113 113 113 29 29 1 1 1 1 1 1 1 1 1 1 1 1 1 1
1 1 1 1 1 1 1 1 1 1 1 1 1 1 1 30 113 113 113 113 113 31 29 29 29 113 113 113 113 113 113 113 29 29 29 29 113 113 113 113 113 29 113 113 113 113 113 113 113 29 29 1 1 1 1 1 1 1 1 1 1 1 1 1
1 1 1 1 1 1 1 1 1 1 1 1 1 1 1 29 113 113 113 113 113 113 113 29 29 29 113 113 113 113 113 29 29 29 29 113 113 113 113 113 113 29 113 113 113 113 113 113 113 113 29 29 1 1 1 1 1 1 1 1 1 1 1 1
1 1 1 1 1 1 1 1 1 1 1 1 1 1 1 29 31 113 113 113 113 113 113 113 113 113 113 113 113 113 113 29 29 113 113 113 113 113 113 113 113 31 113 113 113 113 113 113 113 113 113 29 29 1 1 1 1 1 1 1 1 1 1 1
1 1 1 1 1 1 1 1 1 1 1 1 1 1 113 113 32 113 113 113 113 113 113 113 113 113 113 113 113 113 113 113 113 113 113 113 113 113 113 113 29 29 29 113 113 113 113 113 113 113 113 113 29 1 1 1 1 1 1 1 1 1 1 1
1 1 1 1 1 29 32 29 1 1 1 1 1 1 1 29 113 32 31 29 29 113 113 113 113 113 113 113 113 113 113 113 113 113 113 113 113 113 113 113 29 1 29 113 113 113 113 113 113 113 113 113 29 1 1 1 1 1 1 1 1 1 1 1
1 1 1 1 1 29 113 29 1 1 1 1 1 1 1 29 113 29 44 29 29 30 29 29 29 113 113 113 113 113 113 113 113 113 113 113 113 113 113 113 30 1 29 29 29 113 113 113 113 113 113 29 29 1 1 1 1 1 1 1 1 1 1 1
1 1 1 1 1 29 113 29 1 1 1 1 1 1 1 29 113 32 44 44 44 44 44 44 29 30 106 29 29 113 113 113 113 113 113 113 113 106 113 113 29 1 1 1 29 29 113 113 113 113 29 29 1 1 1 1 1 1 1 1 1 1 1 1
1 1 1 1 1 29 113 29 1 1 1 1 1 1 1 29 113 29 44 44 44 44 44 44 44 29 113 29 29 31 29 29 29 30 29 29 29 29 29 106 29 1 1 1 1 29 29 29 29 29 29 1 1 1 1 1 1 1 1 1 1 1 1 1
29 29 29 31 29 29 113 29 29 30 29 29 29 29 29 29 113 29 44 44 44 44 44 44 44 29 106 29 44 29 29 113 113 113 113 113 106 113 29 113 29 1 1 1 1 1 1 1 1 1 1 1 1 1 1 1 1 1 1 1 1 1 1 1
32 113 113 113 113 113 113 113 113 113 113 113 113 113 113 113 113 29 44 44 44 44 44 44 44 29 32 29 44 44 29 29 91 29 29 29 29 113 29 113 29 1 1 1 1 1 1 1 1 1 1 1 1 1 1 1 1 1 1 1 1 1 1 1
29 30 29 29 29 29 113 29 29 29 29 29 31 29 29 29 29 29 44 44 44 44 44 44 44 44 44 44 44 44 29 111 111 111 31 29 29 113 29 113 29 1 1 1 1 1 1 1 1 1 1 1 1 1 1 1 1 1 1 1 1 1 1 1
44 44 44 44 44 29 113 29 44 44 44 44 44 44 44 44 44 44 44 44 44 44 44 44 44 44 44 44 44 44 29 111 111 111 29 29 29 113 106 113 29 1 1 1 1 1 1 1 1 1 1 1 1 1 1 1 1 1 1 1 1 1 1 1
44 44 44 44 44 29 113 30 44 44 44 44 44 44 44 44 44 44 44 44 44 44 44 44 44 44 44 44 44 44 31 111 111 111 29 29 29 29 29 29 29 1 1 1 1 1 1 1 1 1 1 1 1 1 1 1 1 1 1 1 1 1 1 1
44 44 44 44 44 29 113 29 44 44 44 44 44 44 44 44 44 44 44 44 44 44 44 44 44 44 44 44 44 29 29 111 111 111 29 29 1 1 1 1 1 1 1 1 1 1 1 1 1 1 1 1 1 1 1 1 1 1 1 1 1 1 1 1
44 44 44 44 44 29 29 29 44 44 44 44 44 44 44 44 44 44 44 44 44 44 44 44 44 44 44 44 29 29 111 111 111 111 111 29 29 1 1 1 1 1 1 1 1 1 1 1 1 1 1 1 1 1 1 1 1 1 1 1 1 1 1 1
44 44 44 44 44 44 44 44 44 44 44 44 44 44 44 44 44 44 44 44 44 44 44 44 44 44 29 29 29 111 111 111 111 111 111 111 29 29 29 1 1 1 1 1 1 1 1 1 1 1 1 1 1 1 1 1 1 1 1 1 1 1 1 1
44 44 44 44 44 44 44 44 29 29 29 29 29 29 32 29 29 29 29 29 29 29 29 29 29 32 29 111 111 111 111 111 111 111 111 111 111 111 29 29 29 29 32 29 29 29 31 29 29 29 32 29 29 29 29 29 29 1 1 1 1 1 1 1
44 44 44 44 44 44 44 44 29 109 109 109 109 109 109 109 109 109 109 109 109 109 109 109 29 111 111 111 111 111 111 44 45 45 111 111 111 111 111 111 29 109 109 109 109 109 109 109 109 109 109 109 109 109 109 109 29 1 1 1 1 1 1 1
44 44 44 44 44 44 44 44 29 109 109 109 109 109 109 109 109 109 109 109 109 109 109 109 90 111 111 111 111 44 44 45 44 44 45 44 111 111 111 111 90 109 109 109 109 109 109 109 109 109 109 109 109 109 109 109 29 1 1 1 1 1 1 1
44 44 44 44 44 44 44 44 29 109 109 109 109 109 109 109 109 109 109 109 109 109 109 109 45 111 111 45 44 44 45 44 44 45 44 44 45 44 111 111 44 109 109 109 109 109 109 109 109 109 109 109 109 109 109 109 31 1 1 1 1 1 1 1
44 44 44 44 44 44 44 44 29 109 109 109 14 15 15 15 106 15 15 15 15 44 45 44 44 45 44 44 45 44 44 45 44 44 45 44 44 45 44 44 45 44 44 45 15 15 15 15 106 15 15 15 14 109 109 109 29 1 1 1 1 1 1 1
44 44 44 44 44 44 44 44 29 109 109 109 15 1 1 15 109 15 109 109 15 109 109 109 45 112 112 112 112 112 112 112 112 112 112 112 112 112 112 112 44 109 109 109 15 1 1 15 109 15 1 1 15 109 109 109 29 1 1 1 1 1 1 1
44 44 44 44 44 44 44 44 29 109 109 109 15 1 1 15 106 15 109 109 15 109 109 109 44 112 112 112 112 112 112 112 112 112 112 112 112 112 112 112 45 109 109 109 15 1 1 15 106 15 1 1 15 109 109 109 29 1 1 1 1 1 1 1
44 44 44 44 44 44 44 44 29 109 109 109 15 1 1 15 15 109 109 109 14 109 109 109 90 112 112 112 112 112 112 112 112 112 112 112 112 112 112 112 90 109 109 109 14 1 1 15 15 15 15 15 15 109 109 109 29 1 1 1 1 1 1 1
44 44 44 44 44 44 44 44 29 109 109 109 15 1 1 15 109 109 109 109 15 109 109 109 44 112 112 112 112 112 112 112 112 112 112 112 112 112 112 112 45 109 109 109 15 1 1 15 15 109 109 109 15 109 109 109 29 1 1 1 1 1 1 1
44 44 44 44 44 44 44 44 29 109 109 109 15 1 1 15 109 109 109 109 15 109 109 109 45 112 112 112 112 112 112 112 112 112 112 112 112 112 112 112 44 109 109 109 15 1 1 15 109 109 109 109 15 109 109 109 29 1 1 1 1 1 1 1
44 44 44 44 44 44 44 44 32 109 109 109 15 1 1 15 109 109 109 109 15 109 109 109 44 45 44 91 45 44 91 45 44 44 91 44 44 91 44 44 44 109 109 109 15 1 1 15 109 109 109 109 15 109 109 109 32 1 1 1 1 1 1 1
44 44 44 44 44 44 44 44 29 109 109 109 15 1 1 15 15 15 109 109 15 109 109 109 45 44 32 108 108 108 108 108 108 108 108 108 108 108 29 45 45 109 109 109 15 1 1 15 15 109 109 109 15 109 109 109 29 1 1 1 1 1 1 1
44 44 44 44 44 44 44 44 29 109 109 109 15 1 1 15 106 15 109 109 15 109 109 109 44 45 29 106 108 108 108 108 108 108 108 108 108 106 29 45 44 109 109 109 15 1 1 15 106 15 15 15 15 109 109 109 29 1 1 1 1 1 1 1
44 44 44 44 44 44 44 44 29 109 109 109 15 1 1 15 109 15 109 109 15 109 109 109 45 44 29 108 108 108 108 108 108 108 108 108 108 108 29 45 45 109 109 109 15 1 1 15 109 15 1 1 15 109 109 109 29 1 1 1 1 1 1 1
44 44 44 44 44 44 44 44 29 109 109 109 14 15 15 15 106 15 15 15 14 109 109 109 44 45 29 29 29 108 108 108 108 108 108 108 29 29 29 45 44 109 109 109 14 15 15 15 106 15 15 15 14 109 109 109 29 1 1 1 1 1 1 1
44 44 44 44 44 44 44 44 29 109 109 109 109 109 109 109 109 109 109 109 109 109 109 109 45 44 45 45 29 29 108 108 108 108 108 29 29 29 29 45 45 109 109 109 109 109 109 109 109 109 109 109 109 109 109 109 29 1 1 1 1 1 1 1
44 45 44 44 45 44 44 45 29 109 109 109 109 109 109 109 109 109 109 109 109 109 109 109 44 45 44 44 45 31 108 108 108 108 108 29 32 29 29 45 44 109 109 109 109 109 109 109 109 109 109 109 109 109 109 109 29 1 1 1 1 1 1 1
45 44 44 45 44 44 45 44 29 109 109 109 109 109 109 109 109 109 109 109 109 109 109 109 45 44 44 45 44 29 108 108 108 108 108 32 108 108 29 45 45 109 109 109 109 109 109 109 109 109 109 109 109 109 109 109 29 1 1 1 1 1 1 1
44 45 44 44 45 44 44 45 29 29 29 29 29 29 29 32 29 29 29 29 29 29 29 29 45 45 44 44 45 29 108 108 108 108 108 29 108 108 29 29 45 29 29 31 29 29 29 29 29 29 29 32 29 29 31 29 29 1 1 1 1 1 1 1
45 44 44 45 44 44 45 44 44 45 44 44 45 44 44 45 44 44 45 44 44 45 44 44 45 44 44 45 44 29 29 108 108 108 29 29 108 108 108 29 29 29 29 29 32 29 29 29 29 29 1 1 1 1 1 1 1 1 1 1 1 1 1 1
44 45 44 44 45 44 44 45 44 44 45 44 44 45 44 44 45 44 44 45 44 44 45 44 44 45 44 44 45 44 29 108 108 108 29 29 108 108 108 108 108 108 108 108 108 108 108 108 108 31 1 1 1 1 1 1 1 1 1 1 1 1 1 1
45 44 44 45 44 44 45 44 44 45 44 44 45 44 44 45 44 44 45 44 44 45 44 44 45 44 44 45 44 44 29 29 108 29 29 29 108 108 108 108 108 108 108 108 108 108 108 108 108 29 1 1 1 1 1 1 1 1 1 1 1 1 1 1
44 45 44 44 45 44 44 45 44 44 45 44 44 45 44 44 45 44 44 45 44 44 45 44 44 45 44 44 45 44 44 29 13 29 44 29 29 108 108 108 108 108 108 108 108 108 108 108 29 29 1 1 1 1 1 1 1 1 1 1 1 1 1 1
45 44 44 45 44 44 45 44 44 45 44 44 45 44 44 45 44 44 45 44 44 45 44 44 45 44 44 45 44 44 45 44 44 44 44 44 29 29 29 32 29 29 29 29 29 29 29 29 29 1 1 1 1 1 1 1 1 1 1 1 1 1 1 1
