27 27 27 27 27 27 27 27 27 27 27 27 27 27 27 27 27 27 27 27 27 27 27 27 27 27 27 27 27 27 27 27 27 27 27 27 27 27 27 27 27 27 27 27 27 27 27 27 27 27 27 27 27 27 27 27 27 27 27 27 27 27 27 27
27 27 27 27 27 27 27 27 27 27 27 27 27 27 27 27 27 27 27 27 27 27 27 27 27 27 27 27 27 27 27 27 27 27 27 27 27 27 27 27 27 27 27 27 27 27 27 27 27 27 27 27 27 27 27 27 27 27 27 27 27 27 27 27
27 27 27 27 27 27 27 27 27 27 27 27 27 27 27 27 27 27 27 27 27 27 27 27 27 27 27 27 27 27 27 27 27 27 27 27 27 27 27 27 27 27 27 27 27 27 27 27 27 27 27 27 27 27 27 27 27 27 27 27 27 27 27 27
27 27 27 27 27 27 27 27 27 27 27 27 27 27 27 27 27 27 27 27 27 27 27 27 27 27 27 27 27 27 27 27 27 27 27 27 27 27 27 27 27 27 27 27 27 27 27 27 27 27 27 27 27 27 27 27 27 27 27 27 27 27 27 27
27 27 27 27 27 27 27 27 27 27 27 27 27 27 27 27 27 27 27 27 27 27 27 27 27 27 27 27 27 27 27 27 27 27 27 27 27 27 27 27 27 27 27 27 27 27 27 27 27 27 27 27 27 27 27 27 27 27 27 27 27 27 27 27
27 27 27 27 27 27 27 27 27 27 27 27 27 27 27 27 27 27 27 27 27 27 27 27 27 27 27 27 27 27 27 27 27 27 27 27 27 27 27 27 27 27 27 27 27 27 27 27 27 27 27 27 27 27 27 27 27 27 27 27 27 27 27 27
27 27 27 27 27 27 27 27 27 27 27 27 27 27 27 27 27 27 27 27 27 27 27 27 27 27 27 27 27 27 27 27 27 27 27 27 27 27 27 27 27 27 27 27 27 27 27 27 27 27 27 27 27 27 27 27 27 27 27 27 27 27 27 27
27 27 27 27 27 27 27 27 27 27 27 27 27 27 27 27 27 27 27 27 27 27 27 27 27 27 27 27 27 27 27 27 27 27 27 27 27 27 27 27 27 27 27 27 27 27 27 27 27 27 27 27 27 27 27 27 27 27 27 27 27 27 27 27
27 27 27 27 27 27 27 27 27 27 27 27 27 27 27 27 27 27 27 27 27 27 27 27 27 27 27 27 27 27 27 27 27 27 27 27 27 27 27 27 27 27 27 27 27 27 27 27 27 27 27 27 27 27 27 27 27 27 27 27 27 27 27 27
27 27 27 27 27 27 27 27 27 27 27 27 27 27 27 27 27 27 27 27 27 27 27 27 27 27 27 27 27 27 27 27 27 27 27 27 27 27 27 27 27 27 27 27 27 27 27 27 27 27 27 27 27 27 27 27 27 27 27 27 27 27 27 27
27 27 27 27 27 27 27 27 27 27 27 27 27 27 27 27 27 27 27 27 27 27 27 27 27 27 27 27 27 27 27 27 27 27 27 27 27 27 27 27 27 27 27 27 27 27 27 27 27 27 27 27 27 27 27 27 27 27 27 27 27 27 27 27
27 27 27 27 27 27 27 27 27 27 27 27 27 27 27 27 27 27 27 27 27 27 27 27 27 27 27 27 27 27 27 27 27 27 27 27 27 27 27 27 27 27 27 27 27 27 27 27 27 27 27 27 27 27 27 27 27 27 27 27 27 27 27 27
27 27 27 27 27 27 27 27 27 27 27 27 27 27 27 1 1 27 27 27 1 1 27 27 1 1 27 1 27 27 1 27 1 1 27 27 27 27 27 27 27 27 27 27 27 27 27 27 27 27 27 27 27 27 27 27 27 27 27 27 27 27 27 27
27 27 27 27 27 27 27 27 27 27 27 27 27 27 27 27 109 109 109 109 109 109 109 109 109 109 109 109 109 109 109 109 109 109 109 109 109 27 27 27 27 27 27 27 27 27 27 27 27 27 27 27 27 27 27 27 27 27 27 27 27 27 27 27
27 27 27 27 27 27 27 27 27 27 27 27 27 27 27 1 109 109 109 109 109 109 109 109 109 109 109 109 109 109 109 109 109 109 109 109 109 1 27 27 27 27 27 27 27 27 27 27 27 27 27 27 27 27 27 27 27 27 27 27 27 27 27 27
27 27 27 27 27 27 27 27 1 27 27 6 1 27 27 27 109 109 109 109 27 1 27 27 1 1 1 27 109 109 109 109 109 109 109 109 109 27 27 27 27 27 27 1 1 27 27 1 27 27 27 27 27 27 27 27 27 27 27 27 27 27 27 27
27 27 27 27 27 27 27 27 109 109 109 109 109 109 27 109 109 109 109 109 27 1 27 1 27 27 27 27 109 109 109 12 12 12 109 109 109 27 27 27 27 27 111 111 111 111 111 111 111 111 111 27 27 27 27 27 27 27 27 27 27 27 27 27
27 27 27 27 27 27 27 13 109 109 109 109 109 109 90 109 109 109 109 109 109 109 109 109 109 109 27 1 109 109 109 11 12 11 109 109 109 1 27 27 27 27 111 111 111 111 111 111 111 111 111 1 27 27 27 27 27 27 27 27 27 27 27 27
27 27 27 27 27 27 27 27 109 109 109 109 109 109 27 109 109 109 109 109 109 109 109 109 109 109 1 1 109 109 109 12 12 12 109 109 109 1 27 27 27 27 111 111 111 111 111 111 111 111 111 1 27 27 27 27 27 27 27 27 27 27 27 27
27 27 27 27 27 27 27 27 27 27 27 6 27 27 27 27 27 27 109 109 109 27 27 109 109 109 1 1 109 109 109 109 109 109 109 109 109 27 27 27 27 27 27 27 27 1 27 27 111 111 111 27 27 27 27 27 27 27 27 27 27 27 27 27
27 27 27 27 27 27 27 27 27 27 27 27 1 1 27 1 27 27 109 109 109 27 27 109 109 109 27 27 109 109 109 109 109 109 109 109 109 27 27 1 1 27 1 27 27 27 27 27 111 111 111 27 27 27 27 27 27 27 27 27 27 27 27 27
27 27 27 27 27 27 27 27 27 27 109 109 109 109 109 109 109 109 109 109 109 27 27 109 109 109 1 1 109 109 109 109 109 109 109 109 109 27 111 111 111 111 111 111 27 27 27 27 111 111 111 1 27 27 27 27 27 27 27 27 27 27 27 27
27 27 27 27 27 27 27 27 27 1 109 109 109 109 109 109 109 109 109 109 109 27 1 27 91 27 1 3 27 1 1 27 27 27 1 1 27 1 111 111 111 111 111 111 6 27 27 1 111 111 111 27 27 27 27 27 27 27 27 27 27 27 27 27
27 27 27 27 27 27 27 27 27 27 1 91 27 1 109 109 109 109 109 109 109 27 110 110 110 110 110 110 110 110 110 110 27 27 27 27 27 27 111 111 111 111 111 111 27 27 27 1 111 111 111 1 27 27 27 27 27 27 27 27 27 27 27 27
27 27 27 27 27 27 27 27 27 27 110 110 110 27 27 27 27 27 27 27 27 27 110 110 110 110 110 110 110 110 110 110 27 27 1 1 27 1 111 111 111 111 111 111 27 27 27 1 111 111 111 27 27 27 27 27 27 27 27 27 27 27 27 27
27 27 27 27 27 27 27 27 27 27 110 110 110 27 1 27 27 1 1 27 27 1 110 110 110 110 110 110 110 110 110 110 1 111 111 111 111 111 111 111 111 27 111 111 27 21 27 27 111 111 111 27 27 27 27 27 27 27 27 27 27 27 27 27
27 27 27 27 27 27 27 110 110 3 110 110 110 110 110 110 110 110 110 110 110 27 110 110 110 12 12 11 12 110 110 110 92 111 111 111 111 111 111 111 111 27 111 111 100 111 21 27 111 111 111 1 27 27 27 27 27 27 27 27 27 27 27 27
27 27 27 8 27 110 110 27 110 27 110 110 110 110 110 110 110 110 110 110 110 90 110 110 110 12 10 12 12 110 110 110 27 111 111 111 111 111 111 111 111 27 111 111 27 21 27 1 111 111 111 27 27 27 27 27 27 27 27 27 27 27 27 27
27 27 27 8 110 110 110 1 110 27 110 110 110 110 110 110 110 110 110 110 110 1 110 110 110 110 110 110 110 110 110 110 1 27 27 1 27 1 111 111 111 111 111 111 27 27 27 27 111 111 111 27 27 27 27 27 27 27 27 27 27 27 27 27
27 27 27 8 110 110 8 27 110 27 1 27 27 1 27 27 1 27 27 1 27 27 110 110 110 110 110 110 110 110 110 110 1 27 27 27 27 27 111 111 111 111 111 111 27 111 111 111 111 111 111 1 27 27 27 27 27 27 27 27 27 27 27 27
27 27 27 8 110 110 8 27 110 110 110 110 110 110 110 110 110 110 110 110 110 1 110 110 110 110 110 110 110 110 110 110 27 27 27 27 27 1 111 111 111 111 111 111 6 111 111 111 111 111 111 27 27 27 27 27 27 27 27 27 27 27 27 27
27 27 27 8 110 110 8 27 4 27 27 1 1 27 27 110 110 110 110 110 110 27 27 4 27 91 27 27 1 1 1 27 27 27 27 27 27 27 111 111 111 111 111 111 27 111 111 27 27 1 1 27 27 27 27 27 27 27 27 27 27 27 27 27
27 27 27 7 110 110 8 8 27 27 27 27 27 27 1 110 110 110 110 110 110 4 27 27 27 110 27 27 27 27 27 27 27 27 27 27 27 27 27 1 1 1 27 27 27 27 1 27 27 27 27 27 27 27 27 27 27 27 27 27 27 27 27 27
27 27 27 8 110 110 110 8 27 27 27 27 27 27 27 110 110 110 110 110 110 1 27 27 1 110 110 106 110 27 1 27 1 1 27 27 27 27 27 27 27 27 27 27 27 27 27 27 27 27 27 27 27 27 27 27 27 27 27 27 27 27 27 27
27 27 27 8 110 110 110 8 27 27 27 27 27 27 27 110 110 110 110 110 110 27 27 27 27 110 110 110 110 110 110 110 106 110 110 110 27 27 27 27 27 27 27 27 27 27 27 27 27 27 27 27 27 27 27 27 27 27 27 27 27 27 27 27
27 27 27 8 110 110 110 8 27 27 27 27 27 27 27 27 1 27 1 27 27 27 27 27 1 110 110 110 110 110 110 110 110 106 110 110 4 27 27 27 27 27 27 27 27 27 27 27 27 27 27 27 27 27 27 27 27 27 27 27 27 27 27 27
27 27 27 7 110 110 110 8 8 8 8 8 8 8 8 8 8 8 8 8 8 8 27 27 1 110 110 110 110 110 110 110 106 110 110 110 1 27 27 27 27 27 27 27 27 27 27 27 27 27 27 27 27 27 27 27 27 27 27 27 27 27 27 27
27 27 27 8 110 110 110 110 110 110 110 110 110 110 110 110 110 110 110 110 110 7 27 27 27 106 110 110 110 27 1 1 27 27 27 1 27 27 27 27 27 27 27 27 27 27 27 27 27 27 27 27 27 27 27 27 27 27 27 27 27 27 27 27
27 27 27 8 110 110 110 110 110 110 110 110 110 110 110 110 110 110 110 110 110 8 27 27 27 27 1 1 27 27 27 27 27 27 27 27 27 27 27 27 27 27 27 27 27 27 27 27 27 27 27 27 27 27 27 27 27 27 27 27 27 27 27 27
27 27 27 8 110 110 110 8 8 8 8 8 8 8 8 8 8 8 8 110 110 7 27 27 27 27 27 27 27 27 27 27 27 27 27 27 27 27 27 27 27 27 27 27 27 27 27 27 27 27 27 27 27 27 27 27 27 27 27 27 27 27 27 27
27 27 27 7 110 110 110 8 8 8 8 8 8 8 8 8 8 110 8 110 110 8 27 8 7 8 8 27 27 27 27 27 27 27 27 27 27 27 27 27 27 27 27 27 27 27 27 27 27 27 27 27 27 27 27 27 27 27 27 27 27 27 27 27
27 27 27 8 110 110 110 110 110 110 110 110 7 8 110 90 110 110 8 110 110 8 27 8 110 110 8 27 27 27 27 27 27 27 27 27 27 27 27 27 27 27 27 27 27 27 27 27 27 27 27 27 27 27 27 27 27 27 27 27 27 27 27 27
27 27 27 8 110 110 110 110 110 110 110 110 8 8 8 8 8 8 8 110 110 8 27 8 110 110 7 27 27 27 27 27 27 27 27 27 27 27 27 27 27 27 27 27 27 27 27 27 27 27 27 27 27 27 27 27 27 27 27 27 27 27 27 27
27 27 27 8 8 7 8 8 8 8 110 110 8 8 8 8 110 110 8 110 110 8 27 8 110 110 8 27 27 27 27 27 27 27 27 27 27 27 27 27 27 27 27 27 27 27 27 27 27 27 27 27 27 27 27 27 27 27 27 27 27 27 27 27
27 27 27 27 27 27 27 27 27 8 110 110 7 8 8 8 110 110 8 110 110 8 8 8 110 110 8 27 27 27 27 27 27 27 27 27 27 27 27 27 27 27 27 27 27 27 27 27 27 27 27 27 27 27 27 27 27 27 27 27 27 27 27 27
27 27 27 27 27 27 27 27 27 8 110 110 8 8 8 8 8 8 8 110 110 110 110 110 110 110 8 27 27 27 27 27 27 27 27 27 27 27 27 27 27 27 27 27 27 27 27 27 27 27 27 27 27 27 27 27 27 27 27 27 27 27 27 27
27 27 27 27 27 27 27 27 27 7 110 110 110 110 110 110 110 110 8 110 110 110 110 110 110 110 8 27 27 27 27 27 27 27 27 27 27 27 27 27 27 27 27 27 27 27 27 27 27 27 27 27 27 27 27 27 27 27 27 27 27 27 27 27
27 27 27 27 27 27 27 27 27 8 110 110 110 110 110 110 110 110 7 8 7 8 8 8 7 8 8 27 27 27 27 27 27 27 27 27 27 27 27 27 27 27 27 27 27 27 27 27 27 27 27 27 27 27 27 27 27 27 27 27 27 27 27 27
27 27 27 27 27 27 27 27 27 8 7 8 8 8 8 8 8 8 8 27 27 27 27 27 27 27 27 27 27 27 27 27 27 27 27 27 27 27 27 27 27 27 27 27 27 27 27 27 27 27 27 27 27 27 27 27 27 27 27 27 27 27 27 27
27 27 27 27 27 27 27 27 27 27 27 27 27 27 27 27 27 27 27 27 27 27 27 27 27 27 27 27 27 27 27 27 27 27 27 27 27 27 27 27 27 27 27 27 27 27 27 27 27 27 27 27 27 27 27 27 27 27 27 27 27 27 27 27
27 27 27 27 27 27 27 27 27 27 27 27 27 27 27 27 27 27 27 27 27 27 27 27 27 27 27 27 27 27 27 27 27 27 27 27 27 27 27 27 27 27 27 27 27 27 27 27 27 27 27 27 27 27 27 27 27 27 27 27 27 27 27 27
27 27 27 27 27 27 27 27 27 27 27 27 27 27 27 27 27 27 27 27 27 27 27 27 27 27 27 27 27 27 27 27 27 27 27 27 27 27 27 27 27 27 27 27 27 27 27 27 27 27 27 27 27 27 27 27 27 27 27 27 27 27 27 27
27 27 27 27 27 27 27 27 27 27 27 27 27 27 27 27 27 27 27 27 27 27 27 27 27 27 27 27 27 27 27 27 27 27 27 27 27 27 27 27 27 27 27 27 27 27 27 27 27 27 27 27 27 27 27 27 27 27 27 27 27 27 27 27
27 27 27 27 27 27 27 27 27 27 27 27 27 27 27 27 27 27 27 27 27 27 27 27 27 27 27 27 27 27 27 27 27 27 27 27 27 27 27 27 27 27 27 27 27 27 27 27 27 27 27 27 27 27 27 27 27 27 27 27 27 27 27 27
27 27 27 27 27 27 27 27 27 27 27 27 27 27 27 27 27 27 27 27 27 27 27 27 27 27 27 27 27 27 27 27 27 27 27 27 27 27 27 27 27 27 27 27 27 27 27 27 27 27 27 27 27 27 27 27 27 27 27 27 27 27 27 27
27 27 27 27 27 27 27 27 27 27 27 27 27 27 27 27 27 27 27 27 27 27 27 27 27 27 27 27 27 27 27 27 27 27 27 27 27 27 27 27 27 27 27 27 27 27 27 27 27 27 27 27 27 27 27 27 27 27 27 27 27 27 27 27
27 27 27 27 27 27 27 27 27 27 27 27 27 27 27 27 27 27 27 27 27 27 27 27 27 27 27 27 27 27 27 27 27 27 27 27 27 27 27 27 27 27 27 27 27 27 27 27 27 27 27 27 27 27 27 27 27 27 27 27 27 27 27 27
27 27 27 27 27 27 27 27 27 27 27 27 27 27 27 27 27 27 27 27 27 27 27 27 27 27 27 27 27 27 27 27 27 27 27 27 27 27 27 27 27 27 27 27 27 27 27 27 27 27 27 27 27 27 27 27 27 27 27 27 27 27 27 27
27 27 27 27 27 27 27 27 27 27 27 27 27 27 27 27 27 27 27 27 27 27 27 27 27 27 27 27 27 27 27 27 27 27 27 27 27 27 27 27 27 27 27 27 27 27 27 27 27 27 27 27 27 27 27 27 27 27 27 27 27 27 27 27
27 27 27 27 27 27 27 27 27 27 27 27 27 27 27 27 27 27 27 27 27 27 27 27 27 27 27 27 27 27 27 27 27 27 27 27 27 27 27 27 27 27 27 27 27 27 27 27 27 27 27 27 27 27 27 27 27 27 27 27 27 27 27 27
27 27 27 27 27 27 27 27 27 27 27 27 27 27 27 27 27 27 27 27 27 27 27 27 27 27 27 27 27 27 27 27 27 27 27 27 27 27 27 27 27 27 27 27 27 27 27 27 27 27 27 27 27 27 27 27 27 27 27 27 27 27 27 27
27 27 27 27 27 27 27 27 27 27 27 27 27 27 27 27 27 27 27 27 27 27 27 27 27 27 27 27 27 27 27 27 27 27 27 27 27 27 27 27 27 27 27 27 27 27 27 27 27 27 27 27 27 27 27 27 27 27 27 27 27 27 27 27
27 27 27 27 27 27 27 27 27 27 27 27 27 27 27 27 27 27 27 27 27 27 27 27 27 27 27 27 27 27 27 27 27 27 27 27 27 27 27 27 27 27 27 27 27 27 27 27 27 27 27 27 27 27 27 27 27 27 27 27 27 27 27 27
27 27 27 27 27 27 27 27 27 27 27 27 27 27 27 27 27 27 27 27 27 27 27 27 27 27 27 27 27 27 27 27 27 27 27 27 27 27 27 27 27 27 27 27 27 27 27 27 27 27 27 27 27 27 27 27 27 27 27 27 27 27 27 27
