27 27 27 27 27 27 27 27 27 27 27 27 27 27 27 27 27 27 27 27 27 27 27 27 27 27 27 27 27 27 27 27 27 27 27 27 27 27 27 27 27 27 27 27 27 27 27 27 27 27 27 27 27 27 27 27 27 27 27 27 27 27 27 27
27 27 27 27 27 27 27 27 27 27 27 27 27 27 27 27 27 27 27 27 27 27 27 27 27 27 27 27 27 27 27 27 27 27 27 27 27 27 27 27 27 27 27 27 27 27 27 27 27 27 27 27 27 27 27 27 27 27 27 27 27 27 27 27
27 27 27 27 27 27 27 27 27 27 27 27 27 27 27 27 27 27 27 27 27 27 27 27 27 27 27 27 27 27 27 27 27 27 27 27 27 27 27 27 27 27 27 27 27 27 27 27 27 27 27 27 27 27 27 27 27 27 27 27 27 27 27 27
27 27 27 27 27 27 27 27 27 27 27 27 27 27 27 27 27 27 27 27 27 27 27 27 27 27 27 27 27 27 27 27 27 27 27 27 27 27 27 27 27 27 27 27 27 27 27 27 27 27 27 27 27 27 27 27 27 27 27 27 27 27 27 27
27 27 27 27 27 27 27 27 27 27 27 27 27 27 27 27 27 27 27 27 27 27 27 27 27 27 27 27 27 27 27 27 27 27 27 27 27 27 27 27 27 27 27 27 27 27 27 27 27 27 27 27 27 27 27 27 27 27 27 27 27 27 27 27
27 27 27 27 27 27 27 27 27 27 27 27 27 27 27 27 27 27 27 27 27 27 27 27 27 27 27 27 27 27 27 27 27 27 27 27 27 27 27 27 27 27 27 27 27 27 27 27 27 27 27 27 27 27 27 27 27 27 27 27 27 27 27 27
27 27 27 27 27 27 27 27 27 27 27 27 27 27 27 27 27 27 27 27 27 27 27 27 27 27 27 27 27 27 27 27 27 27 27 27 27 27 27 27 27 27 27 27 27 27 27 27 27 27 27 27 27 27 27 27 27 27 27 27 27 27 27 27
27 27 27 27 27 27 27 27 27 27 27 27 27 27 27 27 27 27 27 27 27 27 27 27 27 27 27 27 27 27 27 27 27 27 27 27 27 27 27 27 27 27 27 27 27 27 27 27 27 27 27 27 27 27 27 27 27 27 27 27 27 27 27 27
27 27 27 27 27 27 27 27 27 27 27 27 27 27 27 27 27 27 27 27 27 27 27 27 27 27 27 27 27 27 27 27 27 27 27 27 27 27 27 27 27 27 27 27 27 27 27 27 27 27 27 27 27 27 27 27 27 27 27 27 27 27 27 27
27 27 27 27 27 27 27 27 27 27 27 27 27 27 27 27 27 27 27 27 27 27 27 27 27 27 27 27 27 27 27 27 27 27 27 27 27 27 27 27 27 27 27 27 27 27 27 27 27 27 27 27 27 27 27 27 27 27 27 27 27 27 27 27
27 27 27 27 27 27 27 27 27 27 27 27 27 27 27 27 27 27 27 27 27 27 27 27 27 27 27 27 27 27 27 27 27 27 27 27 27 27 27 27 27 27 27 27 27 27 27 27 27 27 27 27 27 27 27 27 27 27 27 27 27 27 27 27
27 27 27 27 27 27 27 27 27 27 27 27 27 27 27 27 27 27 27 27 27 27 27 27 27 27 27 27 27 27 27 27 27 27 27 27 27 27 27 27 27 27 27 27 27 27 27 27 27 27 27 27 27 27 27 27 27 27 27 27 27 27 27 27
27 27 27 27 27 27 27 27 27 27 27 27 27 27 27 27 27 27 27 27 27 27 27 27 27 27 27 27 27 27 27 27 27 27 27 27 27 27 27 27 27 27 27 27 27 27 27 27 27 27 27 27 27 27 27 27 27 27 27 27 27 27 27 27
27 27 27 27 27 27 27 27 27 27 27 27 27 27 27 27 27 27 27 27 27 27 27 27 27 27 27 27 27 27 27 27 27 27 27 27 27 27 27 27 27 27 27 27 27 27 27 27 27 27 27 27 27 27 27 27 27 27 27 27 27 27 27 27
27 27 27 27 27 27 27 27 27 27 27 27 27 27 27 27 27 27 27 27 27 27 27 27 27 27 27 27 27 27 27 27 27 27 27 27 27 27 27 27 27 27 27 27 27 27 27 27 27 27 27 27 27 27 27 27 27 27 27 27 27 27 27 27
27 27 27 27 27 27 27 27 27 27 27 27 27 27 27 27 27 27 27 27 27 27 27 27 27 27 27 27 27 27 27 27 27 27 27 27 27 27 27 27 27 27 27 27 27 27 27 27 27 27 27 27 27 27 27 27 27 27 27 27 27 27 27 27
27 27 27 27 27 27 27 27 27 27 27 27 27 27 27 27 27 27 27 27 27 27 27 27 27 27 27 27 27 27 27 27 27 27 27 27 27 27 27 27 27 27 27 27 27 27 27 27 27 27 27 27 27 27 27 27 27 27 27 27 27 27 27 27
27 27 27 27 27 27 27 27 27 27 27 27 27 27 27 27 27 27 27 27 27 27 27 27 27 27 27 27 27 27 27 27 27 27 27 27 27 27 27 27 27 27 27 27 27 27 27 27 27 27 27 27 27 27 27 27 27 27 27 27 27 27 27 27
27 27 27 27 27 27 27 27 27 27 27 27 27 27 27 27 27 27 27 27 27 27 27 27 27 27 27 27 27 27 27 27 27 27 27 27 27 27 27 27 27 27 27 27 27 27 27 27 27 27 27 27 27 27 27 27 27 27 27 27 27 27 27 27
27 27 27 27 27 27 27 27 27 27 27 27 27 27 27 27 27 27 27 27 27 27 27 27 27 27 27 27 27 27 27 27 27 27 27 27 27 27 27 27 27 27 27 27 27 27 27 27 27 27 27 27 27 27 27 27 27 27 27 27 27 27 27 27
27 27 27 27 27 27 27 27 27 27 27 27 27 27 27 27 27 27 27 27 27 27 27 27 27 27 27 27 27 27 27 27 27 27 27 27 27 27 27 27 27 27 27 27 27 27 27 27 27 27 27 27 27 27 27 27 27 27 27 27 27 27 27 27
27 27 27 27 27 27 27 27 27 27 27 27 27 27 27 27 27 27 27 27 27 27 27 27 27 27 27 27 27 27 27 27 27 27 27 27 27 27 27 27 27 27 27 27 27 27 27 27 27 27 27 27 27 27 27 27 27 27 27 27 27 27 27 27
27 27 27 27 27 27 27 27 27 27 27 27 27 27 27 27 27 27 27 27 27 27 27 27 27 27 27 27 27 27 27 27 27 27 27 27 27 27 27 27 27 27 27 27 27 27 27 27 27 27 27 27 27 27 27 27 27 27 27 27 27 27 27 27
27 27 27 27 27 27 27 27 27 27 27 27 27 27 27 27 27 27 27 27 27 27 27 27 27 27 27 27 27 27 27 27 27 27 27 27 27 27 27 27 27 27 27 27 27 27 27 27 27 27 27 27 27 27 27 27 27 27 27 27 27 27 27 27
27 27 27 27 27 27 27 27 27 27 27 27 27 27 8 8 8 8 8 8 8 8 8 8 8 8 8 8 8 8 8 8 8 8 27 27 27 27 27 27 27 27 27 27 27 27 27 27 27 27 27 27 27 27 27 27 27 27 27 27 27 27 27 27
27 27 27 27 27 27 27 27 27 27 27 27 27 27 8 109 109 109 109 109 109 109 109 109 109 109 109 109 109 109 109 109 109 8 8 8 8 8 8 8 8 8 27 27 27 27 27 27 27 27 27 27 27 27 27 27 27 27 27 27 27 27 27 27
27 27 27 27 27 27 27 27 27 27 27 27 27 27 8 109 109 109 109 109 109 109 109 109 109 109 109 109 109 109 109 109 109 109 109 109 109 109 109 109 109 8 27 27 27 27 27 27 27 27 27 27 27 27 27 27 27 27 27 27 27 27 27 27
27 27 27 27 27 27 27 27 27 27 27 27 27 27 8 109 109 109 109 109 109 109 109 109 109 109 109 109 109 109 109 109 109 109 109 109 109 109 109 109 109 8 27 27 27 27 27 27 27 27 27 27 27 27 27 27 27 27 27 27 27 27 27 27
27 27 27 27 27 27 27 27 27 27 27 27 27 27 8 109 109 109 12 12 10 12 12 11 12 12 12 10 12 12 12 12 12 12 10 12 91 12 12 109 109 8 27 27 27 27 27 27 27 27 27 27 27 27 27 27 27 27 27 27 27 27 27 27
27 27 27 27 27 27 27 27 27 27 27 27 27 27 8 109 109 109 12 12 12 114 114 114 114 114 114 114 114 12 115 115 115 115 115 115 115 115 12 109 109 8 27 27 27 27 27 27 27 27 27 27 27 27 27 27 27 27 27 27 27 27 27 27
27 27 27 27 27 27 27 27 27 27 27 27 27 27 8 109 109 109 12 12 12 114 114 114 114 114 114 114 114 90 115 115 115 115 115 115 115 115 11 109 109 8 27 27 27 27 27 27 27 27 27 27 27 27 27 27 27 27 27 27 27 27 27 27
27 27 27 27 27 27 27 27 27 27 27 27 27 27 8 109 109 109 10 114 114 114 114 114 114 114 114 114 114 12 12 12 10 12 12 12 12 12 12 109 109 8 27 27 27 27 27 27 27 27 27 27 27 27 27 27 27 27 27 27 27 27 27 27
27 27 27 27 27 27 27 27 27 27 27 27 27 27 8 109 109 109 12 12 12 114 114 114 114 114 114 114 114 12 109 109 109 109 109 109 109 109 109 109 109 8 27 27 27 27 27 27 27 27 27 27 27 27 27 27 27 27 27 27 27 27 27 27
27 27 27 27 27 27 27 27 27 27 27 27 27 27 8 109 109 109 12 12 12 114 114 114 114 114 114 114 106 12 109 109 109 109 109 109 109 109 109 109 109 8 27 27 27 27 27 27 27 27 27 27 27 27 27 27 27 27 27 27 27 27 27 27
27 27 27 27 27 27 27 27 27 27 27 27 27 27 8 109 109 109 12 12 10 12 12 12 11 12 12 10 12 12 109 109 109 8 8 8 8 8 8 8 8 8 27 27 27 27 27 27 27 27 27 27 27 27 27 27 27 27 27 27 27 27 27 27
27 27 27 27 27 27 27 27 27 27 27 27 27 27 8 109 109 109 109 109 109 109 109 109 109 109 109 109 109 109 109 109 109 8 27 27 27 27 27 27 27 27 27 27 27 27 27 27 27 27 27 27 27 27 27 27 27 27 27 27 27 27 27 27
27 27 27 27 27 27 27 27 27 27 27 27 27 27 8 109 109 109 109 109 109 109 109 109 109 109 109 109 109 109 109 109 109 8 8 8 8 8 8 8 8 8 8 8 27 27 27 27 27 27 27 27 27 27 27 27 27 27 27 27 27 27 27 27
27 27 27 27 27 27 27 27 27 27 27 27 27 27 8 109 109 109 109 109 109 109 109 109 109 109 109 109 109 109 109 109 109 8 116 116 8 116 116 116 116 116 116 8 21 27 27 27 27 27 27 27 27 27 27 27 27 27 27 27 27 27 27 27
27 27 27 27 27 27 27 27 27 27 27 27 27 27 8 8 8 8 8 8 8 8 8 8 8 8 8 8 8 8 109 109 109 92 116 116 94 116 116 116 116 116 116 100 116 21 27 27 27 27 27 27 27 27 27 27 27 27 27 27 27 27 27 27
27 27 27 27 27 27 8 8 8 8 8 8 8 8 8 8 8 8 8 8 8 8 8 8 8 8 8 8 8 8 109 109 109 8 116 116 8 116 116 116 116 116 116 8 21 27 27 27 27 27 27 27 27 27 27 27 27 27 27 27 27 27 27 27
27 27 27 27 27 27 8 109 109 109 109 109 109 109 109 109 109 109 109 109 109 109 109 109 109 109 109 109 109 109 109 109 109 8 8 8 8 8 8 8 8 8 8 8 27 27 27 27 27 27 27 27 27 27 27 27 27 27 27 27 27 27 27 27
27 27 27 27 27 27 8 109 109 109 109 109 109 109 109 109 109 109 109 109 109 109 109 109 109 109 109 109 109 109 109 109 109 8 27 27 27 27 27 27 27 27 27 27 27 27 12 12 12 12 12 12 12 12 12 12 27 27 27 27 27 27 27 27
27 27 27 27 27 27 8 109 109 109 109 109 109 109 109 109 109 109 109 109 109 109 109 109 109 109 109 109 109 109 109 109 109 8 27 27 27 27 27 1 1 27 27 1 27 27 12 111 111 111 111 111 111 111 111 12 27 27 27 27 27 27 27 27
27 27 27 27 27 27 8 109 109 109 8 8 8 8 8 8 8 8 8 8 8 8 8 8 8 8 8 8 8 8 8 91 8 8 27 27 27 27 111 111 111 111 111 111 111 27 12 111 111 111 111 111 111 111 111 12 12 12 12 12 27 27 27 27
27 27 27 27 27 27 8 109 109 109 8 27 27 27 27 27 27 27 27 27 27 27 27 27 27 27 27 27 27 27 27 112 27 27 27 27 27 1 111 111 111 111 111 111 111 1 12 111 111 12 12 12 12 111 111 111 111 111 111 12 27 27 27 27
27 27 27 27 27 27 8 109 109 109 8 27 27 27 27 27 27 27 27 27 27 27 27 27 27 27 27 27 27 1 112 112 112 27 27 27 27 27 111 111 111 111 27 111 111 27 27 111 111 12 27 27 11 111 111 111 111 111 111 10 27 27 27 27
27 27 27 27 27 27 8 109 109 109 8 27 27 1 27 27 1 27 1 27 27 27 1 27 1 1 27 27 27 27 112 112 112 1 27 27 1 27 1 27 91 27 27 111 111 111 106 27 111 111 27 27 12 111 111 12 12 111 111 12 27 27 27 27
27 27 27 27 27 27 8 109 109 109 8 27 113 113 113 113 113 113 113 113 27 110 110 110 110 110 110 1 27 27 112 112 112 27 27 27 111 111 111 111 111 111 27 111 111 27 27 27 27 27 27 27 12 111 111 10 11 111 111 12 27 27 27 27
27 27 27 27 27 27 8 109 109 109 8 1 113 113 113 113 113 113 113 113 90 110 110 110 110 110 110 110 27 27 112 112 112 27 1 111 111 111 111 111 111 111 1 111 111 1 27 27 27 27 27 27 12 111 111 12 12 111 111 12 27 27 27 27
27 27 27 27 27 27 8 109 109 109 8 1 113 113 1 28 113 113 113 113 27 110 110 110 110 110 110 110 110 1 112 112 112 1 111 111 111 111 111 111 111 111 27 111 111 27 27 27 27 27 27 27 12 111 111 111 111 111 111 12 27 27 27 27
27 27 27 27 27 27 8 109 109 109 8 1 113 113 27 27 1 27 27 27 1 27 91 27 1 110 110 110 110 27 112 112 112 27 111 111 111 111 1 27 27 27 1 111 111 111 111 27 27 27 27 27 12 111 111 12 12 111 111 12 27 27 27 27
27 27 27 27 27 27 8 109 109 109 8 27 113 113 1 27 113 113 113 1 27 110 110 110 27 1 110 110 110 27 112 112 112 27 111 111 111 27 27 27 27 27 28 111 111 27 27 27 27 27 27 27 12 111 111 11 10 111 111 12 27 27 27 27
27 27 27 27 27 27 8 109 109 109 8 1 113 113 113 113 106 113 113 113 27 110 110 110 27 27 110 110 110 1 112 112 112 1 111 111 111 1 27 27 27 27 27 111 111 1 27 27 27 27 27 27 12 111 111 12 12 111 111 12 27 27 27 27
27 27 27 27 27 27 8 109 109 109 8 27 113 113 106 113 113 113 113 27 1 110 110 110 1 27 110 110 110 27 112 112 112 1 111 111 111 27 111 106 111 111 111 111 111 1 27 27 27 27 27 27 10 111 111 111 111 111 111 11 27 27 27 27
27 27 27 27 27 27 8 109 109 109 8 27 1 1 27 27 1 27 27 1 27 110 110 110 1 27 27 27 91 1 27 91 27 27 91 27 27 27 111 111 111 111 111 111 111 111 111 27 27 27 27 27 12 111 111 111 111 111 111 12 27 27 27 27
27 27 27 27 27 27 8 109 109 109 8 8 8 8 8 8 8 8 27 110 110 110 110 110 1 27 27 108 108 108 108 108 108 108 108 108 1 1 111 111 111 111 111 111 111 27 27 27 27 27 27 27 12 12 12 12 12 12 12 12 27 27 27 27
27 27 27 27 27 27 8 109 109 109 109 109 109 109 109 109 109 8 1 110 110 110 110 110 27 1 27 27 108 108 108 108 108 108 108 27 27 27 106 111 111 111 111 111 111 1 27 27 27 27 27 27 27 27 27 27 27 27 27 27 27 27 27 27
27 27 27 27 27 27 8 109 109 109 109 109 109 109 109 109 109 90 110 110 110 110 110 110 110 106 110 1 108 108 108 108 108 108 108 1 27 1 111 111 111 111 111 111 111 1 27 27 27 27 27 27 27 27 27 27 27 27 27 27 27 27 27 27
27 27 27 27 27 27 8 109 109 109 109 109 109 109 109 109 109 8 1 110 110 110 110 110 110 110 110 27 108 108 108 108 108 108 108 27 27 1 111 111 111 111 111 111 111 27 27 27 27 27 27 27 27 27 27 27 27 27 27 27 27 27 27 27
27 27 27 27 27 27 8 8 8 8 8 8 8 8 8 8 8 8 27 110 110 110 110 110 110 110 110 27 27 1 27 13 27 27 1 27 27 27 111 111 111 111 111 111 111 27 27 27 27 27 27 27 27 27 27 27 27 27 27 27 27 27 27 27
27 27 27 27 27 27 27 27 27 27 27 27 27 27 27 27 27 27 27 27 1 27 28 1 1 27 27 27 27 27 27 27 27 27 27 27 27 1 27 27 1 27 1 1 27 27 27 27 27 27 27 27 27 27 27 27 27 27 27 27 27 27 27 27
27 27 27 27 27 27 27 27 27 27 27 27 27 27 27 27 27 27 27 27 27 27 27 27 27 27 27 27 27 27 27 27 27 27 27 27 27 27 27 27 27 27 27 27 27 27 27 27 27 27 27 27 27 27 27 27 27 27 27 27 27 27 27 27
27 27 27 27 27 27 27 27 27 27 27 27 27 27 27 27 27 27 27 27 27 27 27 27 27 27 27 27 27 27 27 27 27 27 27 27 27 27 27 27 27 27 27 27 27 27 27 27 27 27 27 27 27 27 27 27 27 27 27 27 27 27 27 27
27 27 27 27 27 27 27 27 27 27 27 27 27 27 27 27 27 27 27 27 27 27 27 27 27 27 27 27 27 27 27 27 27 27 27 27 27 27 27 27 27 27 27 27 27 27 27 27 27 27 27 27 27 27 27 27 27 27 27 27 27 27 27 27
