27 27 27 27 27 27 27 27 27 27 27 27 27 27 27 27 27 27 27 27 27 27 27 27 27 27 27 27 27 27 27 27 27 27 27 27 27 27 27 27 27 27 27 27 27 27 27 27 27 27 27 27 27 27 27 27 27 27 27 27 27 27 27 27
27 27 27 27 27 27 27 27 27 27 27 27 27 27 27 27 27 27 27 27 27 27 27 27 27 27 27 27 27 27 27 27 27 27 27 27 27 27 27 27 27 27 27 27 27 27 27 27 27 27 27 27 27 27 27 27 27 27 27 27 27 27 27 27
27 27 27 27 27 27 27 27 27 27 27 27 27 27 27 27 27 27 27 27 27 27 27 27 27 27 27 27 27 27 27 27 27 27 27 27 27 27 27 27 27 27 27 27 27 27 27 27 27 27 27 27 27 27 27 27 27 27 27 27 27 27 27 27
27 27 27 27 27 27 27 27 27 27 27 27 27 27 27 27 27 27 27 27 27 27 27 27 27 27 27 27 27 27 27 27 27 27 27 27 27 27 27 27 27 27 27 27 27 27 27 27 27 27 27 27 27 27 27 27 27 27 27 27 27 27 27 27
27 27 27 27 27 27 27 27 27 27 27 27 27 27 27 27 27 27 27 27 27 27 27 27 27 27 27 27 27 27 27 27 27 27 27 27 27 27 27 27 27 27 27 27 27 27 27 27 27 27 27 27 27 27 27 27 27 27 27 27 27 27 27 27
27 27 27 27 27 27 27 27 27 27 27 27 27 27 27 27 27 27 27 27 27 27 27 27 27 27 27 27 27 27 27 27 27 27 27 27 27 27 27 27 27 27 27 27 27 27 27 27 27 27 27 27 27 27 27 27 27 27 27 27 27 27 27 27
27 27 27 27 27 27 27 27 27 27 27 27 27 27 27 27 27 27 27 27 27 27 27 27 27 27 27 27 27 27 27 27 27 27 27 27 27 27 27 27 27 27 27 27 27 27 27 27 27 27 27 27 27 27 27 27 27 27 27 27 27 27 27 27
27 27 27 27 27 27 27 27 27 27 27 27 27 27 27 27 27 27 27 27 27 27 27 27 27 27 27 27 27 27 27 27 27 27 27 27 27 27 27 27 27 27 27 27 27 27 27 27 27 27 27 27 27 27 27 27 27 27 27 27 27 27 27 27
27 27 27 27 27 27 27 27 27 27 27 27 27 27 27 27 27 27 27 27 27 27 27 27 27 27 27 27 27 27 27 27 27 27 27 27 27 27 27 27 27 27 27 27 27 27 27 27 27 27 27 27 27 27 27 27 27 27 27 27 27 27 27 27
27 27 27 27 27 27 27 27 27 27 27 27 27 27 27 27 27 27 27 27 27 27 27 27 27 27 27 27 27 27 27 27 27 27 27 27 27 27 27 27 27 27 27 27 27 27 27 27 27 27 27 27 27 27 27 27 27 27 27 27 27 27 27 27
27 27 27 27 27 27 27 27 27 27 27 27 27 27 27 27 27 27 27 27 27 27 27 27 27 27 27 27 27 27 27 27 27 27 27 27 27 27 27 27 27 27 27 27 27 27 27 27 27 27 27 27 27 27 27 27 27 27 27 27 27 27 27 27
27 27 27 27 27 27 27 27 27 27 27 27 27 27 27 27 27 27 27 27 27 27 27 27 27 27 27 27 27 27 27 27 27 27 27 27 27 27 27 27 27 27 27 27 27 27 27 27 27 27 27 27 27 27 27 27 27 27 27 27 27 27 27 27
27 27 27 27 27 27 27 27 27 27 27 27 27 27 27 27 27 27 27 27 27 27 27 27 27 27 27 27 27 27 27 27 27 27 27 27 27 27 27 27 27 27 27 27 27 27 27 27 27 27 27 27 27 27 27 27 27 27 27 27 27 27 27 27
27 27 27 27 27 27 27 27 27 27 27 27 27 27 27 27 27 27 27 27 27 27 27 27 27 27 27 27 27 27 27 27 27 27 27 27 27 27 27 27 27 27 27 27 27 27 27 27 27 27 27 27 27 27 27 27 27 27 27 27 27 27 27 27
27 27 27 27 27 27 27 27 27 27 27 27 27 27 27 27 27 27 27 27 27 27 27 27 27 27 27 27 27 27 27 27 27 27 27 27 27 27 27 27 27 27 27 27 27 27 27 27 27 27 27 27 27 27 27 27 27 27 27 27 27 27 27 27
27 27 27 27 27 27 27 27 27 27 27 27 27 27 27 27 27 27 27 27 27 27 27 27 27 27 116 116 116 116 116 116 116 116 116 116 116 116 27 27 27 27 27 27 27 27 27 27 27 27 27 27 27 27 27 27 27 27 27 27 27 27 27 27
27 27 27 27 27 27 27 27 27 27 27 27 27 27 27 27 27 27 27 27 27 27 27 27 27 28 116 116 116 116 116 116 116 116 116 116 116 116 116 116 116 116 116 116 27 27 27 27 27 27 27 27 27 27 27 27 27 27 27 27 27 27 27 27
27 27 27 27 27 27 27 27 27 27 27 27 27 27 27 27 27 27 27 27 27 27 27 27 27 27 116 116 116 27 27 27 27 116 116 116 116 116 116 116 116 116 116 116 27 27 27 117 117 117 117 117 117 117 117 117 117 27 27 27 27 27 27 27
27 27 27 27 27 27 27 27 27 27 27 27 27 27 27 27 27 27 27 27 27 27 27 27 27 27 116 116 116 27 27 27 27 27 27 27 27 27 27 27 116 116 116 116 27 117 117 117 117 117 117 117 117 117 117 117 117 117 117 27 27 27 27 27
27 27 27 27 27 27 27 27 27 27 27 27 27 27 27 27 27 27 27 27 27 27 27 27 27 27 116 116 116 116 116 106 116 28 27 21 27 27 27 27 27 116 27 27 28 117 117 117 27 27 27 3 27 27 27 117 117 117 117 117 27 27 27 27
27 27 27 27 27 27 27 27 27 27 27 27 27 27 27 27 27 27 27 27 27 27 27 27 27 27 116 116 116 116 116 116 106 116 100 116 21 27 27 27 116 116 27 116 94 117 117 117 4 27 27 27 27 27 4 117 117 117 117 117 117 27 27 27
27 27 27 27 27 27 27 27 27 27 27 27 27 27 27 27 27 27 27 27 27 27 27 27 27 27 116 116 116 116 116 106 116 28 27 21 27 27 27 27 27 116 27 27 28 117 117 117 27 27 27 3 27 27 27 117 117 117 117 117 117 117 27 27
27 27 27 27 27 27 27 27 27 27 27 27 27 27 27 27 27 27 27 27 27 27 27 27 27 27 116 116 116 27 27 27 27 27 27 27 27 27 27 27 116 116 116 116 27 117 117 117 117 117 117 117 117 117 117 117 117 117 117 117 117 117 27 27
27 27 27 27 27 27 27 27 27 27 27 27 27 27 27 27 27 27 27 27 27 27 27 27 27 27 116 116 116 27 27 27 27 116 116 116 116 116 116 116 116 116 116 116 27 27 27 117 117 117 117 117 117 117 117 117 27 27 27 117 117 117 27 27
27 27 27 27 27 27 27 27 27 27 27 27 27 27 27 27 27 27 27 27 27 27 27 27 27 28 116 116 116 116 116 116 116 116 116 116 116 116 116 116 116 116 116 116 27 27 27 27 27 27 27 27 27 27 27 27 27 27 27 117 117 117 27 27
27 27 27 27 27 27 27 27 27 27 27 27 27 27 27 27 27 27 27 27 27 27 27 116 116 27 116 116 116 116 116 116 116 116 116 116 116 116 27 27 27 27 27 27 27 27 27 27 27 27 27 27 27 27 27 27 27 27 27 117 117 117 27 27
27 27 27 27 27 27 27 27 27 27 27 27 27 27 27 27 27 27 27 27 27 116 27 116 116 116 27 27 27 27 27 27 27 27 27 27 27 27 27 110 110 110 110 110 110 110 110 110 110 110 110 110 110 110 110 110 27 27 27 117 117 117 27 27
27 27 27 27 27 27 27 27 27 27 27 27 27 27 27 27 27 27 27 27 27 116 27 116 116 116 27 27 27 27 27 27 27 27 27 27 27 27 110 110 110 110 110 110 110 110 110 110 110 110 110 110 110 110 110 110 110 27 117 117 117 117 117 27
27 27 27 27 27 27 27 27 27 27 27 27 27 27 27 27 27 27 116 116 116 116 116 116 116 116 116 116 27 27 27 27 27 27 27 27 27 110 110 110 110 110 110 110 110 110 110 110 110 110 110 110 110 110 110 110 110 27 117 117 117 117 117 27
27 27 27 27 27 27 27 27 27 27 27 27 27 27 27 27 27 27 27 27 116 116 116 116 116 116 27 27 27 27 27 27 27 27 27 27 27 110 110 110 12 12 12 12 12 12 12 12 12 12 12 12 12 12 110 110 110 28 117 117 117 117 117 27
27 27 27 27 27 27 27 27 27 27 27 27 27 27 27 27 27 27 116 116 116 116 116 116 116 116 116 116 27 27 27 27 27 27 27 27 27 110 110 110 12 111 111 111 111 111 10 111 111 111 111 111 111 12 110 110 110 90 117 117 117 117 117 27
27 27 27 27 27 27 27 27 27 27 27 27 27 27 27 27 27 27 27 27 116 116 116 116 116 116 27 27 27 27 27 27 27 27 27 27 27 110 110 110 12 111 111 111 111 111 12 111 111 111 111 111 111 12 110 110 110 28 27 27 27 27 27 27
27 27 27 27 27 27 27 27 27 27 27 27 27 27 27 27 27 27 27 27 27 116 27 27 116 27 27 27 27 27 27 27 27 27 27 27 27 110 110 110 12 111 111 12 111 111 111 111 111 12 12 111 111 12 110 110 110 27 27 27 27 27 27 27
27 27 27 27 27 27 27 27 27 27 27 27 27 27 27 27 27 27 27 27 27 116 27 27 116 27 27 27 27 27 27 27 27 27 27 27 27 110 110 110 11 111 111 12 111 111 111 111 111 111 11 111 111 12 110 110 110 27 27 27 27 27 27 27
27 27 27 27 27 27 27 27 27 27 27 27 27 27 27 27 27 27 27 27 27 27 27 27 27 27 27 27 27 27 27 27 27 27 27 27 27 110 110 110 12 111 111 12 12 12 12 12 12 12 12 12 91 12 110 110 110 27 109 109 109 109 27 27
27 27 27 27 27 27 27 27 27 27 27 27 27 27 27 27 27 27 27 27 27 27 27 27 27 27 27 27 27 27 27 27 27 27 27 27 27 110 110 110 12 111 111 12 110 110 110 110 110 110 110 110 110 110 110 110 110 90 109 109 109 109 27 27
27 27 27 27 27 27 27 27 27 27 27 27 27 27 27 27 27 27 27 27 27 27 27 27 27 27 27 27 27 27 27 27 27 27 27 27 27 110 110 110 12 111 111 11 110 110 110 110 110 110 110 110 110 110 110 110 110 27 109 109 109 109 27 27
27 27 27 27 27 27 27 27 27 27 27 27 27 27 27 27 27 27 27 27 27 27 27 27 27 27 27 27 27 27 27 27 27 27 27 27 27 110 110 110 12 111 111 12 110 110 110 110 110 110 110 110 110 110 110 110 27 27 109 109 109 109 27 27
27 27 27 27 27 27 27 27 27 27 27 27 27 27 27 27 27 27 27 27 27 27 27 27 27 27 27 27 27 112 112 112 112 112 112 112 27 110 110 110 12 10 12 12 110 110 110 27 27 27 27 27 27 27 27 27 27 27 109 109 109 109 27 27
27 27 27 27 27 27 27 27 27 27 27 27 27 27 27 27 27 27 27 27 27 27 27 27 27 27 27 27 27 112 112 112 112 112 112 112 27 110 110 110 110 110 110 110 110 110 110 27 27 27 27 27 27 27 27 27 27 27 109 109 109 109 27 27
27 27 27 27 27 27 27 27 27 27 27 27 27 27 27 27 27 27 27 27 27 27 27 27 27 27 27 27 27 112 112 112 112 112 112 112 27 110 110 110 110 110 110 110 110 110 110 27 27 113 113 113 27 27 27 109 109 109 109 109 109 109 27 27
27 27 27 27 27 27 27 27 27 27 27 27 27 27 27 27 27 27 27 27 27 27 27 27 27 27 27 27 27 112 112 112 112 112 112 112 27 27 110 110 110 110 110 110 110 110 27 27 27 113 113 113 27 27 27 109 109 109 109 109 109 109 27 27
27 27 27 27 27 27 27 27 27 27 27 27 27 27 27 27 27 27 27 27 27 27 27 27 27 27 27 27 27 112 112 27 27 112 112 112 27 27 27 27 27 27 27 27 27 27 27 27 27 113 113 113 27 27 27 109 109 109 109 27 27 27 27 27
27 27 27 27 27 27 27 27 27 27 27 27 27 27 27 27 27 27 27 27 27 27 27 27 27 27 27 27 27 112 112 27 27 112 112 112 112 112 112 112 112 112 112 112 112 112 112 112 27 113 113 113 27 27 27 109 109 109 109 27 27 27 27 27
27 27 27 27 27 27 27 27 27 27 27 27 27 27 27 27 27 27 27 27 27 27 27 27 27 27 27 27 27 112 112 27 27 112 112 112 112 112 112 112 112 112 112 112 112 112 112 112 27 113 113 113 27 27 27 109 109 109 109 27 27 27 27 27
27 27 27 27 27 27 27 27 27 27 27 27 27 27 27 27 27 27 27 27 27 27 27 27 27 27 27 27 27 112 112 27 27 27 27 27 27 27 27 27 27 27 27 27 27 27 27 27 27 28 91 28 27 27 27 109 109 109 109 109 109 109 27 27
27 27 27 27 27 27 27 27 27 27 27 27 27 27 27 27 27 27 27 27 27 27 27 27 27 27 27 27 27 112 112 27 27 27 27 27 27 27 27 27 27 27 27 27 112 112 112 112 112 112 112 112 27 27 27 109 109 109 109 109 109 109 27 27
27 27 27 27 27 27 27 27 27 27 27 27 27 27 27 27 27 27 27 27 27 27 27 27 27 27 27 27 27 112 112 27 112 112 112 112 28 115 115 115 115 115 27 27 112 112 112 112 112 112 112 112 27 27 27 27 27 27 109 109 109 109 27 27
27 27 27 27 27 27 27 27 27 27 27 27 27 27 27 27 27 27 27 27 27 27 27 27 27 27 27 27 27 112 112 27 112 112 112 112 90 115 115 115 115 115 27 27 112 112 112 112 112 112 112 112 27 27 27 27 27 27 109 109 109 109 27 27
27 27 27 27 27 27 27 27 27 27 27 27 27 27 27 27 27 27 27 27 27 27 27 27 27 27 27 27 27 112 112 27 112 112 112 112 28 115 115 115 115 115 27 27 112 112 112 27 27 27 27 27 27 27 27 109 109 109 109 109 109 109 27 27
27 27 27 27 27 27 27 27 27 27 27 27 27 27 27 27 27 27 27 27 27 27 27 27 27 27 27 27 27 112 112 27 112 112 112 27 27 27 27 27 27 27 27 27 112 112 112 27 27 27 27 27 27 27 3 109 109 109 109 109 109 109 27 27
27 27 27 27 27 27 27 27 27 27 27 27 27 27 27 27 27 27 27 27 27 27 27 27 27 27 27 27 27 112 112 27 27 93 27 27 27 27 27 27 27 27 27 27 112 112 112 27 27 27 112 112 112 112 90 109 109 109 27 27 27 27 27 27
27 27 27 27 27 27 27 27 27 27 27 27 27 27 27 27 27 27 27 27 27 27 27 27 27 27 27 27 27 112 112 27 112 112 112 112 112 112 112 112 112 112 112 112 112 112 112 27 27 27 112 112 112 27 3 109 109 109 27 108 108 108 108 27
27 27 27 27 27 27 27 27 27 27 27 27 27 27 27 27 27 27 27 27 27 27 27 27 27 27 27 27 27 27 27 27 112 112 112 112 112 112 112 112 112 112 112 112 112 112 112 112 112 112 112 112 112 27 27 109 109 109 27 108 108 108 108 27
27 27 27 27 27 27 27 27 27 27 27 27 27 27 27 27 27 27 27 27 27 27 27 27 27 27 27 27 27 27 27 27 112 112 112 112 112 112 112 112 112 112 112 112 112 112 112 112 112 112 112 112 112 27 27 27 109 27 27 108 108 108 108 27
27 27 27 27 27 27 27 27 27 27 27 27 27 27 27 27 27 27 27 27 27 27 27 27 27 27 27 27 27 27 27 27 27 27 27 27 27 27 27 27 27 27 27 27 27 27 27 27 27 27 27 27 27 27 27 27 91 27 27 108 108 108 108 27
27 27 27 27 27 27 27 27 27 27 27 27 27 27 27 27 27 27 27 27 27 27 27 27 27 27 27 27 114 114 114 114 27 27 27 114 114 114 114 27 27 27 27 27 27 27 27 27 27 27 27 27 27 27 27 27 108 27 27 27 108 108 27 27
27 27 27 27 27 27 27 27 27 27 27 27 27 27 27 27 27 27 27 27 27 27 27 27 27 27 27 27 114 114 114 114 114 114 27 114 114 114 114 27 27 27 27 27 27 27 27 27 27 27 27 27 27 27 27 108 108 108 27 27 108 108 27 27
27 27 27 27 27 27 27 27 27 27 27 27 27 27 27 27 27 27 27 27 27 27 27 27 27 27 27 27 114 114 27 27 114 114 27 106 114 114 106 27 27 27 114 114 114 114 114 114 114 114 114 27 27 108 108 108 108 108 108 27 108 108 27 27
27 27 27 27 27 27 27 27 27 27 27 27 27 27 27 27 27 27 27 27 27 27 27 27 27 27 27 27 114 114 27 27 114 114 27 114 114 114 114 27 27 27 114 114 114 114 114 114 114 114 114 114 90 108 108 108 108 108 108 27 108 108 27 27
27 27 27 27 27 27 27 27 27 27 27 27 27 27 27 27 27 27 27 27 27 27 27 27 27 27 27 27 114 114 27 27 114 114 27 114 114 114 114 27 27 27 114 114 114 114 114 114 114 114 114 27 27 108 108 108 108 108 108 27 108 108 27 27
27 27 27 27 27 27 27 27 27 27 27 27 27 27 27 27 27 27 27 27 27 27 27 27 27 27 27 27 114 114 114 114 114 114 27 114 114 114 114 114 114 114 114 114 114 27 27 27 27 27 27 27 27 27 108 108 108 108 108 108 27 108 108 27
27 27 27 27 27 27 27 27 27 27 27 27 27 27 27 27 27 27 27 27 27 27 27 27 27 27 27 27 114 114 114 114 114 114 27 114 114 114 114 114 114 114 114 114 114 27 27 27 27 27 27 27 27 27 27 27 3 27 108 108 27 27 27 27
27 27 27 27 27 27 27 27 27 27 27 27 27 27 27 27 27 27 27 27 27 27 27 27 27 27 27 27 27 27 27 27 27 27 27 27 27 27 27 27 27 27 27 27 27 27 27 27 27 27 27 27 27 27 27 27 27 27 27 13 27 27 27 27
