27 27 27 27 27 27 27 27 27 27 27 27 27 27 27 27 27 27 27 27 27 27 27 27 27 27 27 27 27 27 27 27 27 27 27 27 27 27 27 27 27 27 27 27 27 27 27 27 27 27 27 27 27 27 27 27 27 27 27 27 27 27 27 27
27 27 27 27 27 27 27 27 27 27 27 27 27 27 27 27 27 27 27 27 27 27 27 27 27 27 27 27 27 27 27 27 27 27 27 27 27 27 27 27 27 27 27 27 27 27 27 27 27 27 27 27 27 27 27 27 27 27 27 27 27 27 27 27
27 27 27 27 27 27 27 27 27 27 27 27 27 27 27 27 27 27 27 27 27 27 27 27 27 27 27 27 27 27 27 27 27 27 27 27 27 27 27 27 27 27 27 27 27 27 27 27 27 27 27 27 27 27 27 27 27 27 27 27 27 27 27 27
27 27 27 27 27 27 27 27 27 27 27 27 27 27 27 27 27 27 27 27 27 27 27 27 27 27 27 27 27 27 27 27 27 27 27 27 27 27 27 27 27 27 27 27 27 27 27 27 27 27 27 27 27 27 27 27 27 27 27 27 27 27 27 27
27 27 27 27 27 27 27 27 27 27 27 27 27 27 27 27 27 27 27 27 27 27 27 27 27 27 27 27 27 27 27 27 27 27 27 27 27 27 27 27 27 27 27 27 27 27 27 27 27 27 27 27 27 27 27 27 27 27 27 27 27 27 27 27
27 27 27 27 27 27 27 27 27 27 27 27 27 27 27 27 27 27 27 27 27 27 27 27 27 27 27 27 27 27 27 27 27 27 27 27 27 27 27 27 27 27 27 27 27 27 27 27 27 27 27 27 27 27 27 27 27 27 27 27 27 27 27 27
27 27 27 27 27 27 27 27 27 27 27 27 27 27 27 27 27 27 27 27 27 27 27 27 27 27 27 27 27 27 27 27 27 27 27 27 27 27 27 27 27 27 27 27 27 27 27 27 27 27 27 27 27 27 27 27 27 27 27 27 27 27 27 27
27 27 27 27 27 27 27 27 27 27 27 27 27 27 27 27 27 27 27 27 27 27 27 27 27 27 27 27 27 27 27 27 27 27 27 27 27 27 27 27 27 27 27 27 27 27 27 27 27 27 27 27 27 27 27 27 27 27 27 27 27 27 27 27
27 27 27 27 27 27 27 27 27 27 27 27 27 27 27 27 27 27 27 27 27 27 27 27 27 27 27 27 27 27 27 27 27 27 27 27 27 27 27 27 27 27 27 27 27 27 27 27 27 27 27 27 27 27 27 27 27 27 27 27 27 27 27 27
27 27 27 27 27 27 27 27 27 27 27 27 27 27 27 27 27 27 27 27 27 27 27 27 27 27 27 27 27 27 27 27 27 27 27 27 27 27 27 27 27 27 27 27 27 27 27 27 27 27 27 27 27 27 27 27 27 27 27 27 27 27 27 27
27 27 27 27 27 27 27 27 27 27 27 27 27 27 27 27 27 27 27 27 27 27 27 27 27 27 27 27 27 27 27 27 27 27 27 27 27 27 27 27 27 27 27 27 27 27 27 27 27 27 27 27 27 27 27 27 27 27 27 27 27 27 27 27
27 27 27 27 27 27 27 27 27 27 27 27 27 27 27 27 27 27 27 27 27 27 27 27 27 27 27 27 1 1 27 27 27 1 27 27 1 27 1 27 27 1 27 27 27 27 27 27 27 27 27 27 27 27 27 27 27 27 27 27 27 27 27 27
27 27 27 27 27 27 27 27 27 27 27 27 27 27 27 27 27 27 27 27 27 27 27 27 27 27 27 109 109 109 109 109 109 109 109 109 109 109 109 109 109 109 109 27 27 27 27 27 27 27 27 27 27 27 27 27 27 27 27 27 27 27 27 27
27 27 27 27 27 27 27 27 27 27 27 27 27 27 27 27 27 27 27 27 27 27 27 27 27 27 1 109 109 109 109 109 109 109 109 109 109 109 109 109 109 109 109 1 27 27 27 27 27 27 27 27 27 27 27 27 27 27 27 27 27 27 27 27
27 27 27 27 27 27 27 27 27 27 27 27 27 27 27 27 27 27 27 27 27 27 27 27 27 27 1 109 109 109 109 109 109 109 109 109 109 109 109 109 109 109 109 1 27 27 27 27 27 27 27 27 27 27 27 27 27 27 27 27 27 27 27 27
27 27 27 27 27 27 27 27 27 27 27 27 27 27 27 27 27 27 27 27 27 27 27 27 27 1 27 109 109 109 17 17 17 17 17 17 17 17 17 17 109 109 109 27 27 1 1 27 27 1 27 27 1 27 27 27 27 27 27 27 27 27 27 27
27 27 27 27 27 27 27 27 27 27 27 27 27 27 27 27 27 27 27 27 27 27 27 1 109 109 109 109 109 109 17 114 114 114 114 114 114 106 114 17 109 109 109 109 109 109 109 109 109 109 109 109 109 27 27 27 27 27 27 27 27 27 27 27
27 27 27 27 27 27 27 27 27 27 27 27 27 27 27 27 27 27 27 27 27 27 27 27 109 109 109 109 109 109 17 114 114 114 114 114 106 114 114 17 109 109 109 109 109 109 109 109 109 109 109 109 109 1 27 27 27 27 27 27 27 27 27 27
27 27 27 27 27 27 27 27 27 27 27 27 27 27 27 27 27 27 27 27 27 27 27 27 109 109 109 109 109 109 17 114 114 114 114 114 114 106 114 17 109 109 109 109 109 109 109 109 109 109 109 109 109 1 27 27 27 27 27 27 27 27 27 27
27 27 27 27 27 27 27 27 27 27 27 27 27 27 27 27 27 27 27 27 27 27 27 1 109 109 109 17 17 17 17 114 114 114 17 17 17 17 17 17 17 17 17 17 17 17 17 17 17 17 109 109 109 27 27 27 27 27 27 27 27 27 27 27
27 27 27 27 27 27 27 27 27 27 27 27 27 27 27 27 27 27 27 27 27 27 27 1 109 109 109 17 114 114 114 114 114 114 17 112 112 112 112 112 112 112 112 17 111 111 111 111 111 17 109 109 109 27 27 27 27 27 27 27 27 27 27 27
27 27 27 27 27 27 27 27 27 27 27 27 27 27 27 27 27 27 27 27 27 27 27 1 109 109 109 17 114 114 114 114 114 114 17 112 112 112 112 112 112 112 112 90 111 111 111 111 111 17 109 109 109 27 27 27 27 27 27 27 27 27 27 27
27 27 27 27 27 27 27 27 27 27 27 27 27 27 27 27 27 27 27 27 27 27 27 27 109 109 109 17 114 114 114 114 114 114 17 112 112 112 112 112 112 112 112 17 111 111 111 111 111 17 109 109 109 1 27 27 27 27 27 27 27 27 27 27
27 27 27 27 27 27 27 27 27 27 27 27 27 27 27 27 27 27 27 27 27 27 27 1 109 109 109 17 17 17 17 17 17 91 17 17 112 112 17 112 112 17 17 17 17 17 17 17 111 17 109 109 109 27 27 27 27 27 27 27 27 27 27 27
27 27 27 27 27 27 27 27 27 27 27 27 27 27 27 27 27 27 27 27 27 27 27 27 109 109 109 17 113 113 113 113 113 113 113 17 112 112 17 112 112 17 17 17 17 17 17 17 111 17 109 109 109 27 27 27 27 27 27 27 27 27 27 27
27 27 27 27 27 27 27 27 27 27 27 27 27 27 27 27 27 27 27 27 27 27 27 1 109 109 109 17 113 113 113 113 113 113 113 17 112 112 17 112 112 17 111 111 111 111 111 111 111 17 109 109 109 1 27 27 27 27 27 27 27 27 27 27
27 27 27 27 27 27 27 27 27 27 27 27 27 27 27 27 27 27 27 27 27 27 27 27 109 109 109 17 113 113 113 113 113 113 113 17 112 112 17 112 112 17 111 111 111 111 111 111 111 17 109 109 109 27 27 27 27 27 27 27 27 27 27 27
27 27 27 27 27 27 27 27 27 27 27 27 27 27 27 27 27 27 27 27 27 27 27 27 109 109 109 17 113 113 17 17 17 17 17 17 17 91 17 91 17 17 111 111 17 17 17 17 17 17 109 109 109 27 27 27 27 27 27 27 27 27 27 27
27 27 27 27 27 27 27 27 27 27 27 27 27 27 27 27 27 27 27 27 27 27 27 27 109 109 109 17 113 113 17 17 113 113 18 110 110 110 110 110 110 17 111 111 17 109 109 109 109 109 109 109 109 1 27 27 27 27 27 27 27 27 27 27
27 27 27 27 27 27 27 27 27 27 27 27 27 27 27 12 12 11 12 12 10 12 12 1 109 109 109 17 113 113 113 113 113 113 90 110 110 110 110 110 110 90 111 111 17 109 109 109 109 109 109 109 109 27 27 27 27 27 27 27 27 27 27 27
27 27 27 27 27 27 27 27 27 27 27 27 27 27 27 12 117 117 117 117 117 117 12 27 109 109 109 17 113 113 17 17 113 113 17 110 110 110 110 110 110 17 111 111 17 109 109 109 109 109 109 109 109 27 27 27 27 27 27 27 27 27 27 27
27 27 27 27 27 27 27 27 27 27 27 27 27 27 27 12 117 117 117 117 117 117 12 1 109 109 109 17 113 113 17 17 113 113 17 110 110 110 110 110 110 17 111 111 17 109 109 109 27 27 1 1 27 27 27 27 27 27 27 27 27 27 27 27
27 27 27 27 27 27 27 27 27 27 27 27 27 27 27 12 117 117 12 12 117 117 12 27 109 109 109 17 17 17 17 17 17 17 17 17 91 17 91 17 91 17 17 17 17 109 109 109 1 27 27 27 27 27 27 27 27 27 27 27 27 27 27 27
27 27 27 27 27 27 27 27 27 27 27 27 27 27 27 12 117 117 12 12 117 117 12 27 109 109 109 17 17 115 115 115 115 115 115 115 115 17 109 17 110 17 110 110 17 109 109 109 27 27 27 1 27 27 27 1 1 27 1 27 27 27 27 27
27 27 27 27 27 27 27 27 27 27 27 27 27 27 27 12 117 117 117 117 117 117 11 1 109 109 109 17 17 115 17 115 17 115 17 115 17 17 109 17 110 17 110 110 17 109 109 109 1 27 118 118 118 28 118 118 106 118 118 3 21 27 27 27
27 27 27 27 27 27 27 27 27 27 27 27 27 27 27 12 117 117 117 117 117 117 12 27 109 109 109 17 17 115 115 115 115 115 115 115 115 17 109 17 110 110 110 110 17 109 109 109 27 27 118 106 118 92 118 118 118 106 118 100 142 21 27 27
27 27 27 27 27 27 27 27 27 27 27 27 27 27 27 12 117 117 12 12 117 117 12 1 109 109 109 17 17 17 17 17 17 17 17 17 17 18 109 18 17 17 17 17 17 109 109 109 1 27 118 118 118 28 118 118 106 118 118 3 21 27 27 27
27 27 27 27 27 27 27 27 27 27 27 27 27 27 27 12 117 117 12 12 117 117 12 1 109 109 109 109 109 109 109 109 109 109 109 109 109 109 109 109 109 109 109 109 109 109 109 109 1 27 118 118 118 27 1 1 27 1 27 27 27 27 27 27
27 27 27 27 27 27 27 27 27 27 27 27 27 27 27 10 117 117 117 117 117 117 12 27 109 109 109 109 109 109 109 109 109 109 109 109 109 109 109 109 109 109 109 109 109 109 109 109 27 27 28 93 28 27 118 118 118 118 118 118 118 27 27 27
27 27 27 27 27 27 27 27 27 27 27 27 27 27 27 12 117 117 117 117 117 117 12 27 109 109 109 109 109 109 109 109 109 109 109 109 109 109 109 109 109 109 109 109 109 109 109 109 1 27 118 118 118 1 118 118 118 118 118 118 118 27 27 27
27 27 27 27 27 27 27 27 27 27 27 27 27 27 27 12 12 12 12 12 117 117 12 27 1 27 27 1 1 27 27 1 27 27 27 27 1 27 27 1 27 27 1 1 1 27 27 109 27 1 118 106 118 27 118 27 27 118 118 118 118 27 27 27
27 27 27 27 27 27 27 27 27 27 27 27 27 27 27 27 27 27 27 12 117 117 12 12 12 12 12 27 1 27 27 116 116 116 27 27 27 27 27 27 27 27 27 27 27 27 1 109 27 27 118 118 118 1 118 118 27 118 118 118 118 27 27 27
27 27 27 27 27 27 27 27 27 27 27 27 27 27 27 27 27 27 27 12 117 117 117 117 117 117 23 116 116 116 27 116 116 116 27 27 27 27 27 27 27 27 27 27 27 27 27 91 27 1 3 93 3 1 27 27 27 27 27 27 27 27 27 27
27 27 27 27 27 27 27 27 27 27 27 27 27 27 27 27 27 27 27 10 117 117 117 117 117 117 90 116 116 116 1 116 116 116 116 116 116 116 116 116 116 116 116 27 1 108 108 108 108 108 108 108 108 108 1 27 1 27 1 1 1 27 27 27
27 27 27 27 27 27 27 27 27 27 27 27 27 27 27 27 27 27 27 12 117 117 117 117 117 117 23 116 116 116 1 116 116 116 116 116 116 116 116 116 116 116 116 1 108 108 108 108 108 108 108 108 108 108 108 27 108 108 108 108 108 108 108 27
27 27 27 27 27 27 27 27 27 27 27 27 27 27 27 27 27 27 27 12 12 12 11 12 12 12 27 116 116 116 27 27 27 1 27 27 27 1 27 27 27 116 116 27 108 108 108 108 108 108 108 108 108 108 108 27 108 108 108 108 108 108 108 27
27 27 27 27 27 27 27 27 27 27 27 27 27 27 27 27 27 27 27 27 27 27 27 27 27 27 1 116 116 116 116 116 116 116 116 116 116 116 106 27 27 116 116 90 108 108 108 108 108 108 108 108 108 108 108 1 108 108 27 1 27 108 108 1
27 27 27 27 27 27 27 27 27 27 27 27 27 27 27 27 27 27 27 27 27 27 27 27 27 27 27 116 116 116 116 116 116 116 116 116 116 27 1 27 27 116 116 1 108 108 108 108 108 108 108 108 108 108 108 27 108 108 27 108 108 108 108 1
27 27 27 27 27 27 27 27 27 27 27 27 27 27 27 27 27 27 27 27 27 27 27 27 27 27 27 27 27 1 1 27 27 116 116 116 116 116 116 116 116 116 116 27 108 108 108 108 108 108 108 108 108 108 108 1 108 108 27 108 27 108 108 27
27 27 27 27 27 27 27 27 27 27 27 27 27 27 27 27 27 27 27 27 27 27 27 27 27 27 27 27 27 27 27 27 27 116 116 116 116 116 116 116 116 116 116 27 27 108 108 108 108 108 108 108 108 108 108 27 108 108 1 108 27 108 108 1
27 27 27 27 27 27 27 27 27 27 27 27 27 27 27 27 27 27 27 27 27 27 27 27 27 27 27 27 27 27 27 27 27 27 1 27 27 1 27 1 27 27 27 27 27 27 27 27 27 27 27 27 27 108 108 1 108 108 1 108 27 27 1 27
27 27 27 27 27 27 27 27 27 27 27 27 27 27 27 27 27 27 27 27 27 27 27 27 27 27 27 27 27 27 27 27 27 27 27 27 27 27 27 27 27 27 27 27 27 27 27 27 27 27 27 27 27 108 108 1 108 108 27 108 108 108 108 27
27 27 27 27 27 27 27 27 27 27 27 27 27 27 27 27 27 27 27 27 27 27 27 27 27 27 27 27 27 27 27 27 27 27 27 27 27 27 27 27 27 27 27 27 27 27 27 27 27 27 27 108 108 108 108 1 108 108 27 27 27 27 108 27
27 27 27 27 27 27 27 27 27 27 27 27 27 27 27 27 27 27 27 27 27 27 27 27 27 27 27 27 27 27 27 27 27 27 27 27 27 27 27 27 27 27 27 27 27 27 27 27 27 27 1 108 108 108 108 27 108 108 108 108 27 27 108 27
27 27 27 27 27 27 27 27 27 27 27 27 27 27 27 27 27 27 27 27 27 27 27 27 27 27 27 27 27 27 27 27 27 27 27 27 27 27 27 27 27 27 27 27 27 27 27 27 27 27 1 108 108 1 108 27 27 27 108 108 27 27 108 1
27 27 27 27 27 27 27 27 27 27 27 27 27 27 27 27 27 27 27 27 27 27 27 27 27 27 27 27 27 27 27 27 27 27 27 27 27 27 27 27 27 27 27 27 27 27 27 27 27 27 27 108 108 27 108 27 27 1 108 108 1 27 108 1
27 27 27 27 27 27 27 27 27 27 27 27 27 27 27 27 27 27 27 27 27 27 27 27 27 27 27 27 27 27 27 27 27 27 27 27 27 27 27 27 27 27 27 27 27 27 27 27 27 27 27 108 108 27 27 3 27 28 108 108 1 27 108 1
27 27 27 27 27 27 27 27 27 27 27 27 27 27 27 27 27 27 27 27 27 27 27 27 27 27 27 27 27 27 27 27 27 27 27 27 27 27 27 27 27 27 27 27 27 27 27 27 27 27 1 108 108 108 108 108 108 108 108 108 1 27 108 27
27 27 27 27 27 27 27 27 27 27 27 27 27 27 27 27 27 27 27 27 27 27 27 27 27 27 27 27 27 27 27 27 27 27 27 27 27 27 27 27 27 27 27 27 27 27 27 27 108 108 27 108 108 108 108 108 108 108 108 108 27 108 108 27
27 27 27 27 27 27 27 27 27 27 27 27 27 27 27 27 27 27 27 27 27 27 27 27 27 27 27 27 27 27 27 27 27 27 27 27 27 27 27 27 27 27 27 27 27 27 27 27 27 108 108 1 1 1 27 108 27 1 1 1 1 108 27 27
27 27 27 27 27 27 27 27 27 27 27 27 27 27 27 27 27 27 27 27 27 27 27 27 27 27 27 27 27 27 27 27 27 27 27 27 27 27 27 27 27 27 27 27 27 27 108 108 108 108 108 27 27 27 1 108 27 108 108 106 27 108 1 27
27 27 27 27 27 27 27 27 27 27 27 27 27 27 27 27 27 27 27 27 27 27 27 27 27 27 27 27 27 27 27 27 27 27 27 27 27 27 27 27 27 27 27 27 27 27 108 108 108 108 108 27 27 27 27 108 27 108 27 1 27 108 27 27
27 27 27 27 27 27 27 27 27 27 27 27 27 27 27 27 27 27 27 27 27 27 27 27 27 27 27 27 27 27 27 27 27 27 27 27 27 27 27 27 27 27 27 27 27 27 108 108 108 108 108 27 27 27 27 13 27 108 108 108 108 108 27 27
27 27 27 27 27 27 27 27 27 27 27 27 27 27 27 27 27 27 27 27 27 27 27 27 27 27 27 27 27 27 27 27 27 27 27 27 27 27 27 27 27 27 27 27 27 27 27 27 27 27 27 27 27 27 27 27 27 1 27 27 1 27 27 27
