17 17 17 17 17 17 17 17 17 17 17 17 17 17 17 17 17 17 17 15 15 15 15 15 15 15 15 15 15 15 15 15 15 15 15 15 15 15 15 15 15 15 15 15 15 15 15 15 15 15 15 15 15 15 15 15 15 15 15 15 15 15 15 15
17 17 17 17 17 17 17 17 17 17 17 17 17 17 17 17 17 17 17 15 15 15 113 106 15 113 113 113 113 113 113 113 113 15 15 113 113 113 15 15 15 15 15 15 15 15 15 113 113 113 113 106 113 106 15 106 113 113 113 15 15 15 15 15
17 17 17 17 17 17 17 17 17 17 17 17 17 17 17 17 17 17 17 15 15 15 113 15 15 113 15 15 15 113 15 15 113 15 15 113 15 113 15 113 113 113 113 113 113 113 15 113 15 113 15 15 15 15 15 15 15 15 113 15 15 15 15 15
17 17 17 17 17 17 17 17 17 17 17 17 17 17 17 17 17 17 17 15 15 15 113 15 15 113 15 106 15 113 15 15 113 113 113 113 15 113 15 113 15 15 15 15 15 113 15 113 15 113 113 113 113 113 113 113 113 15 113 15 15 15 15 15
17 17 17 17 17 17 17 17 17 17 17 17 17 17 17 17 17 17 17 15 15 15 113 113 113 113 15 113 15 113 15 15 15 15 15 113 15 113 113 113 15 113 113 113 15 113 15 113 15 15 15 15 113 15 15 15 113 15 113 15 15 15 15 15
17 17 17 17 17 17 17 17 17 17 17 17 17 17 17 17 17 17 17 15 15 15 15 15 15 113 15 113 15 113 113 113 106 15 15 113 15 15 15 113 15 113 15 113 15 113 15 113 15 15 15 15 113 113 113 15 113 15 113 15 15 15 15 15
17 17 17 17 17 17 17 17 17 17 17 17 17 17 17 17 17 17 17 15 15 15 15 15 15 113 15 113 15 15 15 15 15 15 15 113 15 15 15 113 15 113 15 113 113 113 15 113 15 113 15 15 15 15 113 15 113 15 113 15 15 15 15 15
17 17 17 17 17 17 17 17 17 17 17 17 17 17 17 17 17 17 17 15 15 15 15 113 113 113 15 113 113 113 113 113 113 113 113 113 15 15 15 15 15 113 15 113 15 15 15 15 15 113 15 15 15 15 113 15 113 113 113 15 15 15 15 15
17 17 17 17 17 17 17 17 17 17 17 17 17 17 17 17 17 17 17 15 15 15 15 113 15 113 15 15 15 15 15 15 15 113 15 15 15 15 113 113 113 113 15 113 15 15 113 113 113 113 113 113 113 15 113 15 15 15 15 15 15 15 15 15
17 17 17 17 17 17 17 17 17 17 17 17 17 17 17 17 17 17 17 15 15 15 15 113 15 113 113 106 15 106 113 113 15 113 113 113 113 15 113 15 15 15 15 113 15 15 113 15 15 15 15 15 113 15 113 113 113 113 113 113 113 15 15 15
17 17 17 17 17 17 17 17 17 17 17 17 17 17 17 17 17 17 17 15 15 15 15 113 15 15 15 15 15 15 15 113 15 15 15 15 15 15 113 113 113 106 15 113 113 113 113 15 15 106 15 15 113 15 15 15 15 113 15 15 113 15 15 15
17 17 17 17 17 17 17 17 17 17 17 17 17 17 17 17 17 17 17 15 15 15 15 113 113 113 113 113 113 113 15 113 113 113 113 113 113 113 113 15 15 15 15 15 15 15 113 15 15 113 15 15 113 113 113 113 113 113 15 113 113 113 15 15
17 17 17 17 17 17 17 17 17 17 17 17 17 17 17 17 17 17 17 15 15 15 15 15 15 15 113 15 15 15 15 15 15 113 15 15 15 15 113 113 113 15 113 113 113 113 113 15 15 113 113 113 113 15 15 15 15 15 14 113 113 113 14 15
17 17 17 17 17 17 17 17 17 17 17 17 17 17 17 17 17 17 17 15 113 113 113 113 15 15 113 15 106 113 113 113 15 113 15 15 106 15 113 15 15 15 15 15 15 15 15 15 15 15 15 15 15 15 15 15 15 15 15 14 91 14 15 15
17 17 17 17 17 17 17 17 17 17 17 17 17 17 17 17 17 17 17 15 113 15 15 113 113 113 113 15 15 15 15 113 15 113 113 113 113 15 113 15 8 9 9 9 9 9 8 9 8 8 8 9 8 8 8 17 17 17 17 112 112 112 17 17
17 17 17 17 17 17 17 17 17 17 17 17 17 17 17 17 17 17 17 15 113 15 15 15 15 15 113 113 113 106 15 113 15 15 15 15 15 15 113 15 8 109 109 109 109 109 109 109 109 109 109 109 109 109 8 17 112 112 112 112 112 112 17 17
17 17 17 17 17 17 17 17 17 17 17 17 17 17 17 17 17 17 17 15 113 15 15 15 15 15 15 15 15 15 15 113 113 113 113 113 113 113 113 15 9 109 109 109 109 109 109 109 109 109 109 109 109 109 8 17 112 112 112 112 112 112 17 17
17 17 17 17 17 17 17 17 17 17 17 17 17 17 17 17 17 17 17 15 113 15 15 106 116 116 116 116 116 116 15 15 15 15 15 15 15 15 15 15 9 109 109 17 17 109 17 109 17 109 17 109 17 17 17 17 112 112 112 112 112 112 17 17
17 17 17 17 17 17 17 17 17 17 17 17 17 17 17 17 17 17 17 15 113 15 15 15 116 116 116 116 116 15 15 17 17 17 17 17 17 17 17 17 9 109 109 17 109 109 109 109 109 109 109 109 20 112 112 112 112 112 112 17 17 17 17 17
17 17 17 17 17 17 17 17 17 17 17 17 17 17 17 17 17 17 17 15 113 113 113 90 116 116 116 116 116 116 15 17 17 17 17 17 17 17 17 17 9 109 109 109 109 109 109 109 109 109 109 109 90 112 112 112 112 112 112 17 17 17 17 17
17 17 17 17 17 17 17 17 17 17 17 17 17 17 17 17 17 17 17 15 15 15 15 15 116 116 116 116 116 15 15 17 17 17 17 17 17 17 17 17 8 109 109 17 109 109 109 109 109 109 109 109 20 112 112 112 112 112 112 17 17 17 17 17
17 17 17 17 17 17 17 17 17 17 17 17 17 17 17 17 17 17 17 15 15 15 15 106 116 116 116 116 116 116 15 17 17 17 17 17 17 17 17 17 9 109 109 109 109 109 109 17 17 17 17 17 17 17 17 17 17 17 17 17 17 17 17 17
17 17 17 17 17 17 17 17 17 17 17 17 17 17 17 17 17 17 17 15 15 15 15 15 15 15 15 15 15 15 15 17 17 17 17 17 17 17 17 17 9 109 109 17 109 109 109 17 108 108 108 90 110 110 110 110 17 17 17 17 111 17 17 17
17 17 17 17 17 17 17 17 17 17 17 17 17 17 17 17 17 17 17 15 15 15 15 15 15 15 15 15 15 15 15 17 17 17 17 17 17 17 17 17 8 109 109 109 109 109 109 17 108 108 108 11 17 110 110 110 17 17 17 111 111 111 17 17
17 17 17 17 17 17 17 17 17 17 17 17 17 17 17 17 17 17 17 17 17 17 17 17 17 17 17 17 17 17 17 17 17 17 17 17 17 17 17 17 8 109 109 17 109 109 109 90 108 108 108 13 17 110 110 110 17 17 111 111 111 111 111 17
17 17 17 17 17 17 17 17 17 17 17 17 17 17 17 17 17 17 17 17 17 17 17 17 17 17 17 17 17 17 17 17 17 17 17 17 17 17 17 17 8 109 109 109 109 109 109 17 108 108 108 11 17 17 17 17 17 17 111 111 111 111 111 17
17 17 17 17 17 17 17 17 17 17 17 17 17 17 17 17 17 17 17 17 17 17 17 17 17 17 17 17 17 17 17 17 17 17 17 17 17 17 17 17 9 109 109 17 109 109 109 17 108 108 108 92 111 111 111 111 111 111 111 111 111 111 111 17
17 17 17 17 17 17 17 17 17 17 17 17 17 17 17 17 17 17 17 17 17 17 17 17 17 17 17 17 17 17 17 17 17 17 17 17 17 17 17 17 8 109 109 109 109 109 109 17 17 17 17 17 17 17 17 20 17 17 111 111 111 111 111 17
17 17 17 17 17 17 17 17 17 17 17 17 17 17 17 17 17 17 17 17 17 17 17 17 17 17 17 17 17 17 17 17 17 17 17 17 17 17 17 17 9 109 109 17 109 109 109 109 109 109 109 109 20 17 113 113 113 17 111 111 111 111 111 17
17 17 17 17 17 17 17 17 17 17 17 17 17 17 17 17 17 17 17 17 17 17 17 17 17 17 17 17 17 17 17 17 17 17 17 17 17 17 17 17 8 109 109 109 109 109 109 109 109 109 109 109 90 113 113 113 113 20 111 111 111 111 111 17
17 17 17 17 17 17 17 17 17 17 17 17 17 17 17 17 17 17 17 17 17 17 17 17 17 17 17 17 17 17 17 17 17 17 17 17 17 17 17 17 8 109 109 17 109 109 109 109 109 109 109 109 20 17 113 113 113 17 111 111 111 111 111 17
17 17 17 17 17 17 17 17 17 17 17 17 17 17 17 17 17 17 17 17 17 17 17 17 17 17 17 17 17 17 17 17 17 17 17 17 17 17 119 119 90 109 109 17 17 109 17 109 17 109 17 109 17 17 17 91 17 17 111 111 111 111 111 17
17 17 17 17 17 17 17 17 17 17 17 17 17 17 17 17 17 17 17 17 17 17 17 17 17 17 17 17 17 17 17 17 17 17 17 17 17 17 119 119 9 109 109 109 109 109 109 109 109 109 109 109 109 9 17 115 17 17 17 17 18 17 17 17
17 17 17 17 17 17 17 17 17 17 17 17 17 17 17 17 17 17 17 17 17 17 17 17 17 17 17 17 17 17 17 17 17 17 17 17 17 17 119 119 8 109 109 109 109 109 109 109 109 109 109 109 109 8 17 115 17 17 17 117 117 117 17 17
17 17 17 17 17 17 17 17 17 17 17 17 17 17 17 17 17 17 17 17 17 17 17 17 17 17 17 17 17 17 17 17 17 17 17 17 17 17 119 17 9 8 8 8 8 9 9 8 8 9 9 9 8 8 17 115 17 17 106 117 117 117 106 17
17 17 17 17 17 17 17 17 17 17 17 17 17 17 17 17 17 17 17 17 17 17 17 17 17 17 17 17 17 17 17 17 17 17 17 17 17 17 119 17 17 17 17 17 17 17 17 17 17 17 17 17 17 17 17 115 17 17 17 117 117 117 17 17
17 17 17 17 17 17 17 17 17 17 17 17 17 17 17 17 17 17 17 17 17 17 17 17 17 17 17 17 17 17 17 17 17 17 17 17 17 17 119 17 17 17 17 17 17 17 17 17 17 17 17 17 17 17 17 115 17 17 17 17 117 17 17 17
17 17 17 17 17 17 17 17 17 17 17 17 17 17 17 17 17 17 17 17 17 17 17 17 17 17 17 17 17 17 17 17 17 17 17 17 17 17 119 17 17 17 119 119 17 119 119 119 119 119 17 17 17 17 115 115 115 17 17 117 117 117 17 17
17 17 17 17 17 17 17 17 17 17 17 17 17 17 17 17 17 17 17 17 17 17 17 17 17 17 17 17 17 17 17 17 17 17 17 17 17 17 119 119 119 119 119 119 17 119 119 119 119 119 119 17 17 115 115 115 115 115 17 117 117 117 17 17
17 17 17 17 17 17 17 17 17 17 17 17 17 17 17 17 17 17 17 17 17 17 17 17 17 17 17 17 17 17 17 17 17 17 17 17 17 17 17 17 17 17 17 17 17 17 17 17 119 119 119 119 90 115 115 115 115 115 90 117 117 117 20 17
17 17 17 17 17 17 17 17 17 17 17 17 17 17 17 17 17 17 17 17 17 17 17 17 17 17 17 17 17 17 17 17 17 17 17 17 17 17 17 17 17 17 17 17 17 119 119 119 119 119 119 17 17 115 115 115 115 115 17 117 117 117 17 17
17 17 17 17 17 17 17 17 17 17 17 17 17 17 17 17 17 17 17 17 17 17 17 17 17 17 17 17 17 17 17 17 17 17 17 17 17 17 17 17 17 17 17 17 17 119 119 119 119 119 17 17 17 17 115 115 115 17 17 117 117 117 17 17
17 17 17 17 17 17 17 17 17 17 17 17 17 17 17 17 17 17 17 17 17 17 17 17 17 17 17 17 17 17 17 17 17 17 17 17 120 120 120 120 120 17 17 17 17 17 17 17 17 17 17 17 17 17 17 91 17 17 17 17 117 17 17 17
17 17 17 17 17 17 17 17 17 17 12 12 12 12 12 12 12 12 12 12 12 12 17 17 17 17 17 17 17 17 17 17 17 17 17 17 120 120 120 120 120 90 127 127 127 127 127 17 17 17 17 17 17 17 17 118 17 17 17 117 117 117 17 17
17 17 17 17 17 17 17 17 17 17 12 125 125 125 125 125 125 125 125 125 125 12 17 17 17 17 17 17 17 17 17 17 17 17 17 17 120 120 120 120 120 17 127 127 127 127 127 17 17 17 17 17 17 17 118 118 118 17 106 117 117 117 106 17
17 17 17 17 17 17 17 17 17 17 12 125 125 125 125 125 125 125 125 125 125 12 17 17 17 17 17 17 17 17 17 17 17 17 17 17 120 120 120 120 120 90 127 106 127 106 127 17 17 17 17 17 17 20 118 17 118 20 17 117 117 117 17 17
17 17 17 17 17 17 17 17 17 17 12 12 125 125 125 125 125 125 125 125 12 12 12 12 12 12 17 17 17 17 17 118 106 118 118 18 120 120 120 120 120 17 17 17 17 17 17 17 17 17 17 17 17 17 118 118 118 17 17 17 18 17 17 17
17 17 17 17 17 17 17 17 17 17 21 11 125 125 125 125 125 125 125 125 10 124 124 124 124 12 17 17 17 17 17 118 118 118 118 90 120 120 120 120 120 17 17 17 17 17 17 17 17 17 17 17 17 17 17 118 17 17 17 17 117 117 117 17
17 17 17 17 17 17 17 17 17 21 125 100 125 125 125 125 125 125 125 125 90 124 106 124 124 12 17 17 17 17 17 118 118 118 118 18 120 120 120 120 120 17 17 17 118 118 118 118 118 118 118 17 17 17 17 118 17 17 17 17 117 117 117 17
17 17 17 17 17 17 17 17 17 17 21 11 125 125 125 125 125 125 125 125 10 124 124 124 124 12 17 17 17 17 17 118 118 17 17 17 17 17 17 17 17 17 17 17 118 118 118 118 118 118 118 17 17 17 17 118 17 17 17 17 17 117 117 17
17 17 17 17 17 17 17 17 17 17 12 12 125 125 125 125 125 125 125 125 12 12 124 124 106 12 17 17 17 17 17 118 118 17 17 17 118 118 118 118 118 17 17 17 118 106 12 10 12 118 118 17 17 17 118 118 118 17 17 17 17 117 117 17
17 17 17 17 17 17 17 12 12 12 12 125 125 125 125 125 125 125 125 125 125 12 124 124 124 12 17 17 17 17 17 118 118 118 118 118 118 118 118 106 118 118 90 118 118 118 11 12 11 118 118 118 118 118 118 17 118 18 17 17 17 117 117 17
17 17 17 17 17 17 17 12 125 125 12 125 125 125 125 125 125 125 125 125 125 12 106 124 124 12 17 17 17 17 17 118 118 17 17 17 118 118 118 118 118 17 17 17 118 106 12 10 12 118 118 17 17 17 118 118 118 17 17 17 17 2 91 2
17 17 17 17 17 17 17 12 125 125 125 12 12 12 12 12 12 12 12 12 12 12 124 124 124 12 17 17 17 17 17 118 118 17 17 17 17 17 17 17 17 17 17 17 118 118 118 118 118 118 118 17 17 17 17 18 17 17 17 17 17 2 126 2
17 17 17 17 17 17 17 12 125 125 125 12 17 17 17 17 17 17 17 17 17 12 124 124 124 12 17 17 17 17 17 118 118 118 118 18 17 17 17 121 121 121 17 17 118 118 118 118 118 118 118 17 17 17 17 17 17 17 17 17 17 1 126 1
17 17 17 17 17 17 17 12 125 125 125 12 17 17 17 17 17 17 17 17 17 12 124 124 124 12 17 17 17 17 17 118 118 118 118 90 121 121 121 121 121 121 20 17 17 17 17 17 17 17 17 17 17 17 17 17 17 17 17 17 17 2 126 2
17 17 17 17 17 17 17 12 12 12 12 12 17 17 17 17 17 17 17 17 17 12 12 91 12 12 17 17 17 17 17 118 118 118 118 18 17 17 17 121 121 121 17 17 17 17 17 17 17 17 17 17 17 17 17 17 17 17 17 17 17 1 126 2
17 17 17 17 17 17 17 17 17 17 17 17 17 17 17 17 17 17 17 17 17 12 122 122 122 12 17 17 17 17 17 17 17 17 17 17 17 17 17 17 121 17 17 17 17 17 1 1 1 1 1 1 1 1 1 1 1 1 1 1 2 2 126 1
17 17 17 17 17 17 17 17 17 17 17 17 17 17 17 17 17 17 17 17 17 12 122 122 106 12 17 17 17 17 17 17 17 17 17 17 17 17 121 121 121 121 121 17 17 17 1 1 106 1 1 106 1 1 106 1 1 106 1 1 2 126 126 2
17 17 17 17 17 17 17 17 17 17 17 17 17 17 17 17 17 17 17 17 17 12 122 122 122 12 12 12 12 12 12 12 12 12 12 12 12 12 17 17 121 17 17 1 2 2 2 1 123 2 2 123 1 2 123 2 1 123 1 1 126 126 126 2
17 17 17 17 17 17 17 17 17 17 17 17 17 17 17 17 17 17 17 17 17 12 122 122 122 122 122 122 122 122 122 122 122 122 122 122 122 12 23 121 121 121 6 1 123 123 123 123 123 123 123 123 123 123 123 123 123 123 90 126 1 2 1 2
17 17 17 17 17 17 17 17 17 17 17 17 17 17 17 17 17 17 17 17 17 12 122 122 122 122 122 122 122 122 122 122 122 122 122 122 122 122 94 121 121 121 90 123 123 123 123 123 123 123 123 123 123 123 123 123 123 123 1 1 126 1 1 1
17 17 17 17 17 17 17 17 17 17 17 17 17 17 17 17 17 17 17 17 17 12 122 122 122 122 122 122 122 122 122 122 122 122 122 122 122 12 23 121 121 121 6 1 123 123 123 123 123 123 123 123 123 123 123 123 123 123 123 2 126 2 1 1
17 17 17 17 17 17 17 17 17 17 17 17 17 17 17 17 17 17 17 17 17 12 12 12 12 12 12 12 12 12 12 12 12 12 12 12 12 12 12 17 17 17 2 1 1 2 1 2 2 2 2 2 1 1 2 2 1 1 1 2 1 1 1 1
