12 12 12 12 12 12 12 12 12 12 12 12 12 12 12 12 12 12 12 12 12 12 12 12 12 12 12 12 12 12 12 12 12 12 12 12 12 12 12 12 12 12 12 12 12 12 12 12 12 12 12 12 12 12 12 12 12 12 12 12 12 12 12 12
12 133 133 133 133 133 12 12 12 133 133 133 133 133 133 133 133 133 133 133 133 133 133 133 133 133 133 133 133 12 12 12 12 12 12 12 12 12 12 12 12 12 12 12 12 12 12 12 12 12 12 12 12 12 12 12 12 12 12 12 12 12 12 12
12 133 12 12 12 133 12 12 12 133 12 12 12 12 12 12 12 12 12 12 12 12 133 12 133 12 12 12 12 12 133 133 133 133 133 133 133 133 133 12 12 12 12 12 12 12 12 12 12 133 133 12 12 12 12 12 12 12 12 12 12 12 12 12
12 133 12 12 12 133 133 133 12 133 133 133 133 133 133 133 133 133 133 133 12 133 133 133 133 133 133 133 12 12 133 12 12 12 12 12 12 12 133 12 133 133 133 133 133 133 133 133 133 133 12 12 133 133 133 133 133 133 133 133 133 12 12 12
12 133 12 133 12 133 12 133 12 133 12 12 133 12 12 12 12 12 12 133 12 12 12 12 12 133 12 133 12 12 133 133 133 133 133 133 133 12 12 12 133 12 12 12 12 12 12 12 12 133 12 12 133 12 12 12 12 12 12 12 133 12 12 12
12 133 12 133 12 133 12 133 12 12 12 12 133 133 133 133 12 12 12 133 133 133 12 12 12 133 12 133 12 12 133 12 12 12 12 12 133 133 12 12 133 12 12 12 133 133 133 133 133 133 12 12 133 12 12 12 133 133 133 133 133 12 12 12
12 133 133 133 12 133 12 133 133 133 133 133 133 12 12 133 12 12 12 12 133 133 133 133 133 133 12 133 133 133 133 133 133 133 133 12 12 133 133 12 133 12 12 12 133 12 12 12 12 12 12 12 133 12 12 12 12 12 12 12 12 12 12 12
12 12 12 12 12 133 12 12 12 12 12 12 12 12 12 12 12 12 12 12 12 12 12 12 12 12 12 12 12 12 133 12 12 12 133 12 12 12 133 133 133 133 12 12 133 12 12 12 12 12 12 12 133 133 133 133 133 133 133 133 133 12 12 12
12 12 133 133 133 133 12 12 133 133 133 133 133 12 12 12 12 133 133 133 133 133 133 12 12 12 12 12 12 12 133 12 133 12 133 12 133 12 133 12 12 12 12 12 133 133 133 133 133 133 133 12 12 12 12 12 12 12 12 12 133 12 12 12
12 12 133 12 12 12 12 133 133 12 12 12 133 133 12 12 12 133 12 12 12 12 133 12 12 133 133 133 133 133 133 12 133 12 133 12 133 12 133 12 133 12 12 12 12 12 12 12 12 12 133 133 133 133 133 133 133 133 133 12 133 12 12 12
12 12 133 133 133 133 133 133 12 12 12 12 133 133 12 12 12 133 12 12 12 133 133 12 12 133 12 12 12 12 12 12 133 12 133 12 133 12 12 12 133 12 12 133 133 133 12 12 12 12 12 12 12 12 12 12 12 12 133 12 133 12 12 12
12 12 133 12 12 12 12 12 12 12 133 133 133 12 12 12 12 133 12 133 133 133 12 12 12 133 12 133 133 133 133 12 133 133 133 12 133 133 12 12 133 12 12 133 12 12 12 133 133 133 133 133 133 133 133 133 12 12 133 12 133 12 12 12
12 12 133 12 12 133 12 12 12 12 12 12 12 12 12 12 12 133 12 133 133 133 12 12 12 12 12 12 12 12 133 12 12 12 12 12 12 133 12 12 133 133 133 133 133 12 12 133 12 12 12 12 12 12 12 133 12 12 133 12 133 12 12 12
12 12 133 133 133 133 133 133 12 133 133 133 133 133 12 12 12 133 12 133 12 12 12 12 12 12 133 133 133 133 133 12 12 12 12 12 12 133 12 12 12 133 12 12 133 12 12 133 12 12 12 12 12 12 12 133 12 12 133 133 133 133 133 12
12 12 12 12 12 133 12 12 12 133 12 12 12 133 12 12 133 133 12 133 12 12 12 12 12 12 133 133 12 12 133 133 133 133 133 133 133 133 133 133 133 133 12 12 133 12 12 133 12 133 133 133 12 12 12 133 12 12 12 12 12 12 133 12
12 12 12 133 12 133 12 133 133 133 12 133 133 133 133 133 133 12 12 133 133 133 133 133 133 133 133 133 12 12 12 12 12 12 12 12 12 12 12 12 12 12 12 12 133 12 12 12 12 133 12 133 12 12 12 133 133 133 133 133 12 12 133 12
12 12 12 133 133 133 12 133 12 12 12 133 12 12 12 12 12 12 12 12 12 12 12 12 12 12 12 12 12 12 12 12 12 12 133 133 133 133 133 133 133 12 12 12 133 12 12 12 12 133 12 133 12 12 12 12 12 12 12 133 12 12 133 12
12 12 12 12 12 12 12 133 12 12 133 133 12 12 12 12 12 12 12 132 132 12 133 133 133 133 133 133 133 12 12 12 12 133 133 133 133 133 133 133 133 133 12 12 133 133 133 133 133 133 12 133 12 12 12 12 12 12 12 133 133 133 133 12
12 12 12 12 12 12 12 133 12 12 133 133 12 133 133 133 12 12 12 132 132 90 133 133 133 133 133 133 133 133 12 12 12 133 133 12 12 23 12 12 133 133 12 12 12 12 12 12 12 12 12 133 133 133 133 133 133 12 12 12 133 12 12 12
12 133 133 133 133 133 133 133 12 12 12 133 133 133 12 133 133 12 12 132 132 12 133 133 12 12 12 12 133 133 12 12 12 133 133 12 12 133 133 12 133 133 12 12 12 12 12 12 12 12 12 12 12 12 12 12 133 12 12 12 133 12 12 12
12 133 12 12 12 12 12 12 12 12 12 12 12 12 12 12 133 12 12 132 132 12 133 133 12 12 12 133 133 133 12 12 12 133 133 11 133 133 133 11 133 133 12 12 12 12 12 12 12 133 133 133 133 133 133 12 133 12 12 12 133 12 12 12
12 133 12 12 12 12 12 12 12 12 12 133 133 133 133 133 133 12 12 132 132 90 133 133 133 133 133 133 133 133 12 12 12 133 133 12 133 133 133 12 133 133 12 12 12 12 12 12 12 133 133 133 133 133 133 12 133 12 12 133 133 133 12 12
12 133 12 133 12 12 12 21 12 12 12 133 12 12 12 12 12 12 12 132 132 12 133 133 133 133 133 133 133 12 12 12 12 133 133 12 12 23 12 12 133 133 12 12 12 12 12 12 12 133 133 133 133 133 133 12 133 12 133 133 133 133 133 12
12 133 12 133 133 133 100 107 21 12 12 12 12 12 132 132 132 132 132 132 132 12 133 133 12 133 133 133 12 133 133 12 12 133 133 133 133 133 133 133 133 133 12 12 12 12 12 12 12 133 133 133 133 133 133 12 133 12 12 12 12 12 133 12
12 133 133 12 12 12 12 21 12 12 11 12 12 12 132 132 132 132 132 132 132 12 133 133 12 12 133 133 133 12 133 133 133 133 133 133 133 133 133 133 133 12 12 12 12 106 106 12 12 12 12 12 133 133 133 12 133 133 133 133 133 12 133 12
12 133 133 133 12 12 12 12 12 122 122 122 12 12 12 12 132 132 132 132 12 12 133 133 12 12 12 133 133 133 12 12 12 12 12 12 133 133 133 12 12 12 12 12 12 133 133 133 12 133 133 12 133 133 133 12 12 12 12 12 133 12 133 12
12 12 133 133 12 12 131 131 90 122 122 122 90 132 132 12 12 12 12 12 12 12 12 12 12 12 12 12 12 12 23 12 12 12 12 12 133 133 133 12 12 12 12 12 133 133 133 133 12 133 133 133 133 133 133 133 133 133 133 12 133 12 133 12
12 12 133 133 133 12 12 12 12 122 122 122 12 12 12 12 12 12 12 12 12 12 12 12 12 12 12 12 12 109 109 109 12 12 12 12 133 133 133 133 133 133 133 133 133 133 133 133 12 133 133 133 133 133 133 12 12 12 133 12 133 12 133 12
12 12 12 133 133 12 12 12 12 122 122 122 12 12 12 12 12 12 12 12 12 12 12 12 12 12 12 12 109 109 109 109 109 12 12 12 133 133 133 133 133 133 133 133 133 133 133 133 94 133 133 133 133 133 133 12 12 12 133 12 133 12 133 12
12 12 133 133 133 12 129 129 90 122 122 122 90 130 130 12 12 12 12 12 12 12 12 12 12 12 12 109 109 109 109 109 109 109 12 12 133 133 133 133 133 133 133 133 133 133 133 133 12 133 133 133 133 133 133 12 12 12 133 12 133 12 133 12
12 12 133 133 12 12 12 12 12 122 122 122 12 12 12 12 12 12 12 12 12 12 12 12 12 12 109 109 109 109 109 109 109 109 109 12 12 12 12 12 12 12 12 12 133 133 133 133 12 12 12 12 12 12 12 12 12 12 133 12 133 12 133 12
12 133 133 12 12 12 12 12 12 122 122 122 12 12 12 12 12 12 12 12 12 12 12 12 12 109 109 109 109 109 12 109 109 109 109 109 12 12 12 12 12 12 12 12 12 133 133 133 12 12 12 12 12 12 12 133 133 133 133 12 133 133 133 12
12 133 133 133 12 12 127 127 90 122 122 122 90 128 128 12 12 12 12 12 12 12 12 12 109 109 109 109 109 12 12 12 109 109 109 109 109 12 12 12 12 12 12 12 12 106 106 12 12 133 133 133 12 12 12 133 12 12 133 12 12 12 133 12
12 133 133 133 133 12 12 12 12 122 122 122 12 12 12 12 12 12 12 12 12 12 12 109 109 109 109 109 12 12 110 12 12 109 109 109 109 109 12 12 12 12 133 12 12 12 12 12 12 12 12 133 12 12 12 133 12 12 133 12 133 133 133 12
12 133 133 133 133 12 12 12 12 122 122 122 12 12 12 12 12 12 12 12 12 12 109 109 109 109 109 12 12 110 110 110 12 12 109 109 109 109 109 12 12 12 133 133 133 133 133 133 12 12 12 133 12 12 12 133 12 12 12 12 133 12 12 12
12 133 133 133 133 12 125 125 90 122 122 122 90 126 126 12 12 12 12 12 12 109 109 109 109 109 12 12 12 12 91 12 12 12 12 109 109 109 109 109 12 12 12 12 133 12 12 133 12 12 133 133 12 133 133 133 133 133 133 12 133 12 12 12
12 133 133 133 133 12 12 12 12 122 122 122 12 12 12 12 12 12 12 12 109 109 109 109 109 12 12 12 12 12 109 12 12 12 12 12 109 109 109 109 109 12 12 12 133 12 12 133 12 12 133 133 133 133 133 12 12 12 12 12 133 12 12 12
12 12 12 12 12 12 12 12 12 122 122 122 12 12 12 12 12 12 12 23 109 109 109 109 12 12 12 12 12 106 109 12 12 12 111 12 12 109 109 109 109 109 12 12 133 12 12 133 12 12 12 12 133 12 133 12 12 12 12 12 133 12 12 12
12 12 12 12 12 12 123 123 90 122 122 122 90 124 124 12 12 12 12 12 109 109 109 109 109 12 12 12 109 109 109 109 109 90 111 111 12 12 109 109 109 109 23 12 133 12 12 133 12 12 12 12 133 12 133 12 133 133 133 133 133 12 12 12
12 12 12 12 12 12 12 12 12 122 122 122 12 12 12 12 12 12 12 12 12 109 109 109 109 109 12 109 109 109 109 106 12 12 111 12 12 109 109 109 109 109 12 12 133 12 12 133 12 12 133 133 133 12 12 12 12 133 12 133 12 12 12 12
12 12 12 12 12 12 12 12 12 12 91 12 12 12 12 12 12 12 12 12 12 12 109 109 109 109 109 109 109 109 109 12 12 12 12 12 109 109 109 109 109 12 12 12 133 12 12 133 133 133 133 133 133 12 133 12 12 133 12 133 133 133 133 12
12 12 12 12 12 12 12 12 12 121 121 121 12 12 12 12 12 12 12 12 12 12 12 109 109 109 109 109 109 109 12 12 12 12 12 109 109 109 109 109 12 12 12 12 133 12 12 133 12 12 133 12 12 12 133 133 133 133 12 12 12 12 133 12
12 12 12 12 12 12 12 12 10 106 121 106 10 12 12 12 12 12 12 12 12 12 12 12 109 109 109 109 109 12 12 12 12 12 109 109 109 109 109 12 12 12 12 12 133 12 12 133 12 12 133 12 12 12 12 12 12 133 12 12 12 12 12 12
12 12 12 12 12 12 12 12 12 121 121 121 12 12 12 12 12 12 12 12 12 12 12 12 12 109 109 109 12 12 12 12 12 109 109 109 109 109 12 12 12 12 12 12 133 12 12 133 12 12 133 133 133 133 12 12 12 133 133 133 133 133 12 12
12 12 12 12 12 12 12 12 12 12 121 12 12 12 12 12 12 12 12 12 12 12 12 12 12 12 23 12 12 12 12 12 109 109 109 109 109 12 12 12 12 133 133 133 133 12 12 12 12 12 12 12 12 12 12 12 133 133 12 12 12 133 12 12
12 12 12 12 12 12 12 12 12 12 121 12 12 12 12 12 12 12 12 12 12 12 12 12 12 12 10 12 12 12 12 109 109 109 109 109 12 12 12 12 12 133 12 12 12 12 133 133 133 133 133 133 12 12 133 12 12 12 12 12 12 133 12 12
12 12 12 12 12 12 12 12 12 12 121 12 12 12 12 12 12 12 12 12 12 12 12 23 113 113 113 113 113 12 109 109 109 109 109 12 12 12 12 12 12 133 12 12 12 12 133 12 12 12 12 12 12 12 133 133 133 133 133 133 12 133 12 12
12 12 12 12 12 12 12 12 12 12 121 121 121 121 121 121 121 121 121 121 121 121 121 90 113 113 113 113 113 90 109 109 109 109 12 12 12 12 12 12 12 133 133 133 133 133 133 12 12 12 12 12 133 133 133 12 12 12 12 133 12 133 12 12
12 12 12 12 12 11 12 12 12 12 12 12 12 12 12 12 12 12 12 12 12 12 12 23 113 113 113 113 113 12 109 109 109 12 12 12 12 12 133 133 133 133 12 12 12 12 133 133 133 133 12 12 133 12 12 12 12 12 12 133 12 133 12 12
12 117 117 117 117 117 117 117 117 117 12 116 116 116 12 12 12 116 116 116 12 12 12 12 12 12 91 12 12 12 12 91 12 12 12 12 12 12 133 12 12 12 12 133 12 12 133 12 12 133 12 133 133 12 133 133 12 12 12 133 12 133 12 12
12 117 117 117 117 117 117 117 117 117 90 116 116 116 90 118 23 116 116 116 12 114 114 114 12 114 114 114 12 12 108 108 108 12 12 12 12 12 133 12 12 12 12 133 12 12 133 12 12 133 12 12 12 12 12 133 12 12 12 133 12 133 12 12
12 117 117 117 117 117 117 117 117 117 12 116 116 116 12 12 12 116 116 116 90 114 114 114 114 114 114 114 12 108 108 108 108 108 12 108 108 12 133 12 133 12 12 133 133 133 133 12 12 133 133 133 12 12 12 133 12 12 12 133 12 133 12 12
12 117 12 12 117 117 117 12 12 117 12 116 116 116 116 116 116 116 116 116 12 114 114 114 12 114 114 114 12 108 108 108 108 108 12 108 108 12 133 12 133 12 12 12 12 12 12 12 12 133 12 133 12 12 12 133 12 12 12 133 12 133 12 12
12 10 12 12 117 117 117 12 12 10 12 116 116 116 116 116 116 116 116 116 12 114 114 114 23 114 114 114 23 108 108 108 108 108 23 108 108 12 133 133 133 12 12 133 133 133 133 133 133 133 12 133 12 12 12 133 12 12 12 133 12 133 12 12
12 12 12 23 117 117 117 23 12 12 12 116 116 116 116 116 116 116 116 116 12 114 114 114 12 114 114 114 12 108 108 108 108 108 12 12 12 12 12 133 12 12 12 12 12 133 12 12 12 12 12 133 12 133 133 133 133 12 12 133 12 133 12 12
12 12 12 12 117 117 117 12 12 12 12 116 116 116 12 12 12 116 116 116 90 114 114 114 114 114 114 114 12 108 108 108 108 108 12 12 12 133 133 133 12 12 133 12 12 133 12 12 12 12 12 133 12 133 12 12 133 12 12 133 12 133 12 12
12 12 12 12 117 117 117 12 12 12 12 116 116 116 90 119 23 116 116 116 12 114 114 114 12 114 114 114 12 12 108 108 108 12 12 12 12 12 133 12 12 12 133 12 12 133 133 133 133 12 12 133 12 133 12 12 133 12 12 133 133 133 12 12
12 12 117 117 117 117 117 117 117 12 12 116 116 116 12 12 12 116 116 116 12 12 91 12 10 12 91 12 12 12 12 13 12 12 133 133 12 12 133 133 133 133 133 12 12 12 12 12 12 12 12 133 12 133 12 12 12 12 12 133 12 133 12 12
12 12 12 12 93 11 93 12 12 12 12 12 12 12 12 12 12 12 12 12 12 115 115 115 115 115 115 115 12 12 12 12 12 12 12 133 12 12 12 12 12 12 12 12 12 12 12 12 12 12 12 133 12 133 133 133 133 133 133 133 12 133 133 12
12 12 12 138 138 138 138 138 138 138 23 21 12 12 12 12 12 12 12 12 12 115 115 115 115 115 115 115 12 133 133 133 12 133 133 133 12 133 133 133 133 12 12 133 133 133 133 133 133 133 133 133 12 12 12 133 12 12 12 133 12 12 12 12
12 12 12 138 138 138 138 138 138 138 100 139 21 12 12 12 12 12 12 12 12 115 115 115 115 115 115 115 12 133 12 133 12 133 12 133 133 133 12 12 133 12 12 12 12 12 133 12 12 12 133 12 12 12 12 133 12 133 12 133 133 133 12 12
12 12 12 138 138 138 138 138 138 138 23 21 12 12 12 12 12 12 12 12 12 12 115 12 115 12 115 12 12 133 12 133 133 133 12 12 12 133 133 12 133 133 133 133 133 133 133 12 12 12 133 12 12 12 133 133 12 133 12 12 12 133 12 12
12 12 12 12 12 12 12 12 12 12 12 12 12 12 12 12 12 12 12 12 12 12 115 12 115 12 115 12 12 133 12 12 12 133 133 133 12 133 133 12 12 12 12 12 12 12 12 12 12 12 133 133 133 133 133 12 12 133 133 133 133 133 12 12
12 12 12 12 12 12 12 12 12 12 12 12 12 12 12 12 12 12 12 12 12 12 12 12 12 12 12 12 12 12 12 12 12 12 12 12 12 12 12 12 12 12 12 12 12 12 12 12 12 12 12 12 12 12 12 12 12 12 12 12 12 12 12 12
