27 27 27 27 27 27 27 27 27 27 27 27 27 27 27 27 27 27 27 27 27 27 27 27 27 27 27 27 27 27 27 27 27 27 27 27 27 27 27 27 27 27 27 27 27 27 27 27 27 27 27 27 27 27 27 27 27 27 27 27 27 27 27 27
27 27 27 27 27 27 27 27 27 27 27 27 27 27 27 27 27 27 27 27 27 27 27 27 27 27 27 27 27 27 27 27 27 27 27 27 27 27 27 27 27 27 27 27 27 27 27 27 27 27 27 27 27 27 27 27 27 27 27 27 27 27 27 27
27 27 27 27 27 27 27 27 27 27 27 27 27 27 27 27 27 27 27 27 27 27 27 27 27 27 27 27 27 27 27 27 27 27 27 27 27 27 27 27 27 27 27 27 27 27 27 27 27 27 27 27 27 27 27 27 27 27 27 27 27 27 27 27
27 27 27 27 27 27 27 27 27 27 27 27 27 27 27 27 27 27 27 27 27 27 27 27 27 27 27 27 27 27 27 27 27 27 27 27 27 27 27 27 27 27 27 27 27 27 27 27 27 27 27 27 27 27 27 27 27 27 27 27 27 27 27 27
27 27 27 27 27 27 27 27 27 27 27 27 27 27 27 27 27 27 27 27 27 27 27 27 27 27 27 27 27 27 27 27 27 27 27 27 27 27 27 27 27 27 27 27 27 27 27 27 27 27 27 27 27 27 27 27 27 27 27 27 27 27 27 27
27 27 27 27 27 27 27 27 27 27 27 27 27 27 27 27 27 27 27 27 27 27 27 27 27 27 27 27 27 27 27 27 27 27 27 27 27 27 27 27 27 27 27 27 27 27 27 27 27 27 27 27 27 27 27 27 27 27 27 27 27 27 27 27
27 27 27 27 27 27 27 27 27 27 27 27 27 27 27 27 27 27 27 27 27 27 27 27 27 27 27 27 27 27 27 27 27 27 27 27 27 27 27 27 27 27 27 27 27 27 27 27 27 27 27 27 27 27 27 27 27 27 27 27 27 27 27 27
27 27 27 27 27 27 27 27 27 27 27 27 27 27 27 27 27 27 27 27 27 27 27 27 27 27 27 27 27 27 27 27 27 27 27 27 27 27 27 27 27 27 27 27 27 27 27 27 27 27 27 27 27 27 27 27 27 27 27 27 27 27 27 27
27 27 27 27 27 27 27 27 27 27 27 27 27 27 27 27 27 27 27 27 27 27 27 27 27 27 27 27 27 27 27 27 27 27 27 27 27 27 27 27 27 27 27 27 27 27 27 27 27 27 27 27 27 27 27 27 27 27 27 27 27 27 27 27
27 27 27 27 27 27 27 27 27 27 27 27 27 27 27 27 27 27 27 27 27 27 27 27 27 27 27 27 27 27 27 27 27 27 27 27 27 27 27 27 27 27 27 27 27 27 27 27 27 27 27 27 27 27 27 27 27 27 27 27 27 27 27 27
27 27 27 27 27 27 27 27 27 27 27 27 27 27 27 27 27 27 27 27 27 27 27 27 27 27 27 27 27 27 27 27 27 27 27 27 27 27 27 27 27 27 27 27 27 27 27 27 27 27 27 27 27 27 27 27 27 27 27 27 27 27 27 27
27 27 27 27 27 27 27 27 27 27 27 27 27 27 27 27 27 27 27 27 27 27 27 27 27 27 27 27 27 27 27 27 27 27 27 27 27 27 27 27 27 27 27 27 27 27 27 27 27 27 27 27 27 27 27 27 27 27 27 27 27 27 27 27
27 27 27 27 27 27 27 27 27 27 27 27 27 27 27 27 27 27 27 27 27 27 27 27 27 27 27 27 27 27 27 27 27 27 27 27 12 12 12 12 12 12 12 12 12 12 12 12 12 12 12 12 12 12 12 12 12 12 12 12 12 27 27 27
27 27 27 27 27 27 27 27 27 27 27 27 27 27 27 27 27 27 27 27 27 27 27 27 27 27 12 12 12 12 12 12 12 12 12 12 12 12 12 12 12 12 12 12 12 12 12 12 12 12 12 12 12 12 12 12 12 12 12 12 12 27 27 27
27 27 27 27 27 27 27 27 27 27 27 27 27 27 27 27 27 27 27 27 27 27 27 27 27 27 12 12 12 12 12 12 12 12 12 12 12 12 133 133 133 133 133 133 133 133 133 133 133 133 133 133 133 133 133 133 133 133 133 12 12 27 27 27
27 27 27 27 27 27 27 27 27 27 27 27 27 27 27 27 27 27 27 27 27 27 27 27 27 27 12 12 12 12 12 12 12 12 12 12 12 12 133 133 133 133 133 133 133 133 133 133 133 133 133 133 133 133 133 133 133 133 133 12 12 27 27 27
27 27 27 27 27 27 27 27 27 27 27 27 27 27 27 27 12 12 12 12 12 27 27 27 27 27 12 12 12 12 12 12 12 12 12 12 12 12 133 133 133 133 133 133 133 133 133 133 133 133 133 133 133 133 133 133 133 133 133 12 12 27 27 27
27 27 27 27 27 27 27 27 27 27 27 27 27 27 27 27 12 134 134 134 12 27 27 27 27 27 12 12 12 12 12 12 12 12 12 12 12 12 133 133 133 17 20 17 133 133 133 17 18 17 133 133 133 17 20 17 133 133 133 12 12 27 27 27
27 27 27 27 27 27 27 27 27 27 27 27 27 27 27 12 12 134 134 134 12 12 12 12 12 12 12 12 12 12 12 12 12 12 12 12 12 12 133 133 133 18 17 18 133 133 133 20 17 20 133 133 133 18 17 18 133 133 133 12 12 27 27 27
27 27 27 27 12 12 12 12 12 12 12 12 12 12 12 12 134 134 134 134 134 12 12 12 12 11 12 12 12 10 12 12 12 23 12 12 12 12 133 133 133 17 20 17 133 133 133 17 18 17 133 133 133 17 20 17 133 133 133 12 12 27 27 27
27 27 21 21 12 134 134 134 134 134 134 134 134 134 134 134 134 134 134 134 134 94 135 135 135 135 135 135 135 135 135 135 135 135 135 135 135 90 133 133 133 133 133 133 133 133 133 133 133 133 133 133 133 133 133 133 133 133 133 12 12 27 27 27
27 21 139 139 100 134 134 134 134 134 134 134 134 134 134 134 134 134 134 134 134 23 135 135 135 135 135 135 135 135 135 135 135 135 135 135 135 12 133 133 133 133 133 133 133 133 133 133 133 133 133 133 133 133 133 133 133 133 133 12 12 27 27 27
27 27 21 21 12 134 134 134 134 134 134 134 134 134 134 134 134 134 134 134 134 94 135 135 135 135 135 135 135 135 135 135 135 135 135 135 135 90 133 133 133 133 133 133 133 133 133 133 133 133 133 133 133 133 133 133 133 133 133 12 12 27 27 27
27 27 27 27 12 12 12 12 12 12 12 12 12 12 12 12 134 134 134 134 134 12 12 12 12 11 12 12 12 10 12 12 12 23 12 12 12 12 133 133 133 17 18 17 133 133 133 17 20 17 133 133 133 17 18 17 133 133 133 12 12 27 27 27
27 27 27 27 27 27 27 27 27 27 27 27 27 27 27 12 12 134 134 134 12 12 12 12 12 12 12 12 12 12 12 12 12 12 12 12 12 12 133 133 133 20 17 20 133 133 133 18 17 18 133 133 133 20 17 20 133 133 133 12 12 27 27 27
27 27 27 27 27 27 27 27 27 27 27 27 27 27 27 27 12 134 134 134 12 27 27 27 27 27 27 27 27 27 27 27 27 27 27 27 27 12 133 133 133 17 18 17 133 133 133 17 20 17 133 133 133 17 18 17 133 133 133 12 12 27 27 27
27 27 27 27 27 27 27 27 27 27 27 27 27 27 27 27 12 12 12 12 12 27 27 27 27 27 27 27 27 27 27 27 27 27 27 27 27 12 133 133 133 133 133 133 133 133 133 133 133 133 133 133 133 133 133 133 133 133 133 12 12 27 27 27
27 2 1 2 2 27 1 1 27 2 1 1 2 2 2 27 27 27 1 27 2 27 27 1 27 1 1 27 2 1 27 27 1 2 27 2 27 12 133 133 133 133 133 133 133 133 133 133 133 133 133 133 133 133 133 133 133 133 133 12 12 27 27 27
27 1 108 108 108 108 90 109 109 109 109 109 109 109 109 109 1 1 108 108 108 108 108 108 108 108 108 108 108 108 108 108 108 108 108 108 27 12 133 133 133 133 133 133 133 133 133 133 133 133 133 133 133 133 133 133 133 133 133 12 12 27 27 27
27 27 108 108 108 108 1 109 109 109 109 109 109 109 109 109 27 27 108 108 108 108 108 108 108 108 108 108 108 108 108 108 108 108 108 108 1 12 12 12 12 12 12 12 12 12 12 12 12 12 12 93 12 93 11 93 12 93 12 12 12 27 27 27
27 27 108 108 108 108 1 109 109 109 109 1 27 27 109 109 27 27 108 108 108 108 108 108 108 108 108 108 108 108 108 108 108 108 108 108 2 12 12 12 12 12 12 12 12 12 12 12 12 27 132 132 132 132 132 132 132 132 132 27 27 27 27 27
27 27 108 108 108 108 27 109 109 109 109 27 109 1 109 109 2 1 108 108 108 108 108 108 108 108 108 108 108 108 108 108 108 108 108 108 1 27 27 27 27 27 27 27 27 27 27 27 27 2 132 132 132 132 132 132 132 132 132 1 27 27 27 27
27 2 108 108 108 108 2 109 109 27 109 1 109 2 109 109 1 1 108 108 108 108 27 27 1 2 27 1 2 1 27 1 1 27 2 91 27 27 27 27 114 27 114 27 114 27 114 27 114 2 132 132 132 132 132 132 132 132 132 2 27 27 27 27
27 27 108 108 108 108 27 109 109 27 109 109 109 27 109 109 2 27 108 108 108 108 27 27 27 27 27 27 27 27 27 27 27 3 27 113 27 3 2 114 114 1 114 2 114 1 114 1 114 27 1 27 27 27 132 1 132 2 1 27 27 27 27 27
27 27 108 108 108 108 27 109 109 1 27 2 27 1 109 109 27 27 108 108 108 108 27 27 27 27 27 27 27 27 27 2 113 113 113 113 113 113 113 27 1 114 114 114 114 114 114 114 114 114 1 27 27 27 132 27 132 27 27 27 27 27 27 27
27 1 108 108 108 108 2 109 109 109 109 109 109 27 109 109 1 27 108 108 108 108 2 2 140 140 140 27 27 27 27 113 113 113 113 113 113 113 113 113 27 114 114 114 114 114 114 114 114 114 114 114 27 27 132 1 132 27 27 27 27 27 27 27
27 2 108 108 108 108 27 109 109 2 27 2 109 27 27 27 27 27 108 108 108 108 90 140 140 140 140 27 27 27 4 113 113 113 12 113 12 113 113 113 90 114 114 114 114 114 114 114 114 114 1 27 27 27 132 27 132 2 27 27 27 27 27 27
27 1 108 108 108 108 27 109 109 1 1 27 109 109 109 109 27 27 108 108 108 108 27 1 140 140 140 27 27 27 27 113 113 113 113 113 113 113 113 113 1 114 114 114 114 114 114 114 114 114 114 114 2 27 132 1 132 1 27 27 27 27 27 27
27 1 108 108 108 108 2 109 109 27 1 27 27 2 27 27 2 2 108 108 108 108 1 27 27 27 27 27 27 27 27 27 113 113 113 113 113 113 113 27 27 114 114 114 114 114 114 114 114 114 1 27 27 27 132 1 132 27 27 27 27 27 27 27
27 27 108 108 108 108 27 109 109 109 109 109 109 109 109 109 109 27 108 108 108 108 27 27 27 27 2 2 27 2 27 27 27 3 27 91 27 3 2 27 27 27 114 1 114 2 114 27 114 1 27 132 132 132 132 132 132 27 27 27 27 27 27 27
27 2 108 108 108 108 2 109 109 109 109 109 109 109 109 109 109 2 108 108 108 108 2 27 27 108 108 108 108 108 108 27 27 27 115 115 115 27 116 116 116 27 114 27 114 27 114 27 114 27 27 91 1 2 1 27 1 2 27 27 27 27 27 27
27 1 108 108 108 108 27 27 2 1 27 109 109 109 109 109 109 27 108 108 108 108 108 108 27 108 108 108 108 108 108 13 27 2 115 115 115 90 116 116 116 27 27 27 27 27 2 27 27 27 118 118 118 1 27 27 27 27 27 27 27 27 27 27
27 27 108 108 108 108 27 27 27 27 27 109 109 109 109 109 109 1 108 108 108 108 27 108 27 108 108 108 108 108 108 27 27 27 115 115 115 27 116 116 116 27 27 27 27 27 27 27 27 27 118 118 118 1 27 27 27 27 27 27 27 27 27 27
27 2 108 108 108 108 27 1 1 1 27 1 27 2 1 2 27 27 108 108 108 108 28 108 28 27 2 1 2 1 2 1 1 27 1 2 27 1 27 91 27 27 1 2 1 27 1 27 1 27 1 118 118 27 27 27 27 27 27 27 27 27 27 27
27 1 108 108 108 108 108 108 108 108 108 108 108 108 108 108 108 108 108 108 108 108 108 108 108 108 108 108 108 108 108 108 108 108 108 108 1 117 117 117 117 117 117 117 117 117 117 117 117 117 1 118 118 118 118 118 27 27 27 27 27 1 27 27
27 27 108 108 108 108 108 108 108 108 108 108 108 108 108 108 108 108 108 108 108 108 108 108 108 108 108 108 108 108 108 108 108 108 108 108 2 117 15 117 15 117 15 117 15 117 15 117 15 117 90 118 118 118 118 118 118 1 27 27 130 130 130 27
27 27 108 108 108 108 108 108 108 108 108 108 108 108 108 108 108 108 108 108 108 108 108 108 108 108 108 108 108 108 108 108 108 108 108 108 2 117 117 117 117 117 117 117 117 117 117 117 117 117 27 118 118 118 118 118 118 6 27 27 130 130 130 1
27 2 108 108 108 108 108 108 108 108 108 108 108 108 108 108 108 108 108 108 108 108 108 108 108 108 108 108 108 108 108 108 108 108 108 108 27 117 15 117 15 117 15 117 15 117 15 117 15 117 90 118 118 118 118 118 118 27 27 1 130 130 130 27
27 27 27 1 1 27 27 1 27 27 1 27 27 1 27 1 27 27 108 108 108 108 2 27 27 1 1 27 27 27 27 2 108 108 108 108 27 117 117 117 117 117 117 117 117 117 117 117 117 117 2 118 118 118 118 118 27 27 27 1 130 130 130 27
27 27 110 110 110 110 110 110 110 110 110 110 110 110 110 27 27 27 108 108 108 108 27 17 17 17 17 17 17 17 17 1 108 108 108 108 1 2 27 1 27 27 2 27 27 27 1 1 2 27 27 118 118 27 1 27 27 129 129 27 130 130 130 27
1 1 110 110 110 110 110 110 110 110 110 110 110 110 110 27 27 27 108 108 108 108 27 17 111 111 18 112 112 112 17 1 108 108 108 108 27 2 120 120 120 120 120 27 121 121 121 27 27 27 118 118 118 27 126 126 27 129 129 1 130 130 130 1
2 2 110 27 1 110 27 27 110 1 27 110 27 27 110 27 27 1 108 108 108 108 27 17 111 111 90 112 112 112 17 2 108 108 108 108 1 27 120 120 27 1 120 1 121 121 121 27 122 2 118 118 118 27 126 126 1 129 129 27 130 130 106 27
27 110 110 1 27 110 27 1 110 1 27 110 110 27 110 110 27 27 108 108 108 108 2 17 111 111 18 112 112 112 17 27 108 108 108 108 2 2 120 120 27 27 91 2 27 91 27 2 91 27 27 91 27 27 91 27 27 91 27 27 91 27 27 27
27 110 106 27 1 106 27 1 106 27 27 106 1 27 106 110 27 27 108 108 108 108 27 17 111 111 17 112 112 112 17 27 108 108 108 108 27 27 120 120 27 119 119 119 119 119 119 119 119 119 119 119 119 119 119 119 119 119 119 119 119 119 2 27
1 110 110 27 27 110 27 1 110 27 27 110 27 1 110 110 27 27 108 108 108 108 27 17 111 111 17 17 17 17 17 27 108 108 108 108 27 27 120 120 3 119 119 119 119 119 119 119 119 119 119 119 119 119 119 119 119 119 119 119 119 119 6 27
2 110 110 110 110 110 110 110 110 110 110 110 110 110 110 110 27 1 108 108 108 108 2 17 111 111 111 111 111 111 17 27 108 108 108 108 2 2 120 120 27 119 119 119 119 119 119 119 119 119 119 119 119 119 119 119 119 119 119 119 119 119 1 27
27 110 110 110 110 110 110 110 110 110 110 110 110 110 110 110 27 27 108 108 108 108 1 17 111 111 111 111 111 111 17 1 108 108 108 108 1 27 120 120 1 27 91 2 1 91 2 27 91 27 2 91 27 1 91 27 27 91 27 1 91 27 27 27
27 27 91 27 27 2 2 1 27 27 27 2 1 1 27 27 1 1 108 108 108 108 1 17 17 17 17 17 111 111 17 27 108 108 108 108 1 2 120 120 2 1 120 27 27 123 1 124 124 124 1 125 125 2 127 27 128 128 128 27 131 131 131 2
27 1 108 108 108 108 108 108 108 108 108 108 108 108 108 108 108 108 108 108 108 108 27 17 111 111 111 111 111 111 17 27 108 108 108 108 27 27 120 120 120 120 120 27 27 27 27 124 124 124 27 125 125 27 127 1 128 128 128 1 131 131 131 1
27 2 108 108 108 108 108 108 108 108 108 108 108 108 108 108 108 108 108 108 108 108 2 17 111 111 111 111 111 111 17 2 108 108 108 108 2 27 2 27 2 27 2 27 27 27 2 124 124 124 1 27 27 27 27 2 128 128 128 1 131 131 131 27
27 1 108 108 108 108 108 108 108 108 108 108 108 108 108 108 108 108 108 108 108 108 27 17 111 111 17 17 17 17 18 27 108 108 108 108 1 27 27 27 27 27 27 27 27 27 27 27 27 27 27 27 27 27 27 1 128 128 128 1 1 2 27 27
27 2 108 108 108 108 108 108 108 108 108 108 108 108 108 108 108 108 108 108 108 108 1 17 111 111 111 111 111 111 111 90 108 108 108 108 1 27 27 27 27 27 27 27 27 27 27 27 27 27 27 27 27 27 27 27 128 128 128 27 27 27 27 27
27 27 27 1 2 2 27 27 2 27 2 1 27 27 27 27 1 27 27 2 27 27 1 17 17 17 17 17 17 17 18 27 2 1 1 27 2 27 27 27 27 27 27 27 27 27 27 27 27 27 27 27 27 27 27 27 27 2 1 27 27 27 27 27
27 27 27 27 27 27 27 27 27 27 27 27 27 27 27 27 27 27 27 27 27 27 27 27 27 27 27 27 27 27 27 27 27 27 27 27 27 27 27 27 27 27 27 27 27 27 27 27 27 27 27 27 27 27 27 27 27 27 27 27 27 27 27 27
