1 2 1 2 1 1 2 1 2 1 1 2 1 2 1 1 2 1 2 1 1 2 1 2 1 1 2 1 2 1 1 2 1 2 1 1 2 1 2 1 1 2 1 2 1 1 2 1 2 1 1 2 1 2 1 1 2 1 2 1 1 2 1 2
1 126 126 126 126 126 126 126 126 126 126 126 126 126 126 126 126 126 126 126 126 126 126 126 126 126 126 126 126 126 126 126 126 126 126 126 126 126 126 126 126 126 126 126 126 126 126 126 126 1 1 132 132 132 132 132 132 132 132 132 132 132 132 1
2 126 126 126 126 126 126 126 126 126 126 126 126 126 126 126 126 126 126 126 126 126 126 126 126 126 126 126 126 126 126 126 126 126 126 126 126 126 126 126 126 126 126 126 126 126 126 126 126 1 1 132 12 12 132 132 132 132 132 132 132 132 106 1
2 126 126 126 126 126 126 126 126 126 126 126 126 126 126 126 126 126 126 126 126 126 126 126 126 126 126 126 126 126 126 126 126 126 126 126 126 126 126 126 126 126 126 126 126 126 126 126 126 1 1 106 12 12 132 132 132 132 132 132 132 1 1 1
1 126 126 126 126 126 126 126 126 126 126 126 126 126 126 126 126 126 126 126 126 126 126 126 126 126 126 126 126 126 126 126 126 126 126 126 126 126 126 126 126 126 126 126 126 126 126 126 126 1 1 132 12 132 132 132 132 12 132 132 132 3 21 1
1 2 1 2 1 1 2 1 2 2 2 2 126 1 1 2 2 1 1 2 2 1 126 1 1 2 2 1 2 1 1 1 126 1 1 2 1 2 1 1 1 2 1 1 2 2 2 91 2 1 1 132 132 132 132 132 12 12 12 132 132 100 143 21
1 118 118 118 118 118 118 118 118 118 106 2 91 1 106 118 118 118 118 118 106 1 91 1 106 118 118 118 118 118 106 1 91 1 106 118 118 118 118 118 118 118 118 118 2 132 132 132 132 132 1 132 12 132 132 132 132 12 132 132 132 3 21 1
2 118 118 118 118 118 118 118 118 118 118 118 118 118 118 118 118 118 118 118 118 118 118 118 118 118 118 118 118 118 118 118 118 118 118 118 118 118 118 118 118 118 118 118 1 132 132 132 132 132 1 132 12 12 132 132 132 132 132 132 132 2 1 2
2 118 118 118 118 118 17 118 17 118 118 118 118 118 118 118 17 118 17 118 118 118 118 118 118 118 17 118 17 118 118 118 118 118 118 118 17 118 17 118 118 118 118 118 1 1 1 1 132 132 1 132 12 12 132 132 132 132 132 132 132 132 132 1
1 118 118 118 17 17 17 93 17 17 17 118 118 118 17 17 17 93 17 17 17 118 118 118 17 17 17 93 17 17 17 118 118 118 17 17 17 93 17 17 17 118 118 118 2 1 1 1 1 1 1 132 132 132 132 132 132 132 132 132 132 132 132 1
1 118 118 118 17 140 140 140 140 140 17 118 118 118 17 141 141 141 141 141 17 118 118 118 17 143 143 143 143 143 17 118 118 118 17 142 142 142 142 142 17 118 118 118 2 1 2 3 2 2 1 2 1 1 2 1 1 93 1 1 2 1 1 2
2 118 118 118 17 140 140 140 140 140 17 118 118 118 17 141 141 141 141 141 17 118 118 118 17 143 143 143 143 143 17 118 118 118 17 142 142 142 142 142 17 118 118 118 1 125 125 125 125 125 1 106 127 127 127 127 127 127 127 127 127 127 127 1
1 118 118 118 17 140 140 140 140 140 17 118 118 118 17 141 141 141 141 141 17 118 118 118 17 143 143 143 143 143 17 118 118 118 17 142 142 142 142 142 17 118 118 118 1 125 125 106 125 125 2 127 127 127 127 127 127 127 127 127 127 127 127 1
2 118 118 118 17 140 140 140 140 140 17 118 118 118 17 141 141 141 141 141 17 118 118 118 17 143 143 143 143 143 17 118 118 118 17 142 142 142 142 142 17 118 118 118 2 125 125 125 125 125 90 127 127 127 127 127 127 127 127 127 127 127 127 2
2 118 118 118 17 140 140 140 140 140 17 118 118 118 17 141 141 141 141 141 17 118 118 118 17 143 143 143 143 143 17 118 118 118 17 142 142 142 142 142 17 118 118 118 2 125 125 125 125 125 1 127 127 127 127 127 127 127 127 127 127 127 127 1
1 118 118 118 17 17 17 17 17 17 17 118 118 118 17 17 17 17 17 17 17 118 118 118 17 17 17 17 17 17 17 118 118 118 17 17 17 17 17 17 17 118 118 118 1 106 125 125 125 125 2 106 127 127 127 127 127 127 127 127 127 127 127 1
1 2 118 118 118 118 118 118 118 118 118 118 118 118 118 118 118 118 118 118 118 118 118 118 118 118 118 118 118 118 118 118 118 118 118 118 118 118 118 118 118 118 118 1 1 1 1 91 1 1 1 1 1 1 2 1 1 1 2 2 1 1 1 2
2 3 118 118 118 118 118 118 118 118 118 118 118 118 118 118 118 118 118 118 118 118 118 118 118 118 118 118 118 118 118 118 118 118 118 118 118 118 118 118 118 118 118 3 1 125 125 125 125 125 2 106 106 128 128 128 128 128 128 1 1 128 128 1
2 2 118 118 118 118 118 118 118 118 118 118 118 118 118 118 118 118 118 118 118 118 118 118 118 118 118 118 118 118 118 118 118 118 118 118 118 118 118 118 118 118 118 1 2 125 125 125 125 125 1 128 128 128 128 128 128 128 128 1 1 128 128 1
1 118 118 118 17 17 17 17 17 17 17 118 118 118 17 17 17 17 17 17 17 118 118 118 17 17 17 17 17 17 17 118 118 118 17 17 17 17 17 17 17 118 118 118 2 125 125 125 125 125 90 128 128 128 128 128 128 128 128 128 128 128 128 3
1 118 118 118 17 139 139 139 139 139 17 118 118 118 17 141 141 141 141 141 17 118 118 118 17 143 143 143 143 143 17 118 118 118 17 142 142 142 142 142 17 118 118 118 1 125 125 125 125 125 1 128 128 128 128 128 128 128 128 128 128 128 128 1
1 118 118 118 17 139 139 139 139 139 17 118 118 118 17 141 141 141 141 141 17 118 118 118 17 143 143 143 143 143 17 118 118 118 17 142 142 142 142 142 17 118 118 118 1 125 125 125 125 125 2 128 128 128 128 128 128 128 128 128 128 128 128 2
1 118 118 118 17 139 139 139 139 139 17 118 118 118 17 141 141 141 141 141 17 118 118 118 17 143 143 143 143 143 17 118 118 118 17 142 142 142 142 142 17 118 118 118 1 125 125 125 125 125 2 128 128 128 128 128 128 128 128 128 128 128 128 1
2 118 118 118 17 139 139 139 139 139 17 118 118 118 17 141 141 141 141 141 17 118 118 118 17 143 143 143 143 143 17 118 118 118 17 142 142 142 142 142 17 118 118 118 2 125 125 125 125 125 1 128 128 128 128 128 128 128 128 128 128 128 128 2
1 118 118 118 17 139 139 139 139 139 17 118 118 118 17 141 141 141 141 141 17 118 118 118 17 143 143 143 143 143 17 118 118 118 17 142 142 142 142 142 17 118 118 118 1 125 125 125 125 125 90 128 128 128 128 128 128 128 128 128 128 128 128 3
1 118 118 118 17 17 17 93 17 17 17 118 118 118 17 17 17 93 17 17 17 118 118 118 17 17 17 93 17 17 17 118 118 118 17 17 17 93 17 17 17 118 118 118 1 125 125 125 125 125 1 106 128 128 128 128 128 128 128 1 1 128 128 1
2 118 118 118 118 118 17 118 17 118 118 118 118 118 118 118 17 118 17 118 118 118 118 118 118 118 17 118 17 118 118 118 118 118 118 118 17 118 17 118 118 118 118 118 2 125 125 125 125 125 2 128 106 128 128 128 128 128 128 1 1 128 128 2
1 118 118 118 118 118 118 118 118 118 118 1 4 1 118 118 118 118 118 118 118 1 4 2 118 118 118 118 118 118 118 1 4 1 118 118 118 118 118 118 118 118 118 118 1 125 125 125 125 125 1 2 1 2 1 1 2 1 1 2 1 1 1 2
1 2 1 1 1 2 1 2 1 1 2 1 1 2 1 1 2 1 1 1 1 2 1 1 1 1 1 1 2 1 1 1 2 1 1 1 1 1 1 2 2 2 2 1 1 125 125 125 125 125 1 129 129 129 129 129 129 129 129 129 129 129 129 1
12 12 10 12 12 12 12 10 12 12 11 12 12 10 12 12 12 9 8 9 9 8 9 9 8 9 9 8 8 9 9 9 9 8 9 8 8 9 9 9 8 8 9 9 1 125 125 125 125 125 90 129 129 129 129 129 129 129 129 129 129 129 129 2
12 116 116 116 12 116 116 116 116 116 116 116 116 116 116 116 12 8 9 9 9 9 9 9 9 9 9 9 9 9 9 9 8 123 123 123 123 123 123 123 123 123 123 8 2 125 125 125 125 106 1 129 129 129 129 129 129 129 129 129 129 129 129 1
12 116 116 116 90 116 116 106 116 116 116 116 116 116 116 116 12 9 9 9 9 9 9 9 9 9 9 9 9 9 9 9 9 9 123 123 123 123 123 123 123 123 123 8 1 1 91 1 2 1 1 2 1 129 129 129 129 129 129 129 129 129 129 2
12 116 116 116 12 106 106 116 116 116 116 116 116 116 116 116 12 8 9 9 9 9 9 9 9 9 9 9 9 9 9 9 8 123 123 123 123 123 123 123 123 123 123 9 8 124 124 124 8 8 8 8 1 129 129 129 129 129 129 129 129 129 129 1
12 116 116 116 12 12 12 11 12 12 10 12 12 11 12 12 12 9 8 9 8 9 9 8 8 9 8 8 8 8 9 8 13 8 8 9 123 123 8 8 8 91 8 9 9 124 124 124 9 124 124 8 1 129 129 129 129 129 129 129 129 129 129 1
12 116 116 116 12 119 119 119 119 119 119 119 119 119 119 12 12 12 12 12 12 12 12 12 12 12 12 12 12 9 108 108 108 108 108 9 123 123 8 124 124 124 124 124 124 124 124 124 9 124 124 8 1 129 129 129 129 129 129 129 129 129 129 2
12 12 116 116 12 119 119 119 119 119 119 119 119 119 119 119 12 120 120 120 120 120 120 120 120 12 12 12 12 8 108 108 108 108 108 8 106 123 8 124 124 124 124 124 124 124 124 124 8 124 124 8 2 129 129 129 129 129 129 129 129 129 129 2
12 11 116 116 10 119 119 119 119 119 119 119 119 119 119 119 90 120 120 120 120 120 120 120 120 12 8 9 8 9 8 108 108 108 9 8 9 8 9 124 124 124 124 124 124 124 124 124 8 124 124 8 1 2 129 129 129 129 129 129 129 129 129 1
12 12 116 116 12 119 119 119 119 119 119 119 119 119 119 119 12 120 120 120 120 120 120 120 120 12 9 112 112 112 9 8 91 8 9 112 112 112 8 124 124 124 124 124 124 124 124 124 9 124 124 8 1 1 91 1 2 1 1 1 1 1 2 1
12 116 116 116 12 119 119 119 119 119 119 119 119 119 119 12 12 120 120 120 120 120 120 120 12 12 8 112 112 112 9 109 109 109 8 112 112 112 9 124 124 8 8 9 8 9 8 8 9 8 9 9 8 113 113 113 1 2 1 131 131 1 1 2
12 116 116 116 12 12 12 12 12 12 91 12 12 12 12 12 12 12 12 12 12 10 91 10 12 8 8 8 91 8 9 109 109 109 9 8 91 8 9 124 124 9 111 111 111 111 111 111 111 111 111 111 9 113 113 113 1 131 131 131 131 131 131 1
12 116 116 116 116 116 116 116 116 116 116 116 116 116 12 116 116 116 116 116 12 110 110 110 12 8 9 109 109 109 109 109 109 109 109 109 109 109 9 124 124 8 111 111 111 111 111 111 111 111 111 111 9 113 113 113 90 131 131 131 131 131 131 3
12 116 116 116 116 116 116 116 116 116 116 116 116 116 90 116 116 116 116 116 11 110 110 110 11 8 9 109 109 109 109 109 109 109 109 109 109 109 8 124 124 8 111 111 111 111 111 111 111 111 111 111 9 106 113 113 1 131 131 131 131 131 131 2
12 116 116 116 116 116 116 116 116 116 116 116 116 116 12 116 116 116 116 116 12 110 110 110 12 9 9 109 109 109 109 17 17 17 109 109 109 109 9 9 9 9 8 91 8 8 9 8 8 9 9 9 8 113 113 113 6 131 131 131 131 131 131 2
12 12 11 12 12 12 12 10 12 12 12 12 11 12 12 12 12 12 12 12 12 110 110 110 12 109 109 109 109 109 17 17 17 17 17 109 109 109 109 109 8 106 113 113 113 113 113 113 113 113 113 113 113 113 113 113 1 131 131 131 131 131 131 1
12 12 116 116 116 116 12 12 12 12 12 12 12 12 12 12 12 138 138 138 90 110 110 110 90 109 109 109 109 109 17 17 17 17 17 109 109 109 109 109 90 113 113 113 113 113 113 113 113 113 113 113 113 113 113 113 90 131 131 131 131 131 131 3
12 12 116 116 116 116 12 12 12 12 12 12 12 12 12 12 12 138 138 138 12 110 110 110 12 109 109 109 109 109 109 17 17 17 109 109 109 109 109 109 8 113 113 113 113 113 113 113 113 113 113 113 113 113 113 113 1 131 131 131 131 131 131 1
12 12 12 116 116 116 12 12 12 12 12 12 12 12 12 12 12 138 138 138 12 12 91 12 12 8 9 109 109 109 109 109 17 109 109 109 109 109 9 8 9 8 8 9 9 8 9 8 9 9 9 113 113 113 113 113 6 131 131 131 131 131 131 2
12 12 12 116 116 116 12 12 12 12 12 12 12 12 12 12 12 138 138 138 12 137 137 137 12 12 9 109 109 109 109 109 109 109 109 109 109 109 9 109 109 109 109 109 109 8 8 109 109 109 8 8 8 106 113 113 1 131 131 131 131 131 131 1
12 12 12 12 12 12 12 12 12 12 12 12 12 12 12 12 12 12 12 12 12 137 137 137 137 12 8 109 109 109 109 109 109 109 109 109 109 109 9 109 109 109 109 109 109 8 8 109 109 109 109 109 9 113 113 113 90 131 131 131 131 131 131 3
12 12 12 12 12 12 12 12 12 12 12 12 12 12 12 12 12 12 12 12 12 137 137 137 137 12 9 8 91 8 8 109 109 109 8 8 91 8 9 8 9 8 109 109 109 109 109 109 109 109 109 109 8 113 113 113 1 131 131 131 131 131 131 1
12 12 12 12 12 12 12 12 12 12 12 12 12 12 12 12 12 12 12 12 12 12 12 12 12 12 8 135 135 135 8 109 109 109 8 142 142 142 142 142 142 9 109 109 109 109 109 109 109 109 109 109 8 113 113 113 1 2 1 1 2 1 1 2
12 12 12 12 12 12 12 12 12 12 12 12 12 12 12 12 12 12 12 12 12 12 12 12 9 9 8 135 135 135 9 8 91 8 9 142 142 142 142 142 142 8 9 8 9 9 8 8 8 9 9 9 8 8 91 8 8 9 8 9 9 8 9 8
12 12 12 12 12 12 12 12 12 12 12 12 12 12 12 12 12 12 12 12 12 12 12 12 8 135 135 135 135 135 8 114 114 114 8 142 142 142 142 142 142 8 130 130 130 130 130 130 130 130 130 130 130 130 130 130 130 130 130 130 130 130 130 8
12 12 12 12 12 12 12 12 12 12 12 12 12 12 12 12 12 12 12 12 12 12 12 12 9 135 135 135 135 135 9 114 114 114 9 142 142 142 142 142 142 90 130 130 130 130 130 130 130 130 130 130 130 130 130 130 130 130 130 130 130 130 130 8
12 12 12 12 12 12 12 12 12 12 12 12 12 12 12 12 12 12 12 12 12 12 12 12 9 135 135 135 135 135 8 114 114 114 9 142 142 142 142 142 142 8 130 130 130 130 130 130 130 130 130 130 130 130 130 130 130 130 130 130 130 130 130 9
12 12 12 12 12 12 12 12 12 12 12 12 12 12 12 12 12 12 12 12 12 12 12 12 9 135 135 135 135 135 9 114 114 114 8 142 142 142 142 142 142 8 9 8 8 8 91 8 9 8 91 8 8 8 9 9 9 9 9 9 8 8 9 8
12 12 12 12 12 12 12 12 12 12 12 12 12 12 12 12 12 12 12 12 12 12 12 12 8 8 9 8 8 9 8 114 106 114 8 9 8 9 8 9 8 8 8 8 9 133 133 133 133 133 133 133 8 8 8 8 8 8 8 8 8 8 8 8
12 12 12 12 12 12 12 12 12 12 12 12 12 12 12 12 12 12 12 12 12 12 12 12 12 12 12 8 114 114 114 114 114 114 114 114 114 8 8 8 8 133 133 133 8 133 133 133 133 133 133 133 9 8 8 8 8 8 8 8 8 8 8 9
12 12 12 12 12 12 12 12 12 12 12 12 12 12 12 12 12 12 12 12 12 12 12 12 12 12 12 9 114 114 114 114 114 114 114 114 114 9 8 8 8 133 133 133 9 133 133 133 133 133 133 133 9 8 8 8 8 8 8 8 8 8 8 9
12 12 12 12 12 12 12 12 12 12 12 12 12 12 12 12 12 12 12 12 12 12 12 12 12 12 12 8 114 114 114 114 114 114 114 114 114 8 8 8 8 8 133 133 8 133 133 133 133 133 133 133 8 8 8 8 8 8 8 8 8 8 8 9
12 12 12 12 12 12 12 12 12 12 12 12 12 12 12 12 12 12 12 12 12 12 12 12 12 12 12 9 114 114 114 114 114 114 114 114 114 8 8 8 8 133 133 133 9 133 133 133 133 133 133 133 9 8 8 8 8 8 8 8 8 8 8 9
12 12 12 12 12 12 12 12 12 12 12 12 12 12 12 12 12 12 12 12 12 12 12 12 12 12 12 9 114 114 114 114 114 106 114 114 114 9 8 8 8 133 133 133 9 133 133 133 133 133 133 133 8 8 8 8 8 8 8 8 8 8 8 9
12 12 12 12 12 12 12 12 12 12 12 12 12 12 12 12 12 12 12 12 12 12 12 12 12 12 12 9 9 114 8 5 8 7 8 114 9 8 8 8 8 8 8 8 8 133 133 133 133 133 133 133 8 8 8 8 8 8 8 8 8 8 8 8
12 12 12 12 12 12 12 12 12 12 12 12 12 12 12 12 12 12 12 12 12 12 12 12 12 12 12 8 9 8 8 8 9 9 8 8 8 9 8 8 9 9 8 8 9 8 9 8 8 9 9 9 8 8 8 8 9 8 8 8 9 9 8 9
