1 1 1 1 1 2 3 1 1 4 2 2 3 1 1 2 1 2 1 1 1 1 1 6 2 2 2 1 2 12 12 12 12 12 12 12 12 12 12 12 12 12 12 12 12 12 12 12 12 12 12 12 12 12 12 12 12 12 12 12 12 12 12 12
1 114 114 114 2 113 113 113 113 113 113 113 113 113 1 138 138 138 1 112 112 112 112 112 112 112 112 112 2 12 12 12 12 12 12 12 12 12 12 12 12 12 12 12 12 12 12 12 12 12 12 12 12 12 12 12 12 12 12 12 12 12 12 12
1 114 114 114 1 113 113 113 113 113 113 113 113 113 1 138 138 138 90 112 112 112 112 112 112 112 112 112 1 12 12 12 12 12 12 12 12 12 12 12 12 12 12 12 12 12 12 12 12 12 12 12 12 12 12 12 12 12 12 12 12 12 12 12
1 2 6 1 1 113 113 113 113 113 113 113 113 113 2 138 138 138 2 112 112 112 112 112 112 112 112 112 1 12 12 12 12 12 12 12 12 12 12 12 12 12 12 12 12 12 12 12 12 12 12 12 12 12 12 12 12 12 12 12 12 12 12 12
1 114 114 114 1 113 113 113 113 113 113 113 113 113 1 2 1 2 1 112 112 112 112 112 112 112 112 112 1 12 12 12 12 12 12 12 12 12 12 12 12 12 12 12 12 12 12 12 12 12 12 12 12 12 12 12 12 12 12 12 12 12 12 12
4 114 114 114 90 113 113 113 113 113 113 113 113 113 2 2 1 2 1 112 112 112 112 112 112 112 112 112 2 12 12 12 12 12 12 12 12 12 12 12 12 12 12 12 12 12 12 12 12 12 12 12 12 12 12 12 12 12 12 12 12 12 12 12
1 114 114 114 1 113 113 113 113 113 113 113 113 113 2 139 139 139 1 112 112 112 112 112 112 112 112 112 1 12 12 12 12 12 12 12 12 12 12 12 12 12 12 12 12 12 12 12 12 12 12 12 12 12 12 12 12 12 12 12 12 12 12 12
1 114 114 114 1 113 113 113 113 113 113 113 113 113 90 139 139 139 2 112 112 112 112 112 112 112 112 112 2 12 12 12 12 12 12 12 12 12 12 12 12 12 12 12 12 12 12 12 12 12 12 12 12 12 12 12 12 12 12 12 12 12 12 12
2 114 114 114 1 113 113 113 113 113 113 113 113 113 2 139 139 139 1 112 112 112 112 112 112 112 112 112 1 12 12 12 12 12 12 12 12 111 111 111 12 111 111 111 12 12 12 12 12 12 12 12 12 12 12 12 12 12 12 12 12 12 12 12
1 114 114 114 1 1 2 1 2 91 2 2 1 2 2 1 1 2 1 1 2 1 2 91 2 1 2 1 2 12 12 12 12 12 12 12 12 111 111 111 111 111 111 111 12 12 12 12 12 12 12 12 12 12 11 12 12 12 12 12 12 12 12 12
1 114 114 114 114 114 114 114 114 114 114 114 114 114 114 114 114 114 114 114 114 114 114 114 114 114 114 114 114 12 111 111 111 111 12 12 12 111 111 111 111 111 111 111 12 12 12 111 111 111 111 111 111 111 111 111 111 111 111 111 111 111 111 12
1 114 114 114 114 114 114 114 114 114 114 114 114 114 114 114 114 114 114 114 114 114 114 114 114 114 114 114 114 90 111 111 111 111 12 12 10 12 12 12 11 12 12 12 10 12 12 111 111 111 111 111 111 111 111 111 111 111 111 111 111 111 111 12
2 114 114 114 114 114 114 114 114 114 114 114 114 114 114 114 114 114 114 114 114 114 114 114 114 114 114 114 114 12 111 111 111 111 111 111 111 111 111 111 111 111 111 111 111 111 111 111 111 111 111 111 111 111 111 111 111 111 111 111 111 111 111 12
1 2 6 1 1 1 1 2 2 3 1 2 1 1 2 114 114 114 12 12 12 12 12 12 12 12 91 12 12 12 12 111 111 111 111 111 111 111 111 111 111 111 111 111 111 111 111 111 111 111 12 12 12 12 91 12 12 12 12 111 111 111 111 12
1 1 1 1 1 1 1 1 1 1 1 1 1 1 1 114 114 114 12 117 117 117 12 110 110 110 110 110 110 110 12 111 111 111 111 111 111 111 111 111 111 111 111 111 111 111 111 111 111 111 12 110 110 110 110 110 110 110 12 111 111 111 111 12
1 1 1 1 1 1 1 1 1 1 1 1 1 1 1 114 114 114 12 117 117 117 12 110 110 110 110 110 110 110 12 12 12 12 12 12 12 12 12 12 12 12 12 12 12 12 12 12 12 12 12 110 110 110 110 110 110 110 12 111 111 111 111 12
1 1 1 1 1 1 1 1 1 1 1 1 1 1 1 114 114 114 12 117 117 117 12 110 110 110 110 110 110 110 110 110 110 110 110 110 110 110 110 110 110 110 110 110 110 110 110 110 110 110 110 110 110 110 110 110 110 110 12 111 111 111 111 12
1 1 1 1 1 1 1 1 1 1 1 1 1 1 2 114 114 114 12 117 117 117 90 110 110 110 110 110 110 110 110 110 110 110 110 110 110 110 110 110 110 110 110 110 110 110 110 110 110 110 110 110 110 110 110 110 110 110 90 111 111 111 111 12
1 1 1 1 1 1 1 1 1 1 1 1 1 1 1 114 114 114 12 117 117 117 12 110 110 110 110 110 110 110 110 110 110 110 110 110 110 110 110 110 110 110 110 110 110 110 110 110 110 110 110 110 110 110 110 110 110 110 12 111 111 111 111 12
1 1 1 1 1 1 1 1 1 1 1 1 1 1 3 114 114 114 12 117 117 117 12 110 110 110 110 110 110 110 12 12 12 12 12 12 12 12 12 12 91 12 12 12 12 12 12 12 12 12 12 110 110 110 110 110 110 110 12 111 111 111 111 12
1 1 1 1 1 1 1 1 1 1 1 1 1 1 1 114 114 114 12 117 117 117 12 110 110 110 110 110 110 110 12 109 109 109 109 109 109 109 12 109 109 109 12 109 109 109 109 109 109 109 12 110 110 110 110 110 110 110 12 111 111 111 111 12
1 1 1 1 1 1 1 1 1 1 1 1 1 1 2 114 114 114 12 117 117 117 12 12 12 12 91 12 12 12 12 109 109 109 109 109 109 109 12 109 109 109 12 109 109 109 109 109 109 109 12 12 12 12 91 12 12 12 12 111 111 111 111 12
1 1 1 1 1 1 1 1 1 1 1 1 1 1 2 114 114 114 12 117 117 117 117 117 117 117 117 117 117 117 12 109 109 109 109 109 109 109 109 109 109 109 109 109 109 109 109 109 109 109 12 111 111 111 111 111 111 111 111 111 111 111 111 12
1 1 1 1 1 1 1 1 1 1 1 1 1 1 1 114 114 114 12 117 117 117 117 117 117 117 117 117 117 117 12 109 109 109 109 109 109 109 12 109 109 109 12 109 109 109 109 109 109 109 12 111 111 111 111 111 111 111 111 111 111 111 111 10
1 1 1 1 1 1 1 1 1 1 1 1 1 1 1 114 114 114 12 117 117 117 117 117 117 117 117 117 117 117 12 109 109 109 109 109 109 109 12 109 109 109 12 109 109 109 109 109 109 109 12 111 111 111 111 111 111 111 111 111 111 111 111 12
2 1 2 2 3 1 1 1 2 1 1 1 1 1 2 114 114 114 12 12 12 12 12 12 12 12 12 117 117 117 90 109 109 109 109 109 109 109 109 109 109 109 109 109 109 109 109 109 109 109 90 111 111 111 2 1 1 1 2 1 1 2 1 2
2 118 118 118 118 118 118 118 12 114 114 114 114 114 114 114 114 114 114 12 118 118 118 118 118 118 12 117 117 117 12 109 109 109 109 109 109 109 12 109 109 109 12 109 109 109 109 109 109 109 12 111 111 111 1 130 130 130 130 130 130 130 130 1
3 118 118 118 118 118 118 118 90 114 114 114 114 114 114 114 114 114 114 90 118 118 118 118 118 118 12 117 117 117 12 109 109 109 109 109 109 109 12 109 109 109 12 109 109 109 109 109 109 109 12 111 111 111 1 130 130 130 130 130 130 130 130 1
2 118 118 118 118 118 118 118 12 114 114 114 114 114 114 114 114 114 114 12 118 118 118 118 118 118 12 117 117 117 90 109 109 109 109 109 109 109 109 109 109 109 109 109 109 109 109 109 109 109 90 111 111 111 2 130 130 130 130 130 130 130 130 1
1 118 118 118 12 12 12 12 12 12 12 12 12 91 12 12 12 12 12 12 12 12 12 118 118 118 12 117 117 117 12 109 109 109 109 109 109 109 12 109 109 109 12 109 109 109 109 109 109 109 12 111 111 111 90 130 130 130 130 130 130 130 130 1
1 118 118 118 12 120 120 120 12 119 119 119 119 119 119 119 119 119 12 121 121 121 12 118 118 118 12 117 117 117 12 109 109 109 109 109 109 109 12 109 109 109 12 109 109 109 109 109 109 109 12 111 111 111 1 130 130 130 130 130 130 130 130 1
1 118 118 118 10 120 120 120 90 119 119 119 119 119 119 119 119 119 90 121 121 121 10 118 118 118 12 117 117 117 90 109 109 109 109 109 109 109 109 109 109 109 109 109 109 109 109 109 109 109 90 111 111 111 2 130 130 130 130 130 130 130 130 1
2 118 118 118 12 120 120 120 12 119 119 119 119 119 119 119 119 119 12 121 121 121 12 118 118 118 12 117 117 117 12 109 109 109 109 109 109 109 12 109 109 109 12 109 109 109 109 109 109 109 12 111 111 111 1 130 130 130 130 130 130 130 130 1
2 118 118 118 12 12 12 12 12 12 12 12 12 11 12 12 12 12 12 12 12 12 12 118 118 118 12 117 117 117 12 109 109 109 109 109 109 109 12 109 109 109 12 109 109 109 109 109 109 109 12 10 93 10 2 1 2 2 1 1 2 1 2 1
1 118 118 118 118 118 118 118 118 118 118 118 118 118 118 118 118 118 118 118 118 118 118 118 118 118 12 117 117 117 90 109 109 109 109 109 109 109 109 109 109 109 109 109 109 109 109 109 109 109 12 127 127 127 3 129 129 106 129 129 2 21 1 2
3 118 118 118 118 118 118 118 118 118 118 118 118 118 118 118 118 118 118 118 118 118 118 118 118 118 12 117 117 117 12 109 109 109 109 109 109 109 12 109 109 109 12 109 109 109 109 109 109 109 12 127 127 127 90 129 129 129 129 129 100 129 21 1
1 118 118 118 118 118 118 118 118 118 118 118 118 118 118 118 118 118 118 118 118 118 118 118 118 118 12 117 117 117 12 109 109 109 109 109 109 109 12 109 109 109 12 109 109 109 109 109 109 109 12 127 127 127 3 129 129 129 129 106 1 21 1 1
1 118 118 118 12 12 12 12 12 91 12 12 12 12 12 118 118 118 12 12 12 12 12 12 12 12 12 117 117 117 12 109 109 109 109 109 109 109 12 109 109 109 12 109 109 109 109 109 109 109 12 127 127 127 1 2 3 91 3 1 2 1 1 2
1 118 118 118 12 122 122 122 122 122 122 122 122 122 12 12 91 12 12 117 117 117 117 117 117 117 117 117 117 117 90 109 109 109 109 109 109 109 109 109 109 109 109 109 109 109 109 109 109 109 12 127 127 127 127 127 127 127 127 127 127 127 127 12
2 118 118 118 12 122 122 122 122 122 122 122 122 122 12 123 123 123 12 117 117 117 117 117 117 117 117 117 117 117 12 109 109 109 109 109 109 109 12 109 109 109 12 109 109 109 109 109 109 109 12 127 127 127 127 127 127 127 127 127 127 127 127 12
1 118 118 118 12 122 122 122 122 122 122 122 122 122 12 123 123 123 12 117 117 117 117 117 117 117 117 117 117 117 12 109 109 109 109 109 109 109 12 109 109 109 12 109 109 109 109 109 109 109 12 127 127 127 127 127 127 127 127 127 127 127 127 12
1 118 118 118 10 122 122 122 122 122 122 122 122 12 12 123 123 123 12 117 117 117 12 12 12 12 12 12 12 12 12 12 12 12 12 12 12 12 12 12 91 12 12 12 12 12 12 12 12 12 12 12 12 12 12 12 12 12 12 12 127 127 127 12
2 118 118 118 90 122 122 122 122 122 122 122 122 10 12 123 123 123 12 117 117 117 12 108 108 108 108 108 108 108 108 108 108 108 108 108 108 108 108 108 108 108 108 108 108 108 108 108 108 108 108 108 108 108 108 108 108 108 12 12 127 127 127 12
2 118 118 118 10 122 122 122 122 122 122 122 122 12 12 123 123 123 12 117 117 117 12 108 108 108 108 108 108 108 108 108 108 108 108 108 108 108 108 108 108 108 108 108 108 108 108 108 108 108 108 108 108 108 108 108 108 108 12 12 127 127 127 12
2 118 118 118 12 122 122 122 122 122 122 122 122 122 12 123 123 123 12 117 117 117 12 108 108 108 108 108 108 108 108 108 108 108 108 108 108 108 108 108 108 108 108 108 108 108 108 108 108 108 108 108 108 108 108 108 108 108 12 12 127 127 127 12
1 118 118 118 12 122 122 122 122 122 122 122 122 122 12 123 123 123 12 117 117 117 12 12 108 108 108 108 108 108 12 12 10 12 12 108 108 108 108 12 13 12 108 108 108 108 12 12 10 12 12 108 108 108 108 108 108 12 12 12 127 127 127 12
1 118 118 118 12 122 122 122 122 122 122 122 122 122 12 123 123 123 12 117 117 117 12 10 108 108 108 108 108 108 11 12 12 12 11 108 108 108 12 12 12 12 12 108 108 108 11 12 12 12 11 108 108 108 108 108 108 10 12 12 127 127 127 12
1 118 118 118 12 12 12 12 12 91 12 12 12 12 12 123 123 123 12 117 117 117 12 12 108 108 108 108 108 108 12 12 10 12 12 108 108 108 108 12 10 12 108 108 108 108 12 12 10 12 12 108 108 108 108 108 108 12 12 12 127 127 127 12
2 118 118 118 118 118 118 118 118 118 118 118 118 118 12 123 123 123 12 117 117 117 12 108 108 108 108 108 108 108 108 108 108 108 108 108 108 108 108 108 108 108 108 108 108 108 108 108 108 108 108 108 108 108 108 108 108 108 12 12 127 127 127 12
3 118 118 118 118 118 118 118 118 118 118 118 118 118 12 123 123 123 12 117 117 117 12 108 108 108 108 108 108 108 108 108 108 108 108 108 108 108 108 108 108 108 108 108 108 108 108 108 108 108 108 108 108 108 108 108 108 108 12 12 127 127 127 12
1 118 118 118 118 118 118 118 118 118 118 118 118 118 12 123 123 123 12 117 117 117 12 108 108 108 108 108 108 108 108 108 108 108 108 108 108 108 108 108 108 108 108 108 108 108 108 108 108 108 108 108 108 108 108 108 108 108 12 12 127 127 127 12
2 1 2 91 1 3 2 91 2 1 1 118 118 118 12 123 123 123 12 117 117 117 12 12 12 12 12 12 12 12 12 12 12 12 12 12 12 12 12 108 108 108 12 12 12 12 12 12 12 12 12 12 12 12 12 12 12 12 12 12 127 127 127 12
2 124 124 124 124 124 124 124 124 124 1 12 91 12 12 123 123 123 12 117 117 117 117 117 117 117 117 117 117 117 117 117 117 117 117 117 117 117 12 108 108 108 12 128 128 128 128 128 128 128 128 128 128 128 128 128 128 128 12 12 127 127 127 12
1 124 124 124 124 124 124 124 124 124 2 12 125 125 12 123 123 123 12 117 117 117 117 117 117 117 117 117 117 117 117 117 117 117 117 117 117 117 90 108 108 108 90 128 128 128 128 128 128 128 128 128 128 128 128 128 128 128 10 12 127 127 127 12
3 124 124 124 124 124 124 124 124 124 3 12 125 125 12 123 123 123 12 117 117 117 117 117 117 117 117 117 117 117 117 117 117 117 117 117 117 117 12 108 108 108 12 128 128 128 128 128 128 128 128 128 128 128 128 128 128 128 12 12 127 127 127 12
1 124 124 124 124 124 124 124 124 124 1 12 12 12 12 123 123 123 12 12 12 12 12 12 12 12 12 12 12 12 12 12 12 12 12 12 12 12 12 108 108 108 12 12 12 12 12 12 12 12 12 12 12 12 12 12 12 12 12 12 127 127 127 12
1 124 124 124 124 124 124 124 124 124 1 12 12 12 12 123 123 123 12 126 126 126 126 126 126 126 126 126 126 126 126 126 12 108 108 108 108 108 108 108 108 108 108 108 108 108 108 108 10 127 127 127 127 127 127 127 127 127 127 127 127 127 127 12
1 124 124 124 124 124 124 124 124 124 2 12 12 12 12 123 123 123 90 126 126 126 126 126 126 126 126 126 126 126 126 126 90 108 108 106 108 108 108 108 108 108 108 108 108 106 108 108 92 127 127 127 127 127 127 127 127 127 127 127 127 127 127 12
2 124 124 124 124 124 124 124 124 124 1 12 12 12 12 123 123 123 12 126 126 126 126 126 126 126 126 126 126 126 126 126 12 108 108 108 108 108 108 108 108 108 108 108 108 108 108 108 10 127 127 127 127 127 127 127 127 127 127 127 127 127 127 12
1 124 124 124 124 124 124 124 124 124 1 12 12 12 12 12 12 12 12 12 12 12 12 12 12 12 12 12 12 12 12 12 12 12 12 12 12 12 12 12 12 12 12 12 12 12 12 12 12 12 12 12 12 12 12 12 12 12 12 12 12 12 12 12
2 124 124 124 124 124 124 124 124 124 1 12 12 12 12 12 12 12 12 12 12 12 12 12 12 12 12 12 12 12 12 12 12 12 12 12 12 12 12 12 12 12 12 12 12 12 12 12 12 12 12 12 12 12 12 12 12 12 12 12 12 12 12 12
3 124 124 124 124 124 124 124 124 124 3 12 12 12 12 12 12 12 12 12 12 12 12 12 12 12 12 12 12 12 12 12 12 12 12 12 12 12 12 12 12 12 12 12 12 12 12 12 12 12 12 12 12 12 12 12 12 12 12 12 12 12 12 12
1 124 124 124 124 124 124 124 124 124 2 12 12 12 12 12 12 12 12 12 12 12 12 12 12 12 12 12 12 12 12 12 12 12 12 12 12 12 12 12 12 12 12 12 12 12 12 12 12 12 12 12 12 12 12 12 12 12 12 12 12 12 12 12
1 1 3 1 2 4 1 1 3 1 1 12 12 12 12 12 12 12 12 12 12 12 12 12 12 12 12 12 12 12 12 12 12 12 12 12 12 12 12 12 12 12 12 12 12 12 12 12 12 12 12 12 12 12 12 12 12 12 12 12 12 12 12 12
