1 1 1 1 1 1 1 1 1 1 1 1 1 1 1 1 1 1 1 1 1 1 1 1 1 1 1 1 1 1 1 1 1 1 1 1 1 1 1 1 1 1 1 1 1 1 1 1 1 1 1 1 1 1 1 1 1 1 1 1 1 1 1 1
1 1 1 1 1 1 1 1 1 1 1 1 1 1 1 1 1 1 1 1 1 1 1 1 1 1 1 1 1 1 1 1 1 1 1 1 1 1 1 1 1 1 1 1 1 1 1 1 1 1 1 1 1 1 1 1 1 1 1 1 1 1 1 1
1 1 1 1 1 1 1 1 1 1 1 1 1 1 1 1 1 1 1 1 1 1 1 1 1 1 1 1 1 1 1 1 1 1 1 1 1 1 1 1 1 1 1 1 1 1 1 1 1 1 1 1 1 1 1 1 1 1 1 1 1 1 1 1
1 1 1 1 1 1 1 1 1 1 1 1 1 1 1 1 1 1 1 1 1 1 1 1 1 1 1 1 1 1 1 1 1 1 1 1 1 1 1 1 1 1 1 1 1 1 1 1 1 1 1 1 1 1 1 1 1 1 1 1 1 1 1 1
1 1 1 1 1 1 1 1 1 1 1 1 1 1 1 1 1 1 1 1 1 1 1 1 1 1 1 1 1 1 1 1 1 1 1 1 1 1 1 1 1 1 1 1 1 1 1 1 1 1 1 1 1 1 1 1 1 1 1 1 1 1 1 1
1 1 1 1 1 1 1 1 1 1 1 1 1 1 1 1 1 1 1 1 1 1 1 1 1 1 1 1 1 1 1 1 1 1 1 1 1 1 1 1 1 1 1 1 1 1 1 1 1 1 1 1 1 1 1 1 1 1 1 1 1 1 1 1
1 1 1 1 1 1 1 1 1 1 1 1 1 1 1 1 1 1 1 1 1 1 1 1 1 1 1 1 1 1 1 1 1 1 1 1 1 1 1 1 1 1 1 1 1 1 1 1 1 1 1 1 1 1 1 1 1 1 1 1 1 1 1 1
1 1 1 1 1 1 1 1 1 1 1 1 1 1 1 1 1 1 1 1 1 1 1 1 1 1 1 1 1 1 1 1 1 1 1 1 1 1 1 1 1 1 1 1 1 1 1 1 1 1 1 1 1 1 1 1 1 1 1 1 1 1 1 1
1 1 1 1 1 1 1 1 1 1 1 1 1 1 1 1 1 1 1 1 1 1 1 1 1 1 1 1 1 1 1 1 1 1 1 1 1 1 1 1 1 1 1 1 1 1 1 1 1 1 1 1 1 1 1 1 1 1 1 1 1 1 1 1
1 1 1 1 1 1 1 1 1 1 1 1 1 1 1 1 1 1 1 1 1 1 1 1 1 1 1 1 1 1 1 1 1 1 1 1 1 1 1 1 1 1 1 1 1 1 1 1 1 1 1 1 1 1 1 1 1 1 1 1 1 1 1 1
1 1 1 1 1 1 1 1 1 1 1 1 1 1 1 1 1 1 1 1 1 1 1 1 1 1 1 1 1 1 1 1 1 1 1 1 1 1 1 1 1 1 1 1 1 1 1 1 1 1 1 1 1 1 1 1 1 1 1 1 1 1 1 1
1 1 1 1 1 1 1 1 1 1 1 1 1 1 1 1 1 1 1 1 1 1 1 1 1 1 1 1 1 1 1 1 1 1 1 1 1 1 1 1 1 1 1 1 1 1 1 1 1 1 1 1 1 1 1 1 1 1 1 1 1 1 1 1
1 1 1 1 1 1 1 1 1 1 1 1 1 1 1 1 1 1 1 1 1 1 1 1 1 1 1 1 1 1 1 1 1 1 1 1 1 1 1 1 1 1 1 1 1 1 1 1 1 1 1 1 1 1 1 1 1 1 1 1 1 1 1 1
1 1 1 1 1 1 1 1 1 1 1 1 1 1 1 1 1 1 1 1 1 1 1 1 1 1 1 1 1 1 1 1 1 1 1 1 1 1 1 1 1 1 1 1 1 1 1 1 1 1 1 1 1 1 1 1 1 1 1 1 1 1 1 1
1 1 1 1 1 1 1 1 1 1 1 1 1 1 1 1 1 1 1 1 1 1 1 1 1 1 1 1 1 1 1 1 1 1 1 1 1 1 1 1 1 1 1 1 1 1 1 1 1 1 1 1 1 1 1 1 1 1 1 1 1 1 1 1
1 1 1 1 1 1 1 1 1 1 1 1 1 1 1 1 1 1 1 1 1 1 1 1 1 1 1 1 1 1 1 1 1 1 1 1 1 1 1 1 1 1 1 1 1 1 1 1 1 1 1 1 1 1 1 1 1 1 1 1 1 1 1 1
1 1 1 1 1 1 1 1 1 1 1 1 1 1 1 1 1 1 1 1 1 1 1 1 1 1 1 1 1 1 1 1 1 1 1 1 1 1 1 1 1 1 1 1 1 1 1 1 1 1 1 1 1 1 1 1 1 1 1 1 1 1 1 1
1 1 1 1 1 1 1 1 1 1 1 1 1 1 1 1 1 1 1 1 1 1 1 1 1 1 1 1 1 1 1 1 1 1 1 1 1 1 1 1 1 1 1 1 1 1 1 1 1 1 1 1 1 1 1 1 1 1 1 1 1 1 1 1
1 1 1 1 1 1 1 1 1 1 1 1 1 1 1 1 1 1 1 1 1 1 1 1 1 1 1 1 1 1 1 1 1 1 1 1 1 1 1 1 1 1 1 1 1 1 1 1 1 1 1 1 1 1 1 1 1 1 1 1 1 1 1 1
1 1 1 1 1 1 1 1 1 1 1 1 1 1 1 1 1 1 1 1 1 1 1 1 1 1 1 1 1 1 1 1 1 1 1 1 1 1 1 1 1 1 1 1 1 1 1 1 1 1 1 1 1 1 1 1 1 1 1 1 1 1 1 1
1 1 1 1 1 1 1 1 1 1 1 1 1 1 1 1 1 1 1 1 1 1 1 1 1 1 1 1 1 1 1 1 1 1 1 1 1 1 1 1 1 1 1 1 1 1 1 1 1 1 1 1 1 1 1 1 1 1 1 1 1 1 1 1
1 1 1 1 1 1 1 1 1 1 1 1 1 1 1 1 1 1 1 1 1 1 1 1 1 1 1 1 1 1 1 1 1 1 1 1 1 1 1 1 1 1 1 1 1 1 1 1 1 1 1 1 1 1 1 1 1 1 1 1 1 1 1 1
1 1 1 1 1 1 1 1 1 1 1 1 1 1 1 1 1 1 1 1 1 1 1 1 1 1 1 1 1 1 1 1 1 1 1 1 1 1 1 1 1 1 1 1 1 1 1 1 1 1 1 1 1 1 1 1 1 1 1 1 1 1 1 1
1 1 1 1 1 1 1 1 1 1 1 1 1 1 1 1 1 1 1 1 1 1 1 1 1 1 1 1 1 1 1 1 1 1 1 1 1 1 1 1 1 1 1 1 1 1 1 1 1 1 1 1 1 1 1 1 1 1 1 1 1 1 1 1
1 1 1 1 1 1 1 1 1 1 1 1 1 1 1 1 1 1 1 1 1 1 1 1 1 1 1 1 1 1 1 1 1 1 1 1 1 1 1 1 8 8 8 8 8 8 8 8 8 8 8 8 1 1 1 1 1 1 1 1 1 1 1 1
1 1 1 1 1 1 1 1 1 1 1 1 1 1 1 1 1 1 1 1 1 1 1 1 1 1 1 1 1 1 1 1 1 1 1 1 1 1 1 1 8 8 9 9 106 8 106 8 106 9 8 8 1 1 1 1 1 1 1 1 1 1 1 1
1 1 1 1 1 1 1 1 1 1 1 1 1 1 1 1 1 1 1 1 1 1 1 1 1 1 1 1 1 1 1 1 1 1 1 1 1 1 1 1 8 106 120 120 120 120 120 120 120 120 120 9 1 1 1 1 1 1 1 1 1 1 1 1
1 1 1 1 1 1 1 1 1 1 1 1 1 1 1 1 1 1 1 1 1 1 1 1 1 1 1 1 1 1 1 1 1 1 1 1 1 1 1 1 8 8 120 120 120 120 120 120 120 120 120 9 1 1 1 1 1 1 1 1 1 1 1 1
1 1 1 1 1 1 1 1 1 1 1 1 1 1 1 1 1 1 1 1 1 1 1 1 1 1 1 1 1 1 1 1 1 1 1 1 1 1 1 1 8 106 120 120 120 120 120 120 120 120 120 8 21 1 1 1 1 1 1 1 1 1 1 1
1 1 1 1 1 1 1 1 1 1 1 1 1 1 1 1 1 1 1 1 1 1 1 1 1 1 1 1 1 1 1 1 1 1 1 1 1 1 1 1 8 9 120 120 120 120 120 120 120 120 120 100 120 21 1 1 1 1 1 1 1 1 1 1
1 1 1 1 1 1 1 1 1 1 1 1 1 1 1 1 1 1 1 1 1 1 1 1 1 1 1 1 1 1 1 1 1 1 1 1 1 1 1 1 8 106 120 120 120 120 120 120 120 120 120 8 21 1 1 1 1 1 1 1 1 1 1 1
1 1 1 1 1 1 1 1 1 1 1 1 1 1 1 1 1 1 1 1 1 1 1 1 1 1 1 1 1 1 1 1 1 1 1 1 1 1 1 1 8 9 120 120 120 120 120 120 120 120 120 9 1 1 1 1 1 1 1 1 1 1 1 1
1 1 1 1 1 1 1 1 1 1 1 1 1 1 1 1 1 1 1 1 1 1 1 1 1 1 1 1 1 1 1 1 1 1 8 8 9 9 8 8 8 9 120 120 120 120 120 120 120 120 120 9 1 1 1 1 1 1 1 1 1 1 1 1
1 1 1 1 1 1 1 1 1 1 1 1 1 1 1 1 1 1 1 1 1 1 1 1 1 1 1 1 1 1 1 1 1 1 8 117 117 117 106 106 117 92 120 120 9 8 106 9 8 106 8 8 1 1 1 1 1 1 1 1 1 1 1 1
1 1 1 1 1 1 1 1 1 1 1 1 1 1 1 1 1 1 1 1 1 1 1 1 1 1 1 1 1 1 17 17 17 17 9 117 8 9 9 8 8 8 9 8 8 9 9 8 9 8 8 8 1 1 1 1 1 1 1 1 1 1 1 1
1 1 1 1 1 1 1 1 1 1 1 1 1 1 1 1 1 1 1 1 1 1 1 1 1 1 1 1 1 1 20 116 116 17 8 117 117 117 117 117 8 8 9 117 117 117 117 117 117 8 1 1 1 1 1 1 1 1 1 1 1 1 1 1
1 1 1 1 1 1 1 1 1 1 1 1 1 1 1 1 1 1 1 1 1 1 1 1 1 1 1 1 1 1 17 116 116 17 8 9 9 9 8 117 9 8 8 117 8 9 9 8 117 8 1 1 1 1 1 1 1 1 1 1 1 1 1 1
1 1 1 1 1 1 1 1 1 1 1 1 1 1 1 1 1 1 1 1 1 1 1 17 17 17 17 17 17 17 18 17 116 17 20 17 17 1 9 117 8 9 9 117 8 8 8 8 117 9 9 8 8 8 1 1 1 1 1 1 1 1 1 1
1 1 1 1 1 1 1 1 1 1 1 1 1 1 1 1 1 1 1 1 1 1 1 18 119 119 119 119 119 119 119 17 116 116 116 116 17 1 9 117 117 117 117 117 9 8 8 9 117 117 117 117 117 8 1 1 1 1 1 1 1 1 1 1
1 1 1 1 1 1 1 1 1 1 1 1 1 1 1 1 1 1 1 1 1 1 1 17 119 119 17 17 17 20 119 17 116 116 116 116 17 1 8 117 117 117 117 117 8 8 8 9 117 117 8 8 117 9 1 1 1 1 1 1 1 1 1 1
1 1 1 1 1 1 1 1 1 1 1 1 1 1 1 1 1 1 1 1 1 1 17 119 119 119 119 119 119 17 119 17 17 17 17 116 1 2 1 2 1 91 2 2 1 1 1 8 117 117 9 9 117 9 1 1 1 1 1 1 1 1 1 1
1 1 1 1 1 1 1 1 1 1 1 1 1 1 1 1 1 1 1 1 1 1 17 119 119 119 119 119 119 17 119 17 17 116 116 2 106 116 116 116 116 116 116 116 116 116 106 1 9 117 8 9 117 8 1 1 1 1 1 1 1 1 1 1
1 1 1 1 1 1 1 1 1 1 1 1 1 1 1 1 1 1 1 1 1 18 119 119 119 119 119 119 119 17 119 17 17 17 17 1 1 1 2 116 116 116 116 116 2 1 1 8 8 8 8 8 117 8 1 1 1 1 1 1 1 1 1 1
1 1 1 1 1 1 1 1 1 1 1 1 1 1 1 1 1 1 1 1 1 17 119 119 119 119 119 119 119 17 119 17 17 17 17 17 20 17 1 116 116 116 116 116 2 8 8 9 9 9 8 8 117 8 1 1 1 1 1 1 1 1 1 1
1 1 1 1 1 1 1 1 1 1 1 1 1 1 1 1 1 1 1 1 1 17 119 119 119 119 119 119 119 18 119 119 119 119 119 119 119 119 90 116 116 116 116 116 90 117 117 117 117 117 117 117 117 8 1 1 1 1 1 1 1 1 1 1
1 1 1 1 1 1 1 1 1 1 1 1 1 1 1 1 1 1 1 1 1 17 17 17 17 17 17 17 17 17 17 17 17 17 17 17 20 17 1 116 116 116 116 116 1 8 9 8 8 9 9 9 8 8 1 1 1 1 1 1 1 1 1 1
1 1 1 1 1 1 1 1 1 1 1 1 1 1 1 1 1 1 1 1 1 1 1 1 1 1 1 1 1 1 1 1 1 1 1 1 2 1 2 116 116 116 116 116 2 1 1 1 1 1 1 1 1 1 1 1 1 1 1 1 1 1 1 1
1 1 1 1 1 1 1 1 2 1 1 1 1 1 1 1 1 1 1 1 1 1 1 1 1 1 1 1 1 1 1 1 1 1 1 1 106 116 116 116 116 116 116 116 116 116 106 1 1 1 1 1 1 1 1 1 1 1 1 1 1 1 1 1
1 35 35 35 35 35 35 33 35 35 35 35 35 33 35 35 35 35 35 35 35 33 35 35 35 35 35 35 33 35 35 35 35 35 1 2 1 2 2 1 1 91 1 2 1 1 2 1 1 1 1 1 1 1 1 1 1 1 1 1 1 1 1 1
1 33 113 113 113 113 113 113 113 113 113 113 113 113 113 113 113 113 113 113 113 113 113 113 113 113 113 113 113 113 113 113 113 113 6 112 112 112 112 112 112 112 112 112 112 112 112 112 1 1 1 1 1 1 1 1 1 1 1 1 1 1 1 1
1 35 113 113 113 113 113 113 113 113 113 113 113 113 113 113 113 113 113 113 113 113 113 113 113 113 113 113 113 113 113 113 113 113 90 112 112 112 112 112 112 112 112 112 112 112 112 112 6 1 1 1 1 1 1 1 1 1 1 1 1 1 1 1
1 33 113 113 113 113 113 113 113 113 113 113 113 113 113 113 113 113 113 113 113 113 113 113 113 113 113 113 113 113 113 113 113 113 6 112 112 112 112 112 112 112 112 112 112 112 112 112 2 1 1 1 1 1 1 1 1 36 36 36 36 36 36 36
1 1 6 91 6 35 35 35 35 35 91 35 35 35 33 35 35 35 35 91 35 35 35 35 35 35 33 35 35 35 35 35 91 35 1 1 1 3 1 2 1 6 1 2 1 3 1 1 1 1 1 1 1 1 1 1 1 36 111 111 111 111 111 36
1 1 114 114 114 1 114 114 114 114 114 114 2 1 1 1 121 121 121 121 121 121 121 1 1 1 1 1 1 34 34 109 109 109 1 2 2 1 3 1 2 1 1 1 2 1 3 1 2 2 1 1 1 1 1 1 1 36 111 111 111 111 111 36
1 2 114 114 114 1 114 114 114 114 114 114 1 1 1 2 121 121 121 121 121 121 121 2 1 1 1 1 1 34 34 109 109 109 1 110 110 110 110 110 110 110 1 111 111 111 111 111 111 111 2 36 36 36 36 36 36 36 111 111 111 111 111 36
1 1 114 114 114 2 1 1 28 2 2 1 1 1 1 1 121 121 12 10 12 121 121 1 34 34 34 34 34 34 34 109 109 109 2 110 110 110 110 110 110 110 90 111 111 111 111 111 111 111 6 36 111 111 111 111 111 111 111 111 111 111 111 36
1 2 114 114 114 114 114 114 28 2 1 1 1 115 115 1 121 121 11 12 11 121 121 2 34 34 108 108 108 34 34 109 109 109 1 110 110 110 110 110 110 110 2 111 111 111 111 111 111 111 1 36 111 111 111 111 111 111 111 111 111 111 111 36
1 1 114 114 114 114 114 114 90 114 90 114 90 115 115 6 121 121 12 10 12 121 121 2 34 108 108 108 108 108 34 109 109 109 90 110 110 110 110 110 110 110 1 1 2 2 4 1 2 1 1 36 111 111 111 111 111 111 111 111 111 111 111 36
1 6 114 114 114 114 114 114 28 1 1 2 1 115 115 1 121 121 121 121 121 121 121 1 34 108 108 108 108 108 34 109 109 109 2 110 110 110 110 110 110 110 1 111 111 111 111 111 111 111 2 111 111 111 111 111 111 111 111 111 111 111 111 36
1 1 6 1 1 2 1 28 1 1 1 1 1 115 115 2 121 121 121 121 121 121 121 1 13 108 108 108 108 108 90 109 109 109 1 110 110 110 110 110 110 110 90 111 111 111 111 111 111 111 6 111 111 111 111 111 111 111 111 111 111 111 111 36
1 1 1 1 1 1 1 1 1 1 1 1 2 115 115 28 1 2 1 3 1 2 1 1 34 108 108 108 108 108 34 109 109 109 2 110 110 110 110 110 110 110 1 111 111 111 111 111 111 111 1 36 36 36 36 36 36 36 111 111 111 111 111 36
1 1 1 1 1 1 1 1 1 1 1 1 2 115 115 115 115 115 106 115 115 115 1 1 34 108 108 108 108 108 34 1 1 1 1 1 2 2 3 1 1 2 1 2 1 1 3 2 2 1 1 1 1 1 1 1 1 36 111 111 111 111 111 36
1 1 1 1 1 1 1 1 1 1 1 1 1 115 115 115 115 115 115 115 115 115 2 2 1 34 108 108 108 34 1 1 1 1 1 1 1 1 1 1 1 1 1 1 1 1 1 1 1 1 1 1 1 1 1 1 1 36 111 111 111 111 111 36
1 1 1 1 1 1 1 1 1 1 1 1 1 1 3 1 2 2 1 1 2 1 1 1 1 34 34 34 34 1 1 1 1 1 1 1 1 1 1 1 1 1 1 1 1 1 1 1 1 1 1 1 1 1 1 1 1 36 36 36 36 36 36 36
