17 17 17 17 17 17 17 17 17 17 17 17 17 17 17 17 17 17 17 17 17 17 17 17 17 17 17 17 17 17 17 17 17 17 17 17 17 17 17 17 17 17 17 17 17 17 17 17 17 17 17 17 17 17 17 17 17 17 17 17 17 17 17 17
17 17 17 17 17 17 17 17 17 17 17 17 17 17 17 17 17 17 17 17 17 17 17 17 17 17 17 17 17 17 17 17 17 17 17 17 17 17 17 17 17 17 17 17 17 17 17 17 17 17 17 17 17 17 17 17 17 17 17 17 17 17 17 17
17 17 17 17 17 17 17 17 17 17 17 17 17 17 17 17 17 17 17 17 17 17 17 17 17 17 17 17 17 17 17 17 17 17 17 17 17 17 17 17 17 17 17 17 17 17 17 17 17 17 17 17 17 17 17 17 17 17 17 17 17 17 17 17
17 17 17 17 17 17 17 17 17 17 17 17 17 17 17 17 17 17 17 17 17 17 17 17 17 17 17 17 17 17 17 17 17 17 17 17 17 17 17 17 17 17 17 17 17 17 17 17 17 17 17 17 17 17 17 17 17 17 17 17 17 17 17 17
17 17 17 17 17 17 17 17 17 17 17 17 17 17 17 17 17 17 17 17 17 17 17 17 17 17 17 17 17 17 17 17 17 17 17 17 17 17 17 17 17 17 17 17 17 17 17 17 17 17 17 17 17 17 17 17 17 17 17 17 17 17 17 17
17 17 17 17 17 17 17 17 17 17 17 17 17 17 17 17 17 17 17 17 17 17 17 17 17 17 17 17 17 17 17 17 17 17 17 17 17 17 17 17 17 17 17 17 17 17 17 17 17 17 17 17 17 17 17 17 17 17 17 17 17 17 17 17
17 17 17 17 17 17 17 17 17 17 17 17 17 17 17 17 17 17 17 17 17 17 17 17 17 17 17 17 17 17 17 17 17 17 17 17 17 17 17 17 17 17 17 17 17 17 17 17 17 17 17 17 17 17 17 17 17 17 17 17 17 17 17 17
17 17 17 17 17 17 17 17 17 17 17 17 17 17 17 17 17 17 17 17 17 17 17 17 17 17 17 17 17 17 17 17 17 17 17 17 17 17 17 17 17 17 17 17 17 17 17 17 17 17 17 17 17 17 17 17 17 17 17 17 17 17 17 17
17 17 17 17 17 17 17 17 17 17 17 17 17 17 17 17 17 17 17 17 17 17 17 17 17 17 17 17 17 17 17 17 17 17 17 17 17 17 17 17 17 17 17 17 17 17 17 17 17 17 17 17 17 17 17 17 17 17 17 17 17 17 17 17
17 17 17 17 17 17 17 17 17 17 17 17 17 17 17 17 17 17 17 17 17 17 17 17 17 17 17 17 17 17 17 17 17 17 17 17 17 17 17 17 17 17 17 17 17 17 17 17 17 17 17 17 17 17 17 17 17 17 17 17 17 17 17 17
17 17 17 17 17 17 17 17 17 17 17 17 17 17 17 17 17 17 17 17 17 17 17 17 17 17 17 17 17 17 17 17 17 17 17 17 17 17 17 17 17 17 17 17 17 17 17 17 17 17 17 17 17 17 17 17 17 17 17 17 17 17 17 17
17 17 17 17 17 17 17 17 17 17 17 17 17 17 17 17 17 17 17 17 113 113 113 113 113 113 17 17 17 17 17 17 17 17 17 17 17 17 17 17 17 17 17 17 17 17 17 17 17 17 17 17 17 17 17 17 17 17 17 17 17 17 17 17
17 17 17 17 17 17 17 17 17 17 17 17 17 17 17 17 17 17 17 17 113 17 17 17 17 113 17 17 17 17 17 17 17 17 17 17 17 17 17 17 17 17 17 17 17 17 17 17 17 17 17 17 17 17 17 17 17 17 17 17 17 17 17 17
17 17 17 17 17 17 17 17 17 17 17 17 113 113 113 113 17 17 17 17 113 17 17 17 17 113 17 17 17 17 17 17 17 17 17 17 17 17 17 17 17 17 17 17 17 17 17 17 17 17 17 17 17 17 17 17 17 17 17 17 17 17 17 17
17 17 17 17 17 17 17 113 113 113 113 113 113 17 17 113 17 17 17 17 113 17 17 17 17 113 113 113 113 113 113 113 113 17 17 17 17 17 17 17 17 17 17 17 17 17 17 17 17 17 17 17 17 17 17 17 17 17 17 17 17 17 17 17
17 17 17 17 17 17 17 113 17 17 17 17 17 17 17 113 17 17 17 17 113 17 17 17 17 17 17 17 17 17 17 17 113 17 17 17 17 17 17 17 17 17 17 17 17 17 17 17 17 17 17 17 17 17 17 17 17 17 17 17 17 17 17 17
17 17 17 17 17 17 17 113 17 17 17 17 17 17 17 113 17 17 17 17 113 113 113 113 17 17 17 17 17 17 17 17 113 17 17 17 17 17 17 17 17 17 17 17 17 17 17 17 17 17 17 17 17 17 17 17 17 17 17 17 17 17 17 17
17 17 17 17 17 17 17 113 17 113 113 113 113 17 17 113 17 17 17 17 17 17 17 113 17 17 17 17 113 113 113 113 113 17 17 17 17 17 17 17 17 17 17 17 17 17 17 17 17 17 17 17 17 17 17 17 17 17 17 17 17 17 17 17
17 17 17 17 17 17 17 113 17 113 17 17 113 17 17 113 113 113 113 113 113 113 113 113 17 17 17 17 113 17 17 17 17 17 17 17 17 17 17 17 17 17 17 17 17 17 17 17 17 17 17 17 17 17 17 17 17 17 17 17 17 17 17 17
17 17 17 17 17 113 113 113 17 113 17 17 113 17 17 17 17 17 17 17 17 17 17 17 17 17 17 17 113 17 17 40 40 40 40 40 40 40 40 40 17 17 17 17 17 17 17 17 17 17 17 17 17 17 17 17 17 17 17 17 17 17 17 17
17 17 17 17 17 113 17 17 17 113 17 17 113 17 17 17 17 17 17 17 17 17 17 17 17 17 17 17 113 17 17 40 109 109 109 109 109 109 109 40 17 17 17 17 17 17 17 17 17 17 17 17 17 17 17 17 17 17 17 17 17 17 17 17
17 17 17 17 17 113 17 17 17 113 17 17 113 17 17 17 17 17 17 17 17 17 113 113 113 113 17 17 113 17 17 40 109 40 40 40 40 40 109 40 17 17 17 17 17 17 17 17 34 34 34 34 34 34 34 34 34 34 34 17 17 17 17 17
17 17 17 17 17 113 113 113 17 113 17 17 113 113 113 113 113 113 113 113 17 17 113 17 17 113 17 17 113 17 17 40 109 40 17 17 17 40 109 40 40 40 40 40 40 17 17 17 34 114 114 114 114 114 114 114 114 114 34 17 17 17 17 17
17 17 17 17 17 17 17 113 113 113 17 17 17 17 17 17 17 17 17 113 17 17 113 17 17 113 17 17 113 17 17 17 91 17 17 17 17 40 109 109 109 109 109 109 40 17 17 17 34 114 114 114 114 114 114 114 114 114 34 17 17 17 17 17
17 17 17 17 17 17 17 17 17 17 17 17 17 17 17 17 17 17 17 113 113 113 113 17 17 113 17 17 113 17 108 108 108 108 108 17 17 40 40 40 40 40 40 109 40 17 17 17 34 114 114 114 114 114 114 114 114 114 34 34 34 21 17 17
17 17 17 17 17 17 17 17 17 17 17 17 17 17 17 17 17 17 17 17 17 17 17 17 17 113 113 17 113 18 108 108 108 108 108 17 17 40 40 40 40 40 40 109 40 17 17 17 34 114 114 114 114 114 114 114 114 114 114 114 100 114 21 17
17 17 17 17 17 17 17 17 17 17 17 17 17 17 17 17 17 17 17 17 17 17 17 17 17 17 113 17 113 90 108 108 108 108 108 13 17 40 109 109 109 109 109 109 40 17 17 17 34 114 114 114 114 114 114 114 114 114 34 34 34 21 17 17
17 17 17 17 17 17 17 17 17 17 17 17 17 17 17 17 17 17 17 17 17 17 17 17 17 17 113 17 17 18 108 108 108 108 108 17 17 40 109 40 40 40 40 40 40 40 17 17 34 114 114 114 114 114 114 114 114 114 34 17 17 17 17 17
17 17 17 17 17 17 17 17 17 17 17 17 17 17 17 17 17 17 17 17 17 17 17 17 17 17 113 17 17 17 108 108 108 108 108 17 17 40 109 109 109 109 109 109 109 40 17 17 34 114 114 114 114 114 114 114 114 114 34 17 17 17 17 17
17 17 17 17 17 17 17 35 35 35 35 35 35 39 35 35 35 35 35 39 35 35 17 17 17 17 91 17 17 17 17 17 91 17 17 17 40 40 40 40 40 40 40 40 109 40 17 17 34 114 114 114 114 114 114 114 114 114 34 17 17 17 17 17
17 17 17 17 17 17 17 35 111 111 111 111 111 111 111 111 111 111 111 111 111 35 35 35 108 108 108 108 108 17 17 17 108 17 17 40 108 108 108 108 108 40 40 40 109 40 17 17 34 34 34 34 36 93 36 34 34 34 34 17 17 17 17 17
17 17 17 17 17 17 17 35 111 35 35 35 35 35 35 35 35 39 35 35 111 35 35 49 108 108 108 108 108 17 17 17 108 18 17 36 108 108 108 108 108 36 40 40 109 40 17 17 40 40 40 40 36 110 36 40 40 17 17 17 17 17 17 17
17 17 17 17 17 17 17 35 111 39 35 35 112 112 112 112 112 35 35 35 111 111 111 90 108 108 108 108 108 90 108 108 108 108 108 90 108 108 108 108 108 90 109 109 109 40 17 17 40 110 110 110 110 110 110 110 40 17 17 17 17 17 17 17
17 17 17 17 17 17 17 35 111 35 35 35 112 112 112 112 112 35 35 35 35 39 35 49 108 108 108 108 108 17 17 18 108 17 17 36 108 108 108 108 108 36 40 40 40 40 40 40 40 110 40 40 40 40 40 110 40 17 17 17 17 17 17 17
17 17 17 17 17 17 35 35 111 35 35 35 112 112 112 112 112 35 35 35 35 35 35 35 108 108 108 108 108 17 17 17 108 17 17 40 108 108 108 108 108 40 40 40 40 110 110 110 110 110 40 40 40 40 40 110 40 17 17 17 17 17 17 17
17 17 17 17 17 17 35 111 111 35 35 35 112 112 112 112 112 35 35 35 35 35 35 35 17 17 17 17 17 17 17 17 91 17 17 40 40 40 91 40 40 40 40 40 40 110 40 40 40 40 40 40 40 40 40 110 40 17 17 17 17 17 17 17
17 17 17 17 17 17 39 111 39 35 35 35 35 35 91 35 35 35 35 35 35 35 35 35 17 17 17 17 17 35 108 108 108 108 108 17 17 40 110 110 110 110 110 110 110 110 40 40 40 40 40 40 40 40 40 110 40 17 17 17 17 17 17 17
17 17 17 17 17 17 35 111 35 35 35 35 35 49 111 49 35 39 35 35 35 35 35 35 35 35 39 35 35 49 108 108 108 108 108 17 17 40 40 40 40 40 40 40 40 40 40 40 40 110 110 110 110 110 110 110 40 17 17 17 17 17 17 17
17 17 17 17 17 17 35 111 111 111 111 111 111 111 111 111 111 111 111 111 111 111 35 35 35 111 111 111 111 90 108 108 108 108 108 17 17 17 17 17 17 17 40 40 40 40 40 40 40 110 40 40 40 40 40 40 40 17 17 17 17 17 17 17
17 17 17 17 17 17 35 35 35 35 35 39 35 35 37 35 35 35 35 35 35 111 35 35 35 111 35 39 35 49 108 108 108 108 108 17 17 17 17 17 17 17 40 110 110 110 110 40 40 110 110 110 110 110 40 17 17 17 17 17 17 17 17 17
17 17 17 17 17 17 17 17 17 17 17 17 17 17 17 17 17 17 17 17 35 111 39 35 35 111 37 35 35 35 108 108 108 108 108 17 17 17 17 17 17 17 40 110 40 40 110 40 40 40 40 40 40 110 40 17 17 17 17 17 17 17 17 17
17 17 17 17 17 17 17 17 17 17 17 35 35 35 35 35 35 35 35 35 35 111 35 35 35 111 39 35 35 35 40 36 91 36 40 17 17 17 17 40 40 40 40 110 40 40 110 40 40 40 40 40 40 110 40 17 17 17 17 17 17 17 17 17
17 17 17 17 17 17 17 17 17 17 17 35 111 111 111 111 111 111 111 111 111 111 35 35 35 111 35 35 35 35 35 40 110 40 17 17 17 17 17 40 110 110 110 110 40 40 110 40 40 40 40 40 40 110 40 17 17 17 17 17 17 17 17 17
17 17 17 17 17 17 17 17 17 17 17 35 111 35 35 39 35 35 35 35 37 35 35 35 35 111 111 111 111 111 35 40 110 40 17 17 17 17 17 40 110 40 40 40 40 40 110 110 110 110 110 110 110 110 40 17 17 17 17 17 17 17 17 17
17 17 17 17 17 17 17 17 17 17 17 35 111 35 35 35 35 35 39 35 35 35 35 35 35 35 35 35 35 111 39 40 110 40 17 17 17 17 17 40 110 40 17 17 40 40 40 40 40 40 40 40 40 40 40 17 17 17 17 17 17 17 17 17
17 17 17 17 17 17 17 17 17 17 17 35 111 35 35 35 111 111 111 111 111 35 35 35 35 35 35 35 35 111 35 40 110 40 40 40 40 40 40 40 110 40 17 17 17 17 17 17 17 17 17 17 17 17 17 17 17 17 17 17 17 17 17 17
17 17 17 17 17 17 17 17 17 17 17 37 111 35 35 35 111 35 35 35 111 39 35 35 39 35 35 35 37 111 35 40 110 110 110 110 110 110 110 110 110 40 17 17 17 17 17 17 17 17 17 17 17 17 17 17 17 17 17 17 17 17 17 17
17 17 17 17 17 17 17 17 17 17 17 35 111 39 35 35 111 35 35 35 111 35 111 111 111 111 111 35 35 111 35 40 40 40 40 40 40 40 40 40 40 40 17 17 17 17 17 17 17 17 17 17 17 17 17 17 17 17 17 17 17 17 17 17
17 17 17 17 17 17 17 17 17 17 17 35 111 111 111 111 111 35 35 39 111 35 111 35 39 35 111 35 35 111 35 17 17 17 17 17 17 17 17 17 17 17 17 17 17 17 17 17 17 17 17 17 17 17 17 17 17 17 17 17 17 17 17 17
17 17 17 17 17 17 17 17 17 17 17 35 35 35 35 35 35 35 35 35 111 35 111 35 17 35 111 35 39 111 35 17 17 17 17 17 17 17 17 17 17 17 17 17 17 17 17 17 17 17 17 17 17 17 17 17 17 17 17 17 17 17 17 17
17 17 17 17 17 17 17 17 17 17 17 17 17 17 17 17 17 17 35 111 111 35 111 35 17 35 111 39 35 111 35 17 17 17 17 17 17 17 17 17 17 17 17 17 17 17 17 17 17 17 17 17 17 17 17 17 17 17 17 17 17 17 17 17
17 17 17 17 17 17 17 17 17 17 17 17 17 17 17 17 17 17 37 111 35 35 111 39 17 35 111 35 35 111 35 17 17 17 17 17 17 17 17 17 17 17 17 17 17 17 17 17 17 17 17 17 17 17 17 17 17 17 17 17 17 17 17 17
17 17 17 17 17 17 17 17 17 17 17 17 17 17 17 17 17 17 35 111 111 111 111 35 17 35 111 111 111 111 35 17 17 17 17 17 17 17 17 17 17 17 17 17 17 17 17 17 17 17 17 17 17 17 17 17 17 17 17 17 17 17 17 17
17 17 17 17 17 17 17 17 17 17 17 17 17 17 17 17 17 17 35 35 39 35 35 35 17 35 35 37 39 35 35 17 17 17 17 17 17 17 17 17 17 17 17 17 17 17 17 17 17 17 17 17 17 17 17 17 17 17 17 17 17 17 17 17
17 17 17 17 17 17 17 17 17 17 17 17 17 17 17 17 17 17 17 17 17 17 17 17 17 17 17 17 17 17 17 17 17 17 17 17 17 17 17 17 17 17 17 17 17 17 17 17 17 17 17 17 17 17 17 17 17 17 17 17 17 17 17 17
17 17 17 17 17 17 17 17 17 17 17 17 17 17 17 17 17 17 17 17 17 17 17 17 17 17 17 17 17 17 17 17 17 17 17 17 17 17 17 17 17 17 17 17 17 17 17 17 17 17 17 17 17 17 17 17 17 17 17 17 17 17 17 17
17 17 17 17 17 17 17 17 17 17 17 17 17 17 17 17 17 17 17 17 17 17 17 17 17 17 17 17 17 17 17 17 17 17 17 17 17 17 17 17 17 17 17 17 17 17 17 17 17 17 17 17 17 17 17 17 17 17 17 17 17 17 17 17
17 17 17 17 17 17 17 17 17 17 17 17 17 17 17 17 17 17 17 17 17 17 17 17 17 17 17 17 17 17 17 17 17 17 17 17 17 17 17 17 17 17 17 17 17 17 17 17 17 17 17 17 17 17 17 17 17 17 17 17 17 17 17 17
17 17 17 17 17 17 17 17 17 17 17 17 17 17 17 17 17 17 17 17 17 17 17 17 17 17 17 17 17 17 17 17 17 17 17 17 17 17 17 17 17 17 17 17 17 17 17 17 17 17 17 17 17 17 17 17 17 17 17 17 17 17 17 17
17 17 17 17 17 17 17 17 17 17 17 17 17 17 17 17 17 17 17 17 17 17 17 17 17 17 17 17 17 17 17 17 17 17 17 17 17 17 17 17 17 17 17 17 17 17 17 17 17 17 17 17 17 17 17 17 17 17 17 17 17 17 17 17
17 17 17 17 17 17 17 17 17 17 17 17 17 17 17 17 17 17 17 17 17 17 17 17 17 17 17 17 17 17 17 17 17 17 17 17 17 17 17 17 17 17 17 17 17 17 17 17 17 17 17 17 17 17 17 17 17 17 17 17 17 17 17 17
17 17 17 17 17 17 17 17 17 17 17 17 17 17 17 17 17 17 17 17 17 17 17 17 17 17 17 17 17 17 17 17 17 17 17 17 17 17 17 17 17 17 17 17 17 17 17 17 17 17 17 17 17 17 17 17 17 17 17 17 17 17 17 17
17 17 17 17 17 17 17 17 17 17 17 17 17 17 17 17 17 17 17 17 17 17 17 17 17 17 17 17 17 17 17 17 17 17 17 17 17 17 17 17 17 17 17 17 17 17 17 17 17 17 17 17 17 17 17 17 17 17 17 17 17 17 17 17
17 17 17 17 17 17 17 17 17 17 17 17 17 17 17 17 17 17 17 17 17 17 17 17 17 17 17 17 17 17 17 17 17 17 17 17 17 17 17 17 17 17 17 17 17 17 17 17 17 17 17 17 17 17 17 17 17 17 17 17 17 17 17 17
