1 1 1 1 1 1 1 1 1 1 1 1 1 1 1 1 1 1 1 1 1 1 1 1 1 1 1 1 1 1 1 1 1 1 1 1 1 1 1 1 1 1 1 1 1 1 1 1 1 1 1 1 1 1 1 1 1 1 1 1 1 1 1 1
1 1 1 1 1 1 1 1 1 1 1 1 1 1 1 1 1 1 1 1 1 1 1 1 1 1 1 1 1 1 1 1 1 1 1 1 1 1 1 1 1 1 1 1 1 1 1 1 1 1 1 1 1 1 1 1 1 1 1 1 1 1 1 1
1 1 1 1 1 1 1 1 1 1 1 1 1 1 1 1 1 1 1 1 1 1 1 1 1 1 1 1 1 1 1 1 1 1 1 1 1 1 1 1 1 1 1 1 1 1 1 1 1 1 1 1 1 1 1 1 1 1 1 1 1 1 1 1
1 1 1 1 1 1 1 1 1 1 1 1 1 1 1 1 1 1 1 1 1 1 1 1 1 1 1 1 1 1 1 1 1 1 1 1 1 1 1 1 1 1 1 1 1 1 1 1 1 1 1 1 1 1 1 1 1 1 1 1 1 1 1 1
1 1 1 1 1 1 1 1 1 1 1 1 1 1 1 1 1 1 1 1 1 1 1 1 1 1 1 1 1 1 1 1 1 1 1 1 1 1 1 1 1 1 1 1 1 1 1 1 1 1 1 1 1 1 1 1 1 1 1 1 1 1 1 1
1 1 1 1 1 1 1 1 1 1 1 1 1 1 1 1 1 1 1 1 1 1 1 1 1 1 1 1 1 1 1 1 1 1 1 1 1 1 1 1 1 1 1 1 1 1 1 1 1 1 1 1 1 1 1 1 1 1 1 1 1 1 1 1
1 1 1 1 1 1 1 1 1 1 1 1 1 1 1 1 1 1 1 1 1 1 1 1 1 1 1 1 1 1 1 1 1 1 1 1 1 1 1 1 1 1 1 1 1 1 1 1 1 1 1 1 1 1 1 1 1 1 1 1 1 1 1 1
1 1 1 1 1 1 1 1 1 1 1 1 1 1 1 1 1 1 1 1 1 1 1 1 1 1 1 1 1 1 1 1 1 1 1 1 1 1 1 1 1 1 1 1 1 1 1 1 1 1 1 1 1 1 1 1 1 1 1 1 1 1 1 1
1 1 1 1 1 1 1 1 1 1 1 1 1 1 1 1 1 1 1 1 1 1 1 1 1 1 1 1 1 1 1 1 1 1 1 1 1 1 1 1 1 1 1 1 1 1 1 1 1 1 1 1 1 1 1 1 1 1 1 1 1 1 1 1
1 1 1 1 1 1 1 1 1 1 1 1 1 1 1 1 1 1 1 1 1 1 1 1 1 1 1 1 1 1 1 1 1 1 1 1 1 1 1 1 1 1 1 1 1 1 1 1 1 1 1 1 1 1 1 1 1 1 1 1 1 1 1 1
1 1 1 1 1 1 1 1 1 1 1 1 1 1 1 1 1 1 1 1 1 1 1 1 1 1 1 1 1 1 1 1 1 1 1 1 1 1 1 1 1 1 1 1 1 1 1 1 1 1 1 1 1 1 1 1 1 1 1 1 1 1 1 1
1 1 1 1 1 1 1 1 1 1 1 1 1 1 1 1 1 1 1 1 1 1 1 1 1 1 1 1 1 1 1 1 1 1 1 1 1 1 1 1 1 1 1 1 1 1 1 1 1 1 1 1 1 1 1 1 1 1 1 1 1 1 1 1
1 1 1 1 1 1 1 1 1 1 1 1 1 1 1 1 1 1 1 1 1 1 1 1 1 1 1 1 1 1 1 1 1 1 1 1 1 1 1 1 1 1 1 1 1 1 1 1 1 1 1 1 1 1 1 1 1 1 1 1 1 1 1 1
1 1 1 1 1 1 1 1 1 1 1 1 1 1 1 1 1 1 1 1 1 1 1 1 1 1 1 1 1 1 40 40 40 40 40 40 40 40 40 40 40 40 40 1 1 1 1 1 1 1 1 1 1 1 1 1 1 1 1 1 1 1 1 1
1 1 1 1 1 1 1 1 1 1 1 1 1 1 1 1 1 1 1 1 1 1 1 1 1 1 1 1 1 1 40 110 110 110 110 110 110 110 110 110 110 110 40 40 1 1 1 1 1 1 1 1 1 1 1 1 1 1 1 1 1 1 1 1
1 1 1 1 1 1 1 1 1 1 1 1 1 1 1 1 1 1 1 1 1 1 1 1 1 1 1 1 1 1 40 110 110 110 110 110 110 110 110 110 110 110 110 40 40 1 1 1 1 1 1 1 1 1 1 1 1 1 1 1 1 1 1 1
1 1 1 1 1 1 1 1 1 1 1 1 1 1 1 2 2 1 1 2 6 1 2 2 1 1 111 1 1 1 40 110 110 110 110 110 110 110 110 110 106 110 110 110 40 1 1 1 1 1 1 1 1 1 1 1 1 1 1 1 1 1 1 1
1 1 1 1 1 1 1 1 1 1 1 1 1 111 111 111 111 111 111 111 111 111 111 111 111 111 111 1 1 1 40 110 110 110 110 110 110 110 110 106 110 110 110 110 40 1 1 1 1 1 1 1 1 1 1 1 1 1 1 1 1 1 1 1
1 1 1 1 1 1 1 1 1 1 1 1 1 1 111 111 111 111 111 111 111 111 111 111 111 111 111 2 1 40 40 40 34 91 34 40 40 40 40 110 110 110 110 110 40 1 1 1 1 1 1 1 1 1 1 1 1 1 1 1 1 1 1 1
1 1 1 1 1 1 1 1 1 1 1 1 1 2 111 111 12 111 12 12 10 12 12 12 12 111 111 2 6 110 110 110 110 110 110 110 110 110 40 40 110 110 110 110 40 1 1 1 1 1 1 1 1 1 1 1 1 1 1 1 1 1 1 1
1 1 1 1 1 1 1 1 1 1 1 1 1 2 111 111 12 111 111 111 111 106 111 111 12 111 111 1 110 110 110 110 110 110 110 110 110 110 110 34 110 110 110 110 40 1 1 1 1 1 1 1 1 1 1 1 1 1 1 1 1 1 1 1
1 1 1 1 1 1 1 1 1 1 1 1 1 6 111 111 23 111 111 111 111 111 111 106 10 111 111 90 110 110 110 110 110 110 110 110 110 110 110 90 110 110 110 110 40 1 1 1 1 1 1 1 1 1 1 1 1 1 1 1 1 1 1 1
1 1 1 1 1 1 1 1 1 1 1 1 1 1 111 111 12 111 111 111 111 111 111 111 12 111 111 1 110 110 110 110 2 1 1 110 110 110 110 34 110 110 110 110 40 1 1 1 1 1 1 2 2 1 1 1 1 1 1 1 1 1 1 1
1 1 1 1 1 1 1 1 1 1 1 1 1 2 111 111 12 23 12 12 10 12 12 12 12 111 111 2 110 110 110 110 3 1 3 110 110 110 110 40 110 110 110 110 40 1 1 1 1 1 113 113 113 113 113 1 1 1 1 1 1 1 1 1
1 1 1 1 1 1 1 1 1 1 1 1 1 1 111 111 111 111 111 111 111 111 111 111 111 111 111 1 6 110 110 110 1 1 2 110 110 110 6 40 110 110 110 110 40 1 1 1 1 2 113 113 113 113 113 2 1 1 1 1 1 1 1 1
1 1 1 1 1 1 1 1 1 1 1 1 1 111 111 111 111 111 111 111 111 111 111 111 111 111 111 1 2 1 91 1 2 2 1 1 91 2 1 1 40 40 40 40 40 1 1 1 1 2 113 113 113 113 113 1 1 1 1 1 1 1 1 1
1 1 1 1 1 1 1 1 1 1 1 1 1 1 2 1 2 2 1 1 6 1 2 2 1 1 111 1 108 108 108 108 108 108 108 108 108 108 108 1 115 1 2 4 1 1 1 1 2 1 2 113 113 113 113 1 1 1 1 1 1 1 1 1
1 1 1 1 1 1 1 1 1 1 1 1 1 1 1 1 1 1 1 1 1 1 1 1 1 1 1 1 108 108 108 108 108 108 108 108 108 108 108 1 115 2 113 113 113 1 2 2 113 1 1 113 1 1 2 1 1 1 1 1 1 1 1 1
1 1 1 1 1 1 1 1 1 1 1 1 1 1 1 1 1 1 1 1 1 1 1 1 1 1 1 1 2 2 1 6 108 108 108 6 2 1 1 2 115 1 113 113 113 3 113 113 113 113 2 113 2 1 1 1 1 1 1 1 1 1 1 1
1 17 17 17 17 17 17 17 1 1 17 17 18 17 17 17 17 18 17 17 1 1 1 1 1 1 1 1 1 1 1 1 2 108 2 1 1 2 115 115 115 3 113 113 113 90 113 113 113 113 4 113 113 1 1 1 1 1 1 1 1 1 1 1
1 17 116 116 116 116 116 17 1 1 17 116 116 116 116 116 116 116 116 17 1 1 1 1 1 1 1 1 1 1 1 1 1 108 1 1 1 1 115 2 1 1 113 113 113 3 113 113 113 113 2 1 1 1 1 1 1 1 1 1 1 1 1 1
17 17 116 116 106 116 116 17 1 17 17 116 116 116 116 116 116 116 116 17 17 1 1 1 1 1 1 1 1 1 4 13 1 108 1 4 1 4 115 115 115 90 113 113 113 1 1 2 113 1 1 1 1 1 1 1 1 1 1 1 1 1 1 1
17 116 116 116 116 116 116 17 1 17 116 116 116 116 116 116 116 116 116 116 17 1 1 1 1 1 1 2 108 108 108 108 108 108 108 108 108 1 1 2 1 1 113 113 113 2 35 35 39 35 35 35 49 35 35 39 35 35 35 1 1 1 1 1
17 116 116 116 116 116 17 17 1 17 116 116 116 116 116 116 116 116 116 116 17 1 1 1 1 1 1 108 108 108 108 108 108 108 108 108 108 108 1 1 2 1 2 91 1 1 35 114 114 114 114 114 114 114 114 114 114 114 37 1 1 1 1 1
17 116 116 116 116 116 17 17 17 20 116 116 116 116 116 116 116 116 116 116 116 28 28 28 28 28 28 108 108 108 108 108 108 108 108 108 108 108 3 112 112 112 112 112 112 112 35 114 114 114 114 114 114 114 114 114 114 114 35 1 1 1 1 1
18 116 116 116 116 116 116 116 116 116 116 116 116 116 116 116 116 116 116 116 116 116 116 116 116 116 90 108 108 108 14 15 15 15 14 108 108 108 90 112 112 112 112 112 112 112 90 114 114 114 35 35 35 35 39 114 114 114 35 1 1 1 1 1
17 116 116 116 116 116 17 17 17 20 116 116 116 116 116 116 116 116 116 116 116 28 28 28 28 28 28 108 108 108 15 15 15 15 15 108 108 108 3 112 112 112 112 112 112 112 35 114 114 114 33 114 114 114 114 114 114 114 49 1 1 1 1 1
17 116 116 116 116 116 17 17 1 17 116 116 116 116 116 116 116 116 116 116 17 1 1 1 1 1 1 108 108 108 14 15 15 15 14 108 108 108 1 2 2 1 3 2 1 1 39 114 114 114 35 35 39 35 35 114 114 114 35 1 1 1 1 1
17 116 116 116 116 116 116 17 1 17 116 116 116 116 116 116 116 116 116 116 17 1 1 1 1 1 2 108 108 108 108 108 108 108 108 108 108 108 1 1 1 1 1 1 1 1 37 114 114 114 114 114 114 114 114 114 114 114 39 1 1 1 1 1
17 17 116 116 106 116 116 17 1 17 17 116 116 116 116 116 116 116 116 17 17 1 1 1 1 1 2 108 108 108 108 108 108 108 108 108 108 108 2 1 1 1 1 1 1 1 35 114 114 114 114 114 114 114 114 114 114 114 35 1 1 1 1 1
1 17 116 116 116 116 116 17 1 1 17 116 116 116 116 116 116 116 116 17 1 1 1 1 1 1 1 1 108 108 108 108 108 108 108 108 108 1 1 1 1 1 1 1 1 1 35 35 35 39 35 35 49 35 39 35 35 35 35 1 1 1 1 1
1 17 17 17 17 17 17 17 1 1 17 17 18 17 17 17 17 18 17 17 1 1 1 1 1 1 1 6 1 2 2 1 93 1 2 1 1 6 1 1 1 1 1 1 1 1 1 1 35 114 114 114 114 114 114 35 1 1 1 1 1 1 1 1
1 1 1 1 1 1 1 1 1 1 1 1 1 1 1 1 1 1 1 1 1 1 1 1 1 1 6 109 109 109 109 109 109 109 109 109 109 109 6 1 1 1 1 1 1 1 1 1 35 114 114 114 114 114 114 35 1 1 1 1 1 1 1 1
1 1 1 1 1 1 1 1 1 1 1 1 1 1 1 1 1 1 1 1 1 1 1 1 1 1 2 109 109 109 109 109 109 109 109 109 109 109 1 1 1 1 1 1 1 1 1 1 33 114 114 114 114 114 114 33 1 1 1 1 1 1 1 1
1 1 1 1 1 1 1 1 1 1 1 1 1 1 1 1 1 1 1 1 1 1 1 1 1 1 1 109 109 15 15 14 91 14 15 15 109 109 2 1 1 1 1 1 1 1 1 1 35 114 114 114 114 114 114 35 1 1 1 1 1 1 1 1
1 1 1 1 1 1 1 1 1 1 1 1 1 1 1 1 1 1 1 1 1 1 1 1 1 1 2 109 109 15 109 109 109 109 109 15 109 109 2 1 1 1 1 1 1 1 1 1 39 114 114 114 114 114 114 35 1 1 1 1 1 1 1 1
1 1 1 1 1 1 1 1 1 1 1 1 1 1 1 1 1 1 1 1 1 1 1 1 1 1 2 109 109 15 109 109 109 109 109 15 109 109 1 1 1 1 1 1 1 1 1 1 35 35 35 37 39 35 35 35 1 1 1 1 1 1 1 1
1 1 1 1 1 1 1 1 1 1 1 1 1 1 1 1 1 1 1 1 1 1 1 1 1 1 2 109 109 15 15 15 14 15 15 15 109 109 2 1 1 1 1 1 1 1 1 1 1 1 1 1 1 1 1 1 1 1 1 1 1 1 1 1
1 1 1 1 1 1 1 1 1 1 1 1 1 1 1 1 1 1 1 1 1 1 1 1 1 1 1 109 109 14 109 109 109 109 109 14 109 109 1 1 1 1 1 1 1 1 1 1 1 1 1 1 1 1 1 1 1 1 1 1 1 1 1 1
1 1 1 1 1 1 1 1 1 1 1 1 1 1 1 1 1 1 1 1 1 1 1 1 1 1 109 109 109 90 109 109 109 109 109 90 109 109 109 1 1 1 1 1 1 1 1 1 1 1 1 1 1 1 1 1 1 1 1 1 1 1 1 1
1 1 1 1 1 1 1 1 1 1 1 1 1 1 1 1 1 1 1 1 1 1 1 1 1 1 1 2 2 1 109 109 109 109 109 1 2 1 1 1 1 1 1 1 1 1 1 1 1 1 1 1 1 1 1 1 1 1 1 1 1 1 1 1
1 1 1 1 1 1 1 1 1 1 1 1 1 1 1 1 1 1 1 1 1 1 1 1 1 1 1 109 109 109 109 109 109 109 109 109 109 106 6 21 1 1 1 1 1 1 1 1 1 1 1 1 1 1 1 1 1 1 1 1 1 1 1 1
1 1 1 1 1 1 1 1 1 1 1 1 1 1 1 1 1 1 1 1 1 1 1 1 1 1 2 109 109 109 109 109 109 109 109 109 109 109 100 109 21 1 1 1 1 1 1 1 1 1 1 1 1 1 1 1 1 1 1 1 1 1 1 1
1 1 1 1 1 1 1 1 1 1 1 1 1 1 1 1 1 1 1 1 1 1 1 1 1 1 1 109 109 109 109 109 109 109 109 109 109 106 6 21 1 1 1 1 1 1 1 1 1 1 1 1 1 1 1 1 1 1 1 1 1 1 1 1
1 1 1 1 1 1 1 1 1 1 1 1 1 1 1 1 1 1 1 1 1 1 1 1 1 1 1 1 2 1 2 1 4 2 2 2 1 1 1 1 1 1 1 1 1 1 1 1 1 1 1 1 1 1 1 1 1 1 1 1 1 1 1 1
1 1 1 1 1 1 1 1 1 1 1 1 1 1 1 1 1 1 1 1 1 1 1 1 1 1 1 1 1 1 1 1 1 1 1 1 1 1 1 1 1 1 1 1 1 1 1 1 1 1 1 1 1 1 1 1 1 1 1 1 1 1 1 1
1 1 1 1 1 1 1 1 1 1 1 1 1 1 1 1 1 1 1 1 1 1 1 1 1 1 1 1 1 1 1 1 1 1 1 1 1 1 1 1 1 1 1 1 1 1 1 1 1 1 1 1 1 1 1 1 1 1 1 1 1 1 1 1
1 1 1 1 1 1 1 1 1 1 1 1 1 1 1 1 1 1 1 1 1 1 1 1 1 1 1 1 1 1 1 1 1 1 1 1 1 1 1 1 1 1 1 1 1 1 1 1 1 1 1 1 1 1 1 1 1 1 1 1 1 1 1 1
1 1 1 1 1 1 1 1 1 1 1 1 1 1 1 1 1 1 1 1 1 1 1 1 1 1 1 1 1 1 1 1 1 1 1 1 1 1 1 1 1 1 1 1 1 1 1 1 1 1 1 1 1 1 1 1 1 1 1 1 1 1 1 1
1 1 1 1 1 1 1 1 1 1 1 1 1 1 1 1 1 1 1 1 1 1 1 1 1 1 1 1 1 1 1 1 1 1 1 1 1 1 1 1 1 1 1 1 1 1 1 1 1 1 1 1 1 1 1 1 1 1 1 1 1 1 1 1
1 1 1 1 1 1 1 1 1 1 1 1 1 1 1 1 1 1 1 1 1 1 1 1 1 1 1 1 1 1 1 1 1 1 1 1 1 1 1 1 1 1 1 1 1 1 1 1 1 1 1 1 1 1 1 1 1 1 1 1 1 1 1 1
1 1 1 1 1 1 1 1 1 1 1 1 1 1 1 1 1 1 1 1 1 1 1 1 1 1 1 1 1 1 1 1 1 1 1 1 1 1 1 1 1 1 1 1 1 1 1 1 1 1 1 1 1 1 1 1 1 1 1 1 1 1 1 1
1 1 1 1 1 1 1 1 1 1 1 1 1 1 1 1 1 1 1 1 1 1 1 1 1 1 1 1 1 1 1 1 1 1 1 1 1 1 1 1 1 1 1 1 1 1 1 1 1 1 1 1 1 1 1 1 1 1 1 1 1 1 1 1
1 1 1 1 1 1 1 1 1 1 1 1 1 1 1 1 1 1 1 1 1 1 1 1 1 1 1 1 1 1 1 1 1 1 1 1 1 1 1 1 1 1 1 1 1 1 1 1 1 1 1 1 1 1 1 1 1 1 1 1 1 1 1 1
