1 1 1 1 1 1 1 1 1 1 1 1 1 1 1 1 1 1 1 1 1 1 1 1 1 1 1 1 1 1 1 1 1 1 1 1 1 1 1 1 1 1 1 1 1 1 1 1 1 1 1 1 1 1 1 1 1 1 1 1 1 1 1 1
1 1 1 1 1 1 1 1 1 1 1 1 1 1 1 1 1 1 1 1 1 1 1 1 1 1 1 1 1 1 1 1 1 1 1 1 1 1 1 1 1 1 1 1 1 1 1 1 1 1 1 1 1 1 1 1 1 1 1 1 1 1 1 1
1 1 1 1 1 1 1 1 1 1 1 1 1 1 1 1 1 1 1 1 1 1 1 1 1 1 1 1 1 1 1 1 1 1 1 1 1 1 1 1 1 1 1 1 1 1 1 1 1 1 1 1 1 1 1 1 1 1 1 1 1 1 1 1
1 1 1 1 1 1 1 1 1 1 1 1 1 1 1 1 1 1 1 1 1 1 1 1 1 1 1 1 1 1 1 1 1 1 1 1 1 1 1 1 1 1 1 1 1 1 1 1 1 1 1 1 1 1 1 1 1 1 1 1 1 1 1 1
1 1 1 1 1 1 1 1 1 1 1 1 1 1 1 1 1 1 1 1 1 1 1 1 1 1 1 1 1 1 1 1 1 1 1 1 1 1 1 1 1 1 1 1 1 1 1 1 1 1 1 1 1 1 1 1 1 1 1 1 1 1 1 1
1 1 1 1 1 1 1 1 1 1 1 1 1 1 1 1 1 1 1 1 1 1 1 1 1 1 1 1 1 1 1 1 1 1 1 1 1 1 1 1 1 1 1 1 1 1 1 1 1 1 1 1 1 1 1 1 1 1 1 1 1 1 1 1
1 1 1 1 1 1 1 1 1 1 1 1 1 1 1 1 1 1 1 1 1 1 1 1 1 1 1 1 1 1 1 1 1 1 1 1 1 1 1 1 1 1 1 1 1 1 1 1 1 1 1 1 1 1 1 1 1 1 1 1 1 1 1 1
1 1 1 1 1 1 1 1 1 1 1 1 1 1 1 1 1 1 1 1 1 1 1 1 1 1 1 1 1 1 1 1 1 1 1 1 1 1 1 1 1 1 1 1 1 1 1 1 1 1 1 1 1 1 1 1 1 1 1 1 1 1 1 1
1 1 1 1 1 1 1 1 1 1 1 1 1 1 1 1 1 1 1 1 1 1 1 1 1 1 1 1 1 1 1 1 1 1 1 1 1 1 1 1 17 18 17 17 17 17 17 17 1 1 1 1 1 1 1 1 1 1 1 1 1 1 1 1
1 1 1 1 1 1 1 1 1 1 1 1 1 1 1 1 1 1 1 1 1 1 1 1 1 1 1 1 1 1 1 1 1 1 1 1 1 1 1 1 18 115 115 115 115 115 115 17 1 1 1 1 1 1 1 1 1 1 1 1 1 1 1 1
1 1 1 1 1 1 1 1 1 1 1 1 1 1 1 1 1 1 1 1 1 1 1 1 1 1 1 1 1 1 1 1 1 1 1 1 1 1 1 1 17 115 115 115 115 115 115 20 21 1 1 1 1 1 1 1 1 1 1 1 1 1 1 1
1 1 1 1 1 1 1 1 1 1 1 1 1 1 1 1 1 1 1 1 1 1 1 1 1 1 1 1 1 1 1 1 1 1 1 1 1 1 1 1 17 115 115 115 115 115 115 100 115 21 1 1 1 1 1 1 1 1 1 1 1 1 1 1
1 1 1 1 1 1 1 1 1 1 1 1 1 1 1 1 1 1 1 1 1 1 1 1 1 1 1 1 1 1 1 1 1 1 1 1 1 1 1 1 17 115 115 115 115 115 106 20 21 1 1 1 1 1 1 1 1 1 1 1 1 1 1 1
1 1 1 1 1 1 1 1 1 1 1 1 1 1 1 1 1 1 1 1 1 1 1 1 1 1 1 1 1 1 1 1 1 1 1 1 1 1 1 1 17 115 115 115 115 115 106 17 1 1 1 1 1 1 1 1 1 1 1 1 1 1 1 1
1 1 1 1 1 1 1 1 1 1 1 1 1 1 1 1 1 1 1 1 1 1 1 1 1 1 1 1 1 1 1 1 1 1 1 1 1 1 1 1 17 115 115 115 18 17 17 17 1 1 1 1 1 1 1 1 1 1 1 1 1 1 1 1
1 1 1 1 1 1 1 1 1 1 1 1 1 1 2 1 2 6 2 2 1 1 1 1 1 1 1 1 1 1 1 1 1 1 1 1 1 1 1 1 17 115 115 115 17 1 1 1 1 1 1 1 1 1 1 1 1 1 1 1 1 1 1 1
1 1 1 1 1 1 1 1 1 1 1 1 1 2 113 113 113 113 113 113 113 1 1 1 1 1 1 1 1 1 1 1 17 17 18 17 17 17 17 17 17 115 115 115 17 1 1 1 1 1 1 1 1 1 1 1 1 1 1 1 1 1 1 1
1 1 1 1 1 1 1 1 1 1 1 1 1 3 113 113 113 113 113 113 113 3 1 1 1 1 1 1 1 1 1 17 17 115 115 115 115 115 115 115 115 115 115 115 17 1 1 1 1 1 1 1 1 1 1 1 1 1 1 1 1 1 1 1
1 1 1 1 1 1 1 1 1 1 1 1 1 2 113 113 2 1 4 113 113 2 1 1 1 1 1 1 1 1 17 17 115 115 115 115 115 115 115 115 115 115 115 115 17 1 1 1 1 1 1 1 1 1 1 1 1 1 1 1 1 1 1 1
1 1 1 1 1 1 1 1 1 1 1 1 1 1 113 113 2 1 1 113 113 2 1 1 1 1 1 1 1 1 17 115 115 115 115 115 115 115 115 115 115 115 115 115 17 1 1 1 1 1 1 1 1 1 1 1 1 1 1 1 1 1 1 1
1 1 1 1 1 1 1 1 1 1 6 2 1 2 113 113 6 1 2 113 113 1 2 2 4 2 2 2 1 1 18 115 115 115 18 17 17 17 17 17 17 17 17 17 17 1 1 1 1 1 1 1 1 1 1 1 1 1 1 1 1 1 1 1
1 1 1 1 1 1 1 1 1 6 113 113 113 113 113 113 113 113 113 113 113 113 113 113 113 113 113 113 1 1 17 115 115 115 17 1 1 1 1 1 1 1 1 1 1 1 1 1 1 1 1 1 1 1 1 1 1 1 1 1 1 1 1 1
1 1 1 1 1 1 2 3 1 2 113 113 113 113 113 113 113 113 113 113 113 113 113 113 113 113 113 113 2 1 17 115 115 115 17 1 1 1 1 1 1 1 1 1 1 1 1 1 1 1 1 1 1 1 1 1 1 1 1 1 1 1 1 1
1 1 1 1 2 113 113 113 113 113 113 2 1 4 2 2 2 1 2 1 2 113 113 2 2 6 113 113 3 1 17 115 115 115 17 1 1 1 1 1 1 1 1 1 1 1 1 1 1 1 1 1 1 1 1 1 1 1 1 1 1 1 1 1
1 1 1 1 2 113 113 113 113 113 113 2 1 1 1 1 1 1 1 1 3 113 113 1 1 1 113 113 2 1 17 17 115 17 17 12 12 12 11 12 12 12 12 1 1 1 1 1 1 1 1 1 1 1 1 1 1 1 1 1 1 1 1 1
1 1 1 1 1 113 113 1 2 1 113 1 1 1 2 2 4 1 1 2 1 113 113 6 2 1 113 113 2 12 12 12 93 12 12 12 114 114 114 114 114 114 12 1 1 1 1 1 1 1 1 1 1 1 1 1 1 1 1 1 1 1 1 1
1 1 1 1 1 113 113 1 1 2 113 113 113 113 113 113 113 113 113 113 113 113 113 113 113 113 113 113 1 12 108 108 108 108 108 90 114 114 114 114 114 114 12 12 12 1 1 1 1 1 1 1 1 1 1 1 1 1 1 1 1 1 1 1
1 1 1 1 2 113 113 2 1 6 113 113 113 113 113 113 113 113 113 113 113 113 113 113 113 113 113 113 1 12 108 108 108 108 108 12 12 10 114 114 114 114 114 114 12 1 1 1 1 1 1 1 1 1 1 1 1 1 1 1 1 1 1 1
1 1 1 1 4 113 113 1 1 1 6 2 1 2 113 113 1 2 1 1 113 113 1 2 3 2 1 2 1 12 108 108 108 108 108 12 12 12 12 12 114 114 114 114 12 1 1 1 1 1 1 1 1 1 1 1 1 1 1 1 1 1 1 1
1 1 1 1 2 113 113 2 1 1 1 1 1 1 113 113 1 1 1 2 113 113 2 1 12 12 10 12 12 108 108 108 108 108 108 108 12 12 12 12 12 114 114 114 11 12 12 12 12 12 1 1 1 1 1 1 1 1 1 1 1 1 1 1
1 1 1 1 1 113 113 3 1 1 1 1 1 3 113 113 2 1 1 3 113 113 6 4 12 108 108 108 108 108 108 108 108 108 108 108 108 108 108 108 90 114 114 114 12 109 109 109 109 12 1 1 1 1 1 1 1 1 1 1 1 1 1 1
1 1 1 1 2 113 113 1 1 1 1 1 1 2 113 113 4 1 1 2 113 113 113 113 12 108 108 108 108 108 108 15 15 15 108 108 108 108 108 108 12 12 10 12 12 109 109 109 109 12 1 1 1 1 1 1 1 1 1 1 1 1 1 1
1 1 1 1 2 113 113 1 1 1 1 1 1 2 113 113 1 1 1 2 113 113 113 113 94 108 108 108 108 108 108 15 13 15 108 108 108 108 108 108 12 109 109 109 109 109 109 12 12 12 1 1 1 1 1 1 1 1 1 1 1 1 1 1
1 1 1 1 1 113 113 1 2 2 6 1 2 1 113 113 1 2 2 1 113 113 113 113 12 108 108 108 108 108 108 15 108 15 108 108 108 108 108 108 12 109 109 109 109 109 109 109 109 11 1 1 1 1 1 1 1 1 1 1 1 1 1 1
1 1 2 2 3 113 113 113 113 113 113 113 113 113 113 113 113 113 113 113 113 113 6 4 12 108 108 108 108 108 108 108 108 108 108 108 108 108 108 108 90 109 109 109 109 109 109 12 12 12 1 1 1 1 1 1 1 1 1 1 1 1 1 1
1 1 113 113 1 113 113 113 113 113 113 113 113 113 113 113 113 113 113 113 113 113 1 1 12 12 12 10 12 108 108 108 108 108 108 108 12 12 10 12 12 109 109 109 109 109 109 12 1 1 1 1 1 1 1 1 1 1 1 1 1 1 1 1
1 2 113 113 113 1 1 2 2 1 4 2 1 1 2 2 2 3 1 1 1 1 9 9 9 9 8 12 12 12 108 108 108 108 108 12 12 12 12 12 12 109 109 109 109 109 109 10 1 1 1 1 1 1 1 1 1 1 1 1 1 1 1 1
1 2 113 113 113 1 2 2 2 1 2 1 1 1 1 1 1 8 8 9 8 9 112 112 112 112 8 12 12 12 108 108 108 108 108 11 12 12 12 109 109 109 109 109 109 109 109 12 1 1 1 1 1 1 1 1 1 1 1 1 1 1 1 1
1 2 113 113 113 113 113 113 113 113 113 113 113 113 2 1 1 8 112 112 112 112 112 112 112 112 9 8 8 12 108 108 108 108 108 12 12 106 12 109 109 109 109 109 109 109 109 12 12 12 1 1 1 1 1 1 1 1 1 1 1 1 1 1
1 3 113 113 113 113 113 113 113 113 113 113 113 113 3 1 1 9 112 112 112 112 112 112 112 112 112 112 8 12 108 12 10 12 91 12 12 110 10 109 109 109 109 109 109 109 109 109 109 11 1 1 1 1 1 1 1 1 1 1 1 1 1 1
1 1 113 113 113 113 113 113 113 113 113 113 113 113 2 1 1 5 112 112 112 9 8 9 8 112 112 112 9 12 108 12 12 110 110 110 110 110 12 109 109 109 109 109 109 109 109 12 12 12 12 12 1 1 1 1 1 1 1 1 1 1 1 1
1 2 113 113 113 113 113 113 113 113 113 113 113 113 1 1 1 9 112 112 112 8 112 112 9 112 112 112 8 12 91 12 10 110 110 110 110 110 12 109 109 109 109 109 109 109 109 12 110 110 110 12 1 1 1 1 1 1 1 1 1 1 1 1
1 2 113 113 113 113 113 113 113 113 113 113 113 113 2 1 1 8 112 112 112 8 112 112 9 112 112 112 9 8 112 9 12 110 110 110 110 110 12 10 12 12 12 12 10 12 12 12 110 12 110 12 1 1 1 1 1 1 1 1 1 1 1 1
1 1 113 113 113 113 113 113 113 113 113 113 113 113 2 1 1 9 112 112 112 9 112 112 8 9 112 112 112 112 112 9 12 110 110 110 110 110 110 110 110 110 110 110 110 110 110 110 110 12 110 12 1 1 1 1 1 1 1 1 1 1 1 1
1 2 113 113 113 113 113 113 113 113 113 113 113 113 1 1 1 8 112 112 112 8 112 112 8 8 112 112 112 112 112 9 12 110 110 110 110 110 110 110 110 110 110 110 110 110 110 110 110 10 110 12 1 1 1 1 1 1 1 1 1 1 1 1
1 1 113 113 113 113 113 113 113 113 113 113 113 113 2 1 1 8 112 112 112 9 112 112 8 9 112 112 112 112 112 9 11 110 110 12 10 12 12 110 110 110 12 12 12 12 110 110 110 12 91 12 12 11 12 12 12 12 12 12 1 1 1 1
1 3 113 113 113 113 113 113 113 113 113 113 113 113 3 1 1 5 112 112 112 8 9 9 8 8 112 112 112 112 112 8 12 110 110 12 12 12 12 110 110 110 10 12 12 12 110 110 110 12 111 111 111 111 111 111 111 111 111 12 1 1 1 1
1 1 113 113 113 113 113 113 113 113 113 113 113 113 1 1 1 9 112 112 112 112 112 112 112 112 112 112 112 112 112 9 12 110 110 12 12 12 12 110 110 110 12 12 12 10 110 110 110 11 12 12 10 12 111 12 12 12 111 12 1 1 1 1
1 2 113 113 113 113 113 113 113 113 113 113 113 113 2 1 1 8 8 112 112 112 112 112 112 112 112 112 112 112 112 8 12 110 110 12 12 10 12 110 110 110 12 12 12 12 110 110 110 12 10 12 12 12 111 12 12 12 111 12 1 1 1 1
1 1 1 1 2 1 1 2 3 1 2 2 2 1 2 1 1 8 8 9 112 112 112 112 8 9 7 8 9 7 8 9 12 110 110 110 110 110 110 110 110 110 110 110 110 110 110 110 110 110 110 90 111 111 111 111 111 111 111 10 1 1 1 1
1 2 113 113 113 113 113 113 113 113 113 113 113 113 1 1 1 1 1 8 112 112 112 112 8 1 1 1 1 1 1 1 12 110 110 110 110 110 110 110 110 110 110 110 110 110 110 110 110 110 110 12 10 12 111 12 10 12 111 12 1 1 1 1
1 1 113 113 113 113 113 113 113 113 113 113 113 113 2 21 1 1 1 8 112 112 112 112 8 1 1 1 1 1 1 1 12 12 11 12 12 12 12 12 10 110 12 12 11 12 12 12 10 12 91 12 12 11 111 12 12 11 111 12 1 1 1 1
1 1 113 113 113 113 113 113 113 113 113 113 113 113 100 107 21 1 1 8 8 9 8 9 8 1 1 1 1 1 1 1 1 1 1 1 1 1 1 1 12 110 12 12 12 12 12 111 111 111 111 12 12 12 111 12 12 12 111 12 1 1 1 1
1 3 113 113 113 113 113 113 113 113 113 113 113 113 3 21 1 1 1 1 1 1 1 1 1 1 1 1 1 1 1 1 1 1 1 1 1 1 1 1 12 110 110 110 110 110 90 111 12 12 10 12 111 111 111 111 111 111 111 12 1 1 1 1
1 2 113 113 113 113 113 113 113 113 113 113 113 113 1 1 1 1 1 1 1 1 1 1 1 1 1 1 1 1 1 1 1 1 1 1 1 1 1 1 11 110 10 12 12 12 12 111 111 111 111 111 111 111 111 111 111 111 111 12 1 1 1 1
1 1 113 113 113 113 113 113 113 113 113 113 113 113 2 1 1 1 1 1 1 1 1 1 1 1 1 1 1 1 1 1 1 1 1 1 1 1 1 1 12 110 12 12 12 12 12 12 10 12 111 111 111 111 111 111 111 111 111 10 1 1 1 1
1 1 1 3 2 1 1 2 1 1 2 2 3 2 1 1 1 1 1 1 1 1 1 1 1 1 1 1 1 1 1 1 1 1 1 1 1 1 1 1 12 110 110 110 110 110 110 110 110 90 111 111 111 111 111 111 111 111 111 12 1 1 1 1
1 1 1 1 1 1 1 1 1 1 1 1 1 1 1 1 1 1 1 1 1 1 1 1 1 1 1 1 1 1 1 1 1 1 1 1 1 1 1 1 10 110 12 12 12 12 10 12 12 12 111 111 111 111 111 111 111 111 111 12 1 1 1 1
1 1 1 1 1 1 1 1 1 1 1 1 1 1 1 1 1 1 1 1 1 1 1 1 1 1 1 1 1 1 1 1 1 1 1 1 1 1 1 1 12 110 110 110 110 110 110 110 110 90 111 111 111 111 111 111 111 111 111 12 1 1 1 1
1 1 1 1 1 1 1 1 1 1 1 1 1 1 1 1 1 1 1 1 1 1 1 1 1 1 1 1 1 1 1 1 1 1 1 1 1 1 1 1 12 12 12 12 11 12 12 12 12 10 111 111 111 111 111 111 111 111 111 12 1 1 1 1
1 1 1 1 1 1 1 1 1 1 1 1 1 1 1 1 1 1 1 1 1 1 1 1 1 1 1 1 1 1 1 1 1 1 1 1 1 1 1 1 1 1 1 1 1 1 1 1 1 12 111 111 111 111 111 111 111 111 111 12 1 1 1 1
1 1 1 1 1 1 1 1 1 1 1 1 1 1 1 1 1 1 1 1 1 1 1 1 1 1 1 1 1 1 1 1 1 1 1 1 1 1 1 1 1 1 1 1 1 1 1 1 1 12 12 12 11 12 12 12 10 12 12 12 1 1 1 1
1 1 1 1 1 1 1 1 1 1 1 1 1 1 1 1 1 1 1 1 1 1 1 1 1 1 1 1 1 1 1 1 1 1 1 1 1 1 1 1 1 1 1 1 1 1 1 1 1 1 1 1 1 1 1 1 1 1 1 1 1 1 1 1
1 1 1 1 1 1 1 1 1 1 1 1 1 1 1 1 1 1 1 1 1 1 1 1 1 1 1 1 1 1 1 1 1 1 1 1 1 1 1 1 1 1 1 1 1 1 1 1 1 1 1 1 1 1 1 1 1 1 1 1 1 1 1 1
