29 29 29 29 29 29 29 29 29 29 29 29 29 29 29 29 29 29 29 29 29 29 29 29 29 29 29 29 29 29 29 29 29 29 29 29 29 29 29 29 29 29 29 29 29 29 29 29 29 29 29 29 29 29 29 29 29 29 29 29 29 29 29 29
29 29 29 29 29 29 29 29 29 29 29 29 29 29 29 29 29 29 29 29 29 29 29 29 29 29 29 29 29 29 29 29 29 29 29 29 29 29 29 29 29 29 29 29 29 29 29 29 29 29 29 29 29 29 29 29 29 29 29 29 29 29 29 29
29 29 29 29 29 29 29 29 29 29 29 29 29 29 29 29 29 29 29 29 29 29 29 29 29 29 29 29 29 29 29 29 29 29 29 29 29 29 29 29 29 29 29 29 29 29 29 29 29 29 29 29 29 29 29 29 29 29 29 29 29 29 29 29
29 29 29 29 29 29 29 29 29 29 29 29 29 29 29 29 29 29 29 29 29 29 29 29 29 29 29 29 29 29 29 29 29 29 29 29 29 29 29 29 29 29 29 29 29 29 29 29 29 29 29 29 29 29 29 29 29 29 29 29 29 29 29 29
29 29 29 29 29 29 29 29 29 29 29 29 29 29 29 29 29 29 29 29 29 29 29 29 29 29 29 29 29 29 29 29 29 29 29 29 29 29 29 29 29 29 29 29 29 29 29 29 29 29 29 29 29 29 29 29 29 29 29 29 29 29 29 29
29 29 29 29 29 29 29 29 29 29 29 29 29 29 29 30 29 29 31 29 29 29 29 29 29 29 29 29 29 29 29 29 29 29 29 29 29 29 29 29 29 29 29 29 29 29 29 29 29 29 29 29 29 29 29 29 29 29 29 29 29 29 29 29
29 29 29 29 29 29 29 29 29 29 29 29 29 108 108 108 108 108 108 108 108 29 29 29 29 29 29 29 29 29 29 29 29 29 29 29 29 29 29 29 29 29 29 29 29 29 29 29 29 29 29 29 29 29 29 29 29 29 29 29 29 29 29 29
29 29 29 29 29 29 29 29 29 29 29 29 108 108 108 108 108 108 108 108 108 108 29 29 29 29 29 29 29 29 29 29 29 29 29 29 29 29 29 29 29 29 29 29 29 29 29 29 29 29 29 29 29 29 29 29 29 29 29 29 29 29 29 29
29 29 29 29 29 29 29 29 29 29 30 108 108 108 108 108 108 108 108 108 108 108 108 29 31 29 29 108 29 29 29 29 29 29 29 29 29 29 29 29 29 29 29 29 29 29 29 29 29 29 29 29 29 29 29 29 29 29 29 29 29 29 29 29
29 29 29 29 29 29 29 29 29 29 29 108 108 108 108 108 108 108 108 108 108 108 108 108 108 108 108 108 29 29 29 29 29 29 29 29 29 29 29 29 29 29 29 29 29 29 29 29 29 29 29 29 29 29 29 29 29 29 29 29 29 29 29 29
29 29 29 29 29 29 29 29 29 29 31 108 108 108 108 108 108 108 108 108 108 108 108 108 108 108 108 29 29 29 29 29 30 29 31 29 29 29 29 29 29 29 29 29 29 29 29 29 29 29 29 29 29 29 29 29 29 29 29 29 29 29 29 29
29 29 29 29 29 29 29 29 29 29 29 108 108 108 108 108 108 108 108 108 108 108 108 108 108 29 29 108 108 108 108 108 108 108 108 108 108 108 29 29 29 29 29 29 29 29 29 29 29 29 29 29 29 29 29 29 29 29 29 29 29 29 29 29
29 29 29 29 29 29 29 29 29 29 29 108 108 108 108 108 108 108 108 108 108 108 108 29 31 29 108 108 108 108 108 108 108 108 108 108 108 108 108 108 29 29 29 29 29 29 29 29 29 29 29 29 29 29 29 29 29 29 29 29 29 29 29 29
29 29 29 29 29 29 29 29 29 29 29 30 108 108 108 108 108 108 108 108 108 108 29 29 29 108 108 108 108 108 108 108 108 108 108 108 108 108 108 108 108 108 31 29 29 29 29 29 29 29 29 29 29 29 29 29 29 29 29 29 29 29 29 29
29 29 29 29 29 29 29 29 29 29 29 29 29 108 108 108 108 108 108 108 108 29 29 30 108 108 108 108 108 108 108 108 108 108 108 108 108 108 108 108 108 108 108 108 29 29 29 29 29 29 29 29 29 29 29 29 29 29 29 29 29 29 29 29
29 29 29 29 29 29 29 29 29 29 29 29 29 29 29 29 29 29 30 29 29 29 29 108 108 108 108 1 2 1 1 2 91 1 2 2 1 1 108 108 108 108 108 108 108 108 29 30 29 29 29 29 29 29 29 29 29 29 29 29 29 29 29 29
29 29 29 29 29 29 29 29 29 29 29 29 29 29 29 29 29 29 29 29 29 108 108 108 108 108 1 1 2 1 1 110 110 110 2 1 1 2 1 2 108 108 108 108 108 108 108 108 29 29 29 29 29 29 29 29 29 29 29 29 29 29 29 29
29 29 29 29 29 29 29 29 29 29 29 29 29 29 29 29 29 29 29 29 108 108 108 108 108 2 2 116 116 116 2 110 110 110 3 1 2 2 1 1 1 2 108 108 108 108 108 108 108 108 29 31 29 29 29 29 29 29 29 29 29 29 29 29
29 29 29 29 29 29 29 29 29 29 29 29 29 29 29 29 29 29 29 29 108 108 108 108 1 4 116 116 116 116 4 110 110 110 110 110 110 110 110 1 2 1 2 2 108 108 108 108 108 108 108 108 29 30 29 29 29 29 29 29 29 29 29 29
29 29 29 29 29 29 29 29 29 29 29 29 29 29 29 29 29 29 31 108 108 108 108 2 1 2 116 116 116 116 2 110 110 110 3 1 2 1 110 1 110 110 110 1 1 2 108 108 108 108 108 108 108 108 29 29 29 29 29 29 29 29 29 29
29 29 29 29 29 29 29 29 29 29 29 29 29 29 29 29 29 29 29 108 108 108 108 1 116 116 116 116 116 116 1 110 110 110 1 110 110 110 110 110 110 110 110 110 110 1 2 1 108 108 108 108 108 106 108 29 29 29 29 29 29 29 29 29
29 29 29 29 29 29 29 29 29 29 29 29 29 29 29 29 29 29 108 108 108 108 2 1 116 2 116 116 116 116 1 2 91 1 2 110 110 110 110 110 110 110 110 110 110 110 110 1 1 2 108 108 108 108 108 30 29 29 29 29 29 29 29 29
29 29 29 29 29 29 29 29 29 29 29 29 29 29 29 29 29 30 108 108 108 108 2 2 116 1 1 1 1 1 1 112 112 112 1 1 2 2 2 1 1 2 1 1 2 1 2 1 2 2 1 2 1 93 29 29 29 117 18 17 17 17 17 29
29 29 29 29 29 29 29 29 29 29 29 29 29 29 29 29 29 108 108 108 108 1 1 3 116 116 116 116 1 1 2 112 112 112 3 113 113 113 113 113 113 113 113 113 113 113 6 117 117 117 117 117 117 117 117 117 117 117 94 114 114 114 17 29
29 29 29 29 29 29 29 29 29 29 29 29 29 29 29 29 29 108 108 108 108 2 1 2 2 1 6 93 6 1 1 112 112 112 90 113 113 113 113 113 113 113 113 113 113 113 92 117 117 117 117 117 117 117 117 29 29 117 18 114 114 114 17 29
29 29 29 29 29 29 29 29 29 29 29 29 29 29 29 29 29 108 108 108 108 1 109 109 109 109 109 109 109 109 6 112 112 112 3 113 113 113 113 113 113 113 113 113 113 113 6 117 117 117 117 117 117 117 117 31 17 17 17 114 114 114 17 29
29 29 29 29 29 29 29 29 29 29 29 29 29 29 29 29 31 108 108 108 108 90 109 109 109 109 109 109 109 109 90 112 112 112 1 1 113 2 1 2 1 2 2 1 1 2 2 1 2 2 1 2 117 117 117 29 17 114 114 114 114 114 17 29
29 29 29 29 29 29 29 29 29 29 29 29 29 29 29 29 29 108 108 108 108 1 109 109 109 109 109 109 109 109 6 112 112 112 2 2 113 2 1 113 113 113 113 2 113 113 113 113 113 113 113 1 1 93 29 29 17 114 114 114 106 114 17 29
29 29 29 29 29 29 29 29 29 29 29 29 29 29 29 29 29 108 108 108 108 2 2 2 1 1 2 1 1 2 1 112 112 112 1 2 113 2 1 113 1 2 113 2 113 113 113 113 113 1 113 2 115 115 115 29 18 114 114 114 18 17 17 29
29 29 29 29 29 29 29 29 29 29 29 29 29 29 29 29 29 108 108 108 108 1 111 111 111 106 106 106 1 1 1 2 91 2 1 2 113 1 2 113 2 1 113 1 113 113 113 113 113 2 113 1 115 115 115 29 17 114 114 114 17 29 29 29
29 29 29 29 29 29 29 29 29 29 29 29 29 29 29 29 29 108 108 108 108 2 111 111 111 111 111 111 2 1 2 111 111 111 1 2 113 1 1 113 2 2 113 1 2 2 1 2 1 1 113 2 115 115 115 30 17 114 114 114 17 29 29 29
29 29 29 29 29 29 29 29 29 29 29 29 29 29 29 29 30 108 108 108 108 2 111 111 111 111 111 111 2 1 1 111 111 111 2 1 113 113 113 113 6 1 113 113 113 113 113 113 113 113 113 6 115 115 115 29 17 114 114 114 17 29 29 29
29 29 29 29 29 29 29 29 29 29 29 29 29 29 29 29 29 108 108 108 108 1 111 111 111 111 111 111 1 2 1 111 111 111 2 1 6 2 1 1 2 1 6 2 2 2 2 1 1 2 1 1 115 115 115 29 17 114 114 114 17 29 29 29
29 29 29 29 29 29 29 29 29 29 29 29 29 29 29 29 29 108 108 108 108 1 111 111 111 111 111 111 111 111 111 111 111 111 1 111 106 111 111 111 111 111 111 111 111 111 111 111 2 1 1 115 115 115 115 31 17 114 114 114 17 29 29 29
29 29 29 29 29 29 29 29 29 29 29 29 29 29 29 29 29 108 108 108 108 2 1 1 1 1 1 111 111 111 111 111 111 111 1 111 106 111 111 111 111 111 111 111 111 111 111 111 2 6 115 115 115 115 115 29 17 114 114 114 17 29 29 29
29 29 29 29 29 29 29 29 29 29 29 29 29 29 29 29 108 108 108 108 108 108 108 108 108 1 1 111 111 111 111 111 111 111 2 111 106 111 111 111 111 111 111 111 111 111 2 1 1 115 115 115 115 115 115 29 18 114 114 114 18 29 29 29
29 29 29 29 29 29 29 29 29 29 29 29 29 29 29 108 108 108 108 108 108 108 108 108 108 2 1 1 1 1 1 111 111 111 1 1 2 2 1 2 111 111 111 111 2 1 2 115 115 115 115 115 115 115 115 29 17 114 114 114 17 29 29 29
29 29 29 29 29 29 29 29 29 29 29 29 29 29 29 108 108 108 108 108 108 108 108 108 108 1 1 1 1 1 1 111 111 111 111 111 111 111 111 111 111 111 6 1 1 115 115 115 115 115 115 115 115 115 29 29 17 114 114 114 17 29 29 29
29 29 29 29 29 29 29 29 29 29 29 29 29 29 29 108 108 108 108 108 108 108 108 108 108 1 2 2 2 1 1 3 91 3 2 2 2 1 2 1 1 2 1 115 115 115 115 115 115 115 115 115 29 31 29 29 17 114 114 114 17 29 29 29
29 29 29 29 29 29 29 29 29 29 29 29 29 29 29 108 108 108 1 1 1 108 108 108 108 108 108 108 108 108 108 108 108 108 108 108 108 108 108 108 108 1 115 115 115 115 115 115 115 29 29 29 29 29 29 29 17 114 114 114 17 29 29 29
29 29 29 29 29 29 29 29 29 29 29 29 29 29 30 108 108 108 108 13 1 108 108 108 108 108 108 108 108 108 108 108 108 108 108 108 108 108 108 108 108 90 115 115 115 115 115 115 29 17 17 17 20 17 17 17 18 114 114 114 17 29 29 29
29 29 29 29 29 29 29 29 29 29 29 29 29 29 29 108 108 108 1 1 1 108 108 108 108 108 108 108 108 108 108 108 108 108 108 108 108 108 108 108 108 29 115 115 115 115 115 29 17 17 114 106 114 114 114 114 114 114 114 114 17 29 29 29
29 29 29 29 29 29 29 29 29 29 29 29 29 29 31 108 108 108 108 108 108 108 108 108 108 108 108 108 108 108 108 108 108 108 108 108 108 108 108 108 29 29 115 115 115 115 29 29 17 114 114 114 114 114 114 114 114 106 114 106 17 29 29 29
29 29 29 29 29 29 29 29 29 29 29 29 29 29 29 108 108 108 108 108 108 108 108 108 108 29 29 29 29 30 29 29 29 29 29 31 29 29 29 30 29 29 29 31 29 29 115 29 17 114 114 114 114 114 114 114 114 114 106 114 17 29 29 29
29 29 29 29 29 29 29 29 29 29 29 29 29 29 29 29 108 108 108 108 108 108 108 108 108 29 29 29 29 29 29 29 29 29 29 29 29 29 29 29 29 29 29 29 29 115 115 29 17 114 114 114 114 114 114 17 18 17 17 17 17 29 29 29
29 29 29 29 29 29 29 29 29 29 29 29 29 29 29 29 29 29 29 29 30 29 31 29 29 29 29 29 29 29 29 29 29 29 29 29 29 29 29 29 29 29 29 29 29 115 115 29 20 114 114 114 114 114 114 20 17 17 17 17 17 17 29 29
29 29 29 29 29 29 29 29 29 29 29 29 29 29 29 29 29 29 29 29 29 29 29 29 29 29 29 29 29 29 29 29 29 29 29 29 29 29 29 29 30 29 29 29 29 29 115 29 17 114 114 114 114 114 114 114 106 114 18 21 17 17 29 29
29 29 29 29 29 29 29 29 29 29 29 29 29 29 29 29 29 29 29 29 29 29 29 29 29 29 29 29 29 29 29 29 29 29 29 29 29 29 115 115 115 115 115 115 115 115 115 29 17 114 114 114 114 114 114 114 114 114 100 143 21 17 29 29
29 29 29 29 29 29 29 29 29 29 29 29 29 29 29 29 29 29 29 29 29 29 29 29 29 29 29 29 29 29 29 29 29 29 29 29 29 115 115 115 115 115 115 115 115 115 115 30 17 114 114 114 114 114 114 114 106 114 18 21 17 17 29 29
29 29 29 29 29 29 29 29 29 29 29 29 29 29 29 29 29 29 29 29 29 29 29 29 29 29 29 29 29 29 29 29 29 29 29 29 29 115 115 115 115 115 115 115 115 115 115 29 17 17 114 106 114 114 106 20 17 17 17 17 17 17 29 29
29 29 29 29 29 29 29 29 29 29 29 29 29 29 29 29 29 29 29 29 29 29 29 29 29 29 29 29 29 29 29 29 29 29 29 29 29 115 115 115 115 29 29 115 115 115 115 29 29 17 17 17 18 17 17 17 17 29 29 29 29 29 29 29
29 29 29 29 29 29 29 29 29 29 29 29 29 29 29 29 29 29 29 29 29 29 29 29 29 29 29 29 29 29 29 29 29 29 29 29 30 115 115 115 115 29 30 115 115 115 115 29 29 29 29 29 29 29 29 29 29 29 29 29 29 29 29 29
29 29 29 29 29 29 29 29 29 29 29 29 29 29 29 29 29 29 29 29 29 29 29 29 29 29 29 29 29 29 29 29 29 29 29 29 29 115 115 115 115 115 115 115 115 115 115 29 29 29 29 29 29 29 29 29 29 29 29 29 29 29 29 29
29 29 29 29 29 29 29 29 29 29 29 29 29 29 29 29 29 29 29 29 29 29 29 29 29 29 29 29 29 29 29 29 29 29 29 29 29 115 115 115 115 115 115 115 115 115 115 30 29 29 29 29 29 29 29 29 29 29 29 29 29 29 29 29
29 29 29 29 29 29 29 29 29 29 29 29 29 29 29 29 29 29 29 29 29 29 29 29 29 29 29 29 29 29 29 29 29 29 29 29 29 29 115 115 115 115 115 115 115 115 115 29 29 29 29 29 29 29 29 29 29 29 29 29 29 29 29 29
29 29 29 29 29 29 29 29 29 29 29 29 29 29 29 29 29 29 29 29 29 29 29 29 29 29 29 29 29 29 29 29 29 29 29 29 29 29 29 30 29 29 29 29 29 29 29 29 29 29 29 29 29 29 29 29 29 29 29 29 29 29 29 29
29 29 29 29 29 29 29 29 29 29 29 29 29 29 29 29 29 29 29 29 29 29 29 29 29 29 29 29 29 29 29 29 29 29 29 29 29 29 29 29 29 29 29 29 29 29 29 29 29 29 29 29 29 29 29 29 29 29 29 29 29 29 29 29
29 29 29 29 29 29 29 29 29 29 29 29 29 29 29 29 29 29 29 29 29 29 29 29 29 29 29 29 29 29 29 29 29 29 29 29 29 29 29 29 29 29 29 29 29 29 29 29 29 29 29 29 29 29 29 29 29 29 29 29 29 29 29 29
29 29 29 29 29 29 29 29 29 29 29 29 29 29 29 29 29 29 29 29 29 29 29 29 29 29 29 29 29 29 29 29 29 29 29 29 29 29 29 29 29 29 29 29 29 29 29 29 29 29 29 29 29 29 29 29 29 29 29 29 29 29 29 29
29 29 29 29 29 29 29 29 29 29 29 29 29 29 29 29 29 29 29 29 29 29 29 29 29 29 29 29 29 29 29 29 29 29 29 29 29 29 29 29 29 29 29 29 29 29 29 29 29 29 29 29 29 29 29 29 29 29 29 29 29 29 29 29
29 29 29 29 29 29 29 29 29 29 29 29 29 29 29 29 29 29 29 29 29 29 29 29 29 29 29 29 29 29 29 29 29 29 29 29 29 29 29 29 29 29 29 29 29 29 29 29 29 29 29 29 29 29 29 29 29 29 29 29 29 29 29 29
29 29 29 29 29 29 29 29 29 29 29 29 29 29 29 29 29 29 29 29 29 29 29 29 29 29 29 29 29 29 29 29 29 29 29 29 29 29 29 29 29 29 29 29 29 29 29 29 29 29 29 29 29 29 29 29 29 29 29 29 29 29 29 29
29 29 29 29 29 29 29 29 29 29 29 29 29 29 29 29 29 29 29 29 29 29 29 29 29 29 29 29 29 29 29 29 29 29 29 29 29 29 29 29 29 29 29 29 29 29 29 29 29 29 29 29 29 29 29 29 29 29 29 29 29 29 29 29
29 29 29 29 29 29 29 29 29 29 29 29 29 29 29 29 29 29 29 29 29 29 29 29 29 29 29 29 29 29 29 29 29 29 29 29 29 29 29 29 29 29 29 29 29 29 29 29 29 29 29 29 29 29 29 29 29 29 29 29 29 29 29 29
