1 1 1 1 1 1 1 1 1 1 1 1 1 1 1 1 1 1 1 1 1 1 1 1 1 1 1 1 1 1 1 1 1 1 1 1 1 1 1 1 1 1 1 1 1 1 1 1 1 1 1 1 1 1 1 1 1 1 1 1 1 1 1 1
1 1 1 1 1 1 1 1 1 1 1 1 1 1 1 1 1 1 1 1 1 1 1 1 1 1 1 1 1 1 1 1 1 1 1 1 1 1 1 1 1 1 1 1 1 1 1 1 1 1 1 1 1 1 1 1 1 1 1 1 1 1 1 1
1 1 1 1 1 1 1 1 1 1 1 1 1 1 1 1 1 1 1 1 1 1 1 1 1 1 1 1 1 1 1 1 1 1 1 1 1 1 1 1 1 1 1 1 1 1 1 1 1 1 1 1 1 1 1 1 1 1 1 1 1 1 1 1
1 1 1 1 1 1 1 1 1 1 1 1 1 1 1 1 1 1 1 1 1 1 1 1 1 1 1 1 1 1 1 1 1 1 1 1 1 1 1 1 1 1 1 1 1 1 1 1 1 1 1 1 1 1 1 1 1 1 1 1 1 1 1 1
1 1 1 1 1 1 1 1 1 1 1 1 1 1 1 1 1 1 1 1 1 1 1 1 1 1 1 1 1 1 1 1 1 1 1 1 1 1 1 1 1 1 1 1 1 1 1 1 1 1 1 1 1 1 1 1 1 1 1 1 1 1 1 1
1 1 1 1 1 1 1 1 1 1 1 1 1 1 1 1 1 1 1 1 1 1 1 1 1 1 1 1 1 1 1 1 1 1 1 1 1 1 1 1 1 1 1 1 1 1 1 1 1 1 1 1 1 1 1 1 1 1 1 1 1 1 1 1
1 1 1 1 1 1 1 1 1 1 1 1 1 1 1 1 1 1 42 42 42 42 42 47 42 42 47 42 42 47 42 42 47 42 42 47 42 42 1 1 1 1 1 1 1 1 1 1 1 1 1 1 1 1 1 1 1 1 1 1 1 1 1 1
1 1 1 1 1 1 1 1 1 1 1 1 1 1 1 1 1 1 42 113 113 113 113 113 113 113 113 113 113 113 113 113 113 113 113 113 113 47 21 1 1 1 1 1 1 1 1 1 1 1 1 1 1 1 1 1 1 1 1 1 1 1 1 1
1 1 1 1 1 1 1 1 1 1 1 1 1 1 1 1 1 1 42 113 113 113 113 113 113 113 113 113 113 113 113 113 113 113 113 113 113 100 143 21 1 1 1 1 1 1 1 1 1 1 1 1 1 1 1 1 1 1 1 1 1 1 1 1
1 1 1 1 1 1 1 1 1 1 1 1 1 1 1 1 1 1 42 113 113 113 113 113 113 113 113 113 113 113 113 113 113 113 113 113 113 47 21 1 1 1 1 1 1 1 1 1 1 1 1 1 1 1 1 1 1 1 1 1 1 1 1 1
1 1 1 1 1 1 1 1 1 1 1 1 1 1 1 1 1 1 42 113 42 42 42 47 42 42 47 42 42 47 42 42 47 42 42 47 42 42 1 1 1 1 1 1 1 1 1 1 1 1 1 1 1 1 1 1 1 1 1 1 1 1 1 1
1 1 1 1 1 1 1 1 1 1 1 1 1 1 1 1 1 1 42 113 42 1 1 1 1 1 1 1 1 1 1 1 1 1 1 1 1 1 1 1 1 1 1 1 1 1 1 1 1 1 1 1 1 1 1 1 1 1 1 1 1 1 1 1
1 1 1 1 1 1 1 1 1 1 1 17 17 17 17 17 17 17 18 95 18 17 17 17 17 17 17 17 1 1 1 1 1 1 1 1 1 1 1 1 1 1 1 1 1 1 1 1 1 1 1 1 1 1 1 1 1 1 1 1 1 1 1 1
1 1 1 1 1 1 1 1 1 1 1 17 111 111 111 111 111 111 106 111 106 111 111 111 111 111 111 17 1 1 1 1 1 1 1 1 1 1 1 1 1 1 1 1 1 1 1 1 1 1 1 1 1 1 1 1 1 1 1 1 1 1 1 1
1 1 1 1 1 1 1 1 1 1 1 20 111 111 111 111 111 111 111 111 111 111 111 111 111 111 111 20 1 1 1 1 1 1 1 1 1 1 1 1 1 1 1 1 1 1 1 1 1 1 1 1 1 1 1 1 1 1 1 1 1 1 1 1
1 1 1 1 1 1 1 1 1 1 1 17 111 111 111 111 111 111 111 111 111 111 111 111 111 111 111 17 1 1 1 1 1 1 1 1 1 1 1 1 1 1 1 1 1 1 1 1 1 1 1 1 1 1 1 1 1 1 1 1 1 1 1 1
1 1 1 1 1 1 1 1 1 1 1 17 111 111 111 111 111 111 111 111 111 111 111 111 111 111 111 17 1 1 1 1 1 1 1 1 1 1 1 1 1 1 1 1 1 1 1 1 1 1 1 1 1 1 1 1 1 1 1 1 1 1 1 1
1 1 1 1 1 1 1 1 1 1 1 17 17 111 111 111 111 111 111 111 111 111 111 111 111 111 17 17 1 1 1 1 1 1 1 1 1 1 1 1 1 1 1 1 1 1 1 1 1 1 1 1 1 1 1 1 1 1 1 1 1 1 1 1
1 1 1 1 1 1 1 1 1 1 1 1 17 91 20 91 20 91 20 91 20 91 20 91 20 91 17 1 1 1 1 1 1 1 1 1 1 1 1 1 1 1 1 1 1 1 1 1 1 1 1 1 1 1 1 1 1 1 1 1 1 1 1 1
1 1 1 1 1 1 1 1 1 1 1 1 18 111 111 111 111 111 111 111 111 111 111 111 111 111 18 1 1 1 1 1 1 1 1 1 1 1 1 1 1 1 1 1 1 1 1 1 1 1 1 1 1 1 1 1 1 1 1 1 1 1 1 1
1 1 1 1 1 1 1 1 1 1 1 1 17 111 111 111 111 111 111 111 111 111 111 111 111 111 17 1 1 1 2 1 2 1 3 1 1 2 1 2 1 1 1 1 2 2 3 2 2 2 1 1 2 1 2 3 2 2 1 1 1 1 1 1
1 1 1 1 1 1 1 1 1 1 1 1 17 111 111 111 111 111 111 111 111 111 111 111 111 111 17 1 13 1 108 108 108 108 108 90 118 118 118 118 118 2 1 118 118 118 118 118 118 118 1 1 109 109 109 109 109 109 109 2 1 1 1 1
1 1 1 1 1 1 1 1 1 1 1 1 17 111 111 111 111 111 111 111 111 111 111 111 111 111 17 2 108 2 108 108 108 108 108 3 1 2 1 2 118 118 118 118 118 118 118 118 118 118 2 1 6 109 109 109 109 109 109 2 1 1 1 1
1 1 1 1 1 1 1 1 1 1 1 1 17 17 17 17 17 17 17 111 111 111 111 111 111 111 17 1 108 1 108 108 108 108 108 2 118 118 1 2 2 3 118 118 118 118 118 118 118 118 3 118 2 109 109 109 109 109 109 1 1 1 1 1
1 1 1 1 1 1 1 1 1 1 1 1 1 1 1 1 1 1 17 17 111 111 111 111 111 111 17 2 108 2 108 108 108 108 108 1 118 118 118 118 118 118 118 118 118 118 118 118 118 118 6 118 90 109 109 12 109 109 109 2 1 1 1 1
1 1 1 1 1 1 1 1 8 9 8 7 9 8 8 8 1 1 1 17 17 111 111 111 111 111 17 1 108 1 108 108 108 108 108 2 118 118 118 118 118 118 118 118 118 118 118 118 118 118 3 118 2 109 109 10 109 109 109 1 1 1 1 1
1 1 1 1 1 1 1 8 8 110 110 110 110 110 110 9 8 1 1 1 17 111 111 111 111 111 17 2 108 2 108 108 108 108 108 1 118 118 2 1 2 3 118 118 118 118 118 118 118 118 2 6 6 109 109 12 109 109 109 2 1 1 1 1
1 1 1 1 1 1 8 9 110 110 110 110 110 110 110 110 9 8 1 1 17 111 111 111 111 111 17 1 108 2 108 108 108 108 108 3 2 1 2 1 118 118 118 118 118 118 118 118 118 118 1 2 109 109 109 109 109 109 109 109 109 3 1 1
1 1 1 1 1 1 9 110 110 110 110 110 110 110 110 110 110 8 1 1 18 111 18 17 17 17 17 2 108 1 108 108 108 108 108 90 118 118 118 118 118 1 2 118 118 118 118 118 118 118 2 1 109 109 109 109 109 109 109 109 109 2 1 1
1 1 1 1 1 1 5 110 110 110 110 110 110 110 110 110 110 7 1 1 1 91 2 1 2 1 2 1 108 3 108 108 108 108 108 3 1 2 1 2 1 2 2 2 1 1 3 1 2 1 1 2 109 109 109 109 109 109 109 109 109 2 1 1
1 1 1 1 1 1 9 110 110 110 110 110 110 110 110 110 110 9 1 1 2 108 108 108 108 108 108 108 108 108 108 108 108 108 108 108 108 108 108 108 108 108 108 108 108 2 109 109 109 109 109 1 109 12 10 12 109 12 12 12 109 1 1 1
1 1 1 1 1 1 8 110 110 110 110 110 110 110 110 110 110 9 1 1 1 108 108 108 108 108 108 108 108 108 108 108 108 108 108 108 108 108 108 108 108 108 108 108 108 1 109 109 109 109 109 2 109 12 11 12 109 10 12 11 109 1 1 1
1 1 1 1 8 8 9 8 110 110 110 110 110 110 110 110 110 7 1 1 3 108 108 108 108 108 108 108 108 108 108 108 108 108 108 108 108 108 108 108 108 108 108 108 108 2 109 109 109 109 109 1 109 109 109 109 109 12 12 12 109 2 1 1
1 1 1 1 9 110 110 110 110 110 110 110 110 110 110 110 110 8 1 1 1 108 108 108 108 108 108 108 108 108 108 108 108 108 108 108 108 108 108 108 108 108 108 108 108 1 109 109 109 109 109 2 109 12 10 12 109 12 12 12 109 1 1 1
1 1 1 8 8 110 8 9 9 9 8 9 8 8 9 9 8 8 1 1 2 108 108 108 108 108 108 108 108 108 108 108 108 108 108 108 108 108 108 108 108 108 108 108 108 2 1 2 1 2 109 2 109 12 11 12 109 12 12 12 109 1 1 1
1 1 1 9 110 110 8 1 1 1 1 1 1 1 1 1 1 1 1 1 1 2 1 1 2 3 1 2 2 3 108 108 108 108 108 1 91 1 2 2 3 2 2 1 91 1 1 1 1 109 109 6 109 109 109 109 109 11 12 10 109 2 1 1
1 1 1 8 110 110 8 9 9 8 8 9 8 8 9 8 8 9 9 8 8 9 8 9 8 9 8 1 1 2 108 108 108 108 108 2 109 2 1 1 1 1 1 2 109 1 1 1 3 1 1 1 109 1 1 1 109 12 12 12 109 3 1 1
1 1 9 8 9 9 110 110 110 110 110 110 8 110 110 110 110 110 110 110 110 110 110 110 110 110 9 1 1 1 108 108 108 108 108 1 109 1 1 1 1 1 1 1 109 109 109 109 109 109 109 109 109 1 1 1 109 12 12 12 109 1 1 1
8 9 8 110 110 9 110 110 110 110 110 110 90 110 110 110 110 110 110 110 110 110 110 110 110 110 9 1 1 2 108 108 108 108 108 2 109 2 2 1 1 2 2 1 1 2 2 2 3 1 2 1 1 2 1 2 109 12 12 12 109 2 1 1
9 110 110 110 110 110 110 110 8 8 9 8 8 9 9 8 8 9 8 9 8 9 9 8 110 110 9 1 1 1 108 108 108 108 108 3 109 1 109 109 109 109 109 109 109 109 109 109 109 109 109 109 109 109 109 109 109 10 12 11 109 2 1 1
8 110 110 110 110 110 110 110 8 9 8 9 8 9 8 8 9 9 8 9 8 9 8 9 110 110 8 1 1 2 108 108 108 108 108 2 109 2 109 109 109 109 109 109 109 109 109 109 109 109 109 109 109 109 109 109 109 12 12 12 109 1 1 1
9 110 110 110 110 110 110 110 110 110 110 110 90 110 110 110 110 110 110 110 110 110 110 110 110 110 9 1 1 1 108 108 108 108 108 1 109 109 109 109 109 109 109 109 109 109 109 109 109 109 109 109 109 109 109 109 109 109 109 109 109 2 1 1
9 110 110 110 110 110 110 110 110 110 110 110 8 110 110 110 110 110 110 110 110 110 110 110 110 110 8 1 3 1 108 108 108 108 108 2 3 1 1 2 1 1 2 1 2 1 1 2 3 1 2 1 2 2 1 1 2 1 2 2 2 1 1 1
8 110 110 110 110 110 110 110 8 9 9 8 9 8 8 9 8 9 9 8 9 8 8 8 110 110 110 92 108 108 108 108 108 108 108 1 1 1 1 1 1 1 1 1 1 1 1 1 1 1 1 1 1 1 1 1 1 1 1 1 1 1 1 1
9 110 110 110 110 110 110 110 8 9 9 9 8 9 8 9 8 8 9 8 8 8 8 8 110 110 9 1 3 1 2 1 1 2 1 2 1 1 1 1 1 1 1 1 1 1 1 1 1 1 1 1 1 1 1 1 1 1 1 1 1 1 1 1
8 8 9 110 110 9 110 110 110 110 110 110 90 110 110 110 110 110 110 110 110 110 110 110 110 110 9 1 1 1 1 1 1 1 1 1 1 1 1 1 1 1 1 1 1 1 1 1 1 1 1 1 1 1 1 1 1 1 1 1 1 1 1 1
1 1 8 9 8 8 110 110 110 110 110 110 8 110 110 110 110 110 110 110 110 110 110 110 110 110 8 1 1 1 1 1 1 1 1 1 1 1 1 1 1 1 1 1 1 1 1 1 1 1 1 1 1 1 1 1 1 1 1 1 1 1 1 1
1 1 1 1 1 8 9 9 8 9 9 8 9 9 8 9 8 8 8 9 8 8 9 9 9 8 8 1 1 1 1 1 1 1 1 1 1 1 1 1 1 1 1 1 1 1 1 1 1 1 1 1 1 1 1 1 1 1 1 1 1 1 1 1
1 1 1 1 1 1 1 1 1 1 1 1 1 1 1 1 1 1 1 1 1 1 1 1 1 1 1 1 1 1 1 1 1 1 1 1 1 1 1 1 1 1 1 1 1 1 1 1 1 1 1 1 1 1 1 1 1 1 1 1 1 1 1 1
1 1 1 1 1 1 1 1 1 1 1 1 1 1 1 1 1 1 1 1 1 1 1 1 1 1 1 1 1 1 1 1 1 1 1 1 1 1 1 1 1 1 1 1 1 1 1 1 1 1 1 1 1 1 1 1 1 1 1 1 1 1 1 1
1 1 1 1 1 1 1 1 1 1 1 1 1 1 1 1 1 1 1 1 1 1 1 1 1 1 1 1 1 1 1 1 1 1 1 1 1 1 1 1 1 1 1 1 1 1 1 1 1 1 1 1 1 1 1 1 1 1 1 1 1 1 1 1
1 1 1 1 1 1 1 1 1 1 1 1 1 1 1 1 1 1 1 1 1 1 1 1 1 1 1 1 1 1 1 1 1 1 1 1 1 1 1 1 1 1 1 1 1 1 1 1 1 1 1 1 1 1 1 1 1 1 1 1 1 1 1 1
1 1 1 1 1 1 1 1 1 1 1 1 1 1 1 1 1 1 1 1 1 1 1 1 1 1 1 1 1 1 1 1 1 1 1 1 1 1 1 1 1 1 1 1 1 1 1 1 1 1 1 1 1 1 1 1 1 1 1 1 1 1 1 1
1 1 1 1 1 1 1 1 1 1 1 1 1 1 1 1 1 1 1 1 1 1 1 1 1 1 1 1 1 1 1 1 1 1 1 1 1 1 1 1 1 1 1 1 1 1 1 1 1 1 1 1 1 1 1 1 1 1 1 1 1 1 1 1
1 1 1 1 1 1 1 1 1 1 1 1 1 1 1 1 1 1 1 1 1 1 1 1 1 1 1 1 1 1 1 1 1 1 1 1 1 1 1 1 1 1 1 1 1 1 1 1 1 1 1 1 1 1 1 1 1 1 1 1 1 1 1 1
1 1 1 1 1 1 1 1 1 1 1 1 1 1 1 1 1 1 1 1 1 1 1 1 1 1 1 1 1 1 1 1 1 1 1 1 1 1 1 1 1 1 1 1 1 1 1 1 1 1 1 1 1 1 1 1 1 1 1 1 1 1 1 1
1 1 1 1 1 1 1 1 1 1 1 1 1 1 1 1 1 1 1 1 1 1 1 1 1 1 1 1 1 1 1 1 1 1 1 1 1 1 1 1 1 1 1 1 1 1 1 1 1 1 1 1 1 1 1 1 1 1 1 1 1 1 1 1
1 1 1 1 1 1 1 1 1 1 1 1 1 1 1 1 1 1 1 1 1 1 1 1 1 1 1 1 1 1 1 1 1 1 1 1 1 1 1 1 1 1 1 1 1 1 1 1 1 1 1 1 1 1 1 1 1 1 1 1 1 1 1 1
1 1 1 1 1 1 1 1 1 1 1 1 1 1 1 1 1 1 1 1 1 1 1 1 1 1 1 1 1 1 1 1 1 1 1 1 1 1 1 1 1 1 1 1 1 1 1 1 1 1 1 1 1 1 1 1 1 1 1 1 1 1 1 1
1 1 1 1 1 1 1 1 1 1 1 1 1 1 1 1 1 1 1 1 1 1 1 1 1 1 1 1 1 1 1 1 1 1 1 1 1 1 1 1 1 1 1 1 1 1 1 1 1 1 1 1 1 1 1 1 1 1 1 1 1 1 1 1
1 1 1 1 1 1 1 1 1 1 1 1 1 1 1 1 1 1 1 1 1 1 1 1 1 1 1 1 1 1 1 1 1 1 1 1 1 1 1 1 1 1 1 1 1 1 1 1 1 1 1 1 1 1 1 1 1 1 1 1 1 1 1 1
1 1 1 1 1 1 1 1 1 1 1 1 1 1 1 1 1 1 1 1 1 1 1 1 1 1 1 1 1 1 1 1 1 1 1 1 1 1 1 1 1 1 1 1 1 1 1 1 1 1 1 1 1 1 1 1 1 1 1 1 1 1 1 1
1 1 1 1 1 1 1 1 1 1 1 1 1 1 1 1 1 1 1 1 1 1 1 1 1 1 1 1 1 1 1 1 1 1 1 1 1 1 1 1 1 1 1 1 1 1 1 1 1 1 1 1 1 1 1 1 1 1 1 1 1 1 1 1
1 1 1 1 1 1 1 1 1 1 1 1 1 1 1 1 1 1 1 1 1 1 1 1 1 1 1 1 1 1 1 1 1 1 1 1 1 1 1 1 1 1 1 1 1 1 1 1 1 1 1 1 1 1 1 1 1 1 1 1 1 1 1 1
