35 35 35 35 35 35 35 35 35 35 35 35 35 35 35 35 35 35 35 35 35 35 35 35 35 35 35 35 35 35 35 35 35 35 35 35 35 35 35 35 35 35 35 35 35 35 35 35 35 35 35 35 35 35 35 35 35 35 35 35 35 35 35 35
35 35 35 35 35 35 35 35 35 35 35 35 35 35 35 35 35 35 35 35 35 35 35 35 35 35 35 35 35 35 35 35 35 35 35 35 35 35 35 35 35 35 35 35 35 35 35 35 35 35 35 35 35 35 35 35 35 35 35 35 35 35 35 35
35 35 35 35 35 35 35 35 35 35 35 35 35 35 35 35 35 35 35 35 35 35 35 35 35 35 35 35 35 35 35 35 35 35 35 35 35 35 35 35 35 35 35 35 35 35 35 35 35 35 35 1 3 1 35 35 35 35 35 35 35 35 35 35
35 35 35 35 35 35 35 35 35 35 35 35 35 35 35 35 35 2 2 1 2 1 2 1 2 1 2 1 2 1 2 1 2 1 2 1 2 1 2 1 2 1 2 1 2 1 2 1 2 1 2 1 114 2 1 35 35 35 35 35 35 35 35 35
35 35 35 35 35 35 35 35 35 35 35 35 35 35 35 35 35 1 114 114 114 114 114 114 114 114 114 114 114 114 114 114 114 114 114 114 114 114 114 114 114 114 114 114 114 114 114 114 114 114 114 114 114 114 3 35 35 35 35 35 35 35 35 35
35 35 35 35 35 35 35 35 35 35 35 35 35 35 35 35 35 2 114 114 114 114 114 114 1 114 114 114 114 114 114 114 114 114 114 114 114 114 114 114 114 114 114 114 114 114 114 114 114 114 114 114 114 2 1 35 35 35 35 35 35 35 35 35
35 35 35 35 35 35 35 35 35 35 35 35 35 35 35 35 35 1 114 114 1 2 114 114 2 114 114 6 1 2 1 2 1 2 1 2 3 91 3 2 1 2 1 2 1 2 1 2 1 2 6 114 114 1 35 35 35 35 35 35 35 35 35 35
35 35 35 35 35 35 35 35 35 35 35 35 35 35 35 35 35 2 114 114 2 1 114 114 1 114 114 1 1 2 1 2 1 1 1 1 109 109 109 1 1 1 2 1 2 1 1 1 1 1 1 114 114 2 35 35 35 35 35 35 35 35 35 35
35 35 35 35 35 35 35 35 35 35 35 35 35 35 35 35 35 1 114 114 1 2 114 114 2 114 114 2 1 109 109 109 109 1 1 2 109 109 109 2 1 1 109 109 109 109 2 1 1 1 2 114 114 1 35 35 35 35 35 35 35 35 35 35
35 35 35 35 35 35 35 35 35 35 35 35 35 35 35 35 35 2 114 114 2 1 114 114 1 114 114 1 2 109 109 109 109 2 1 6 109 109 109 6 1 2 109 109 109 109 1 1 1 1 1 114 114 2 35 35 35 35 35 35 35 35 35 35
35 35 35 35 35 35 35 35 35 35 35 35 35 35 35 35 35 1 114 114 1 2 114 114 2 114 114 2 1 109 109 109 109 109 109 109 109 109 109 109 109 109 109 109 109 109 2 1 1 1 2 114 114 1 35 35 35 35 35 35 35 35 35 35
35 35 35 35 35 35 35 35 35 35 35 35 35 35 35 35 35 2 114 114 2 1 114 114 1 114 114 1 1 109 109 109 109 109 109 109 109 109 109 109 109 109 109 109 109 109 1 1 1 1 1 114 114 4 35 35 35 35 35 35 35 35 35 35
35 35 35 35 35 35 35 35 35 35 35 35 35 35 35 35 35 1 114 114 1 2 114 114 2 114 114 2 1 2 6 109 109 12 12 12 12 10 12 12 12 12 109 109 6 1 2 1 2 1 2 114 114 1 35 35 35 35 35 35 35 35 35 35
35 35 35 35 35 35 35 35 35 35 35 35 35 35 35 35 35 2 114 114 2 1 114 114 1 114 114 6 1 2 1 109 109 12 109 109 109 109 109 109 109 12 109 109 1 2 113 113 113 3 114 114 114 2 35 35 35 35 35 35 35 35 35 35
35 35 35 35 35 35 35 35 35 35 35 35 35 35 35 35 35 1 114 114 1 2 114 114 2 114 114 114 114 114 1 109 109 11 109 109 109 109 109 109 109 11 109 109 1 1 113 113 113 90 114 114 114 1 35 35 35 35 35 35 35 35 35 35
35 35 35 35 35 35 35 35 35 35 35 35 35 35 35 35 35 2 114 114 2 1 114 114 1 114 114 114 114 114 2 109 109 12 109 109 109 109 109 109 109 12 109 109 1 2 113 113 113 3 114 114 114 2 35 35 35 35 35 35 35 35 35 35
35 35 35 35 35 35 35 35 35 35 35 35 35 35 35 35 35 1 114 114 1 1 2 1 1 2 1 2 114 114 1 109 109 12 12 10 12 12 12 10 12 12 109 109 1 1 113 113 2 1 2 1 114 1 35 35 35 35 35 35 35 35 35 35
35 35 35 35 35 35 35 35 35 35 35 35 35 35 35 35 35 2 114 114 2 1 2 1 2 1 2 1 114 114 2 109 109 109 109 109 109 109 109 109 109 109 109 109 1 2 113 113 1 35 35 2 3 2 35 35 35 35 35 35 35 35 35 35
35 35 35 35 35 35 35 35 35 35 35 35 35 35 35 35 35 1 114 114 114 114 114 114 114 114 114 114 114 114 3 109 109 109 109 109 109 109 109 109 109 109 109 109 3 1 113 113 2 35 35 35 35 35 35 35 35 35 35 35 35 35 35 35
35 35 35 35 35 35 35 35 35 35 35 35 35 35 35 35 35 2 114 114 114 114 114 114 114 114 114 114 114 114 2 1 109 109 109 109 109 109 109 109 109 109 109 1 1 2 113 113 1 2 1 2 1 2 35 35 35 35 35 35 35 35 35 35
35 35 35 35 35 35 35 35 35 35 35 35 35 35 35 35 35 1 6 1 2 1 2 1 4 1 2 1 2 1 1 1 1 109 109 109 109 109 109 109 109 109 1 1 1 1 113 113 113 113 113 113 113 2 35 35 35 35 35 35 35 35 35 35
35 35 35 35 35 35 35 35 35 35 35 35 17 17 17 17 17 17 17 17 17 17 110 110 110 110 110 110 1 1 1 1 1 1 109 109 109 109 109 109 109 1 1 1 1 2 113 113 113 113 113 113 113 1 35 35 35 35 35 35 35 35 35 35
35 35 35 35 35 35 35 35 35 35 35 35 17 111 111 111 111 111 111 111 111 18 110 110 110 110 110 110 110 1 2 1 2 1 2 1 6 91 6 1 2 1 2 1 2 1 4 1 2 1 2 113 113 2 35 35 35 35 35 35 35 35 35 35
35 35 35 35 35 35 35 35 35 35 35 35 17 111 111 111 111 111 111 111 111 90 110 110 110 110 110 110 110 110 110 110 110 110 110 2 108 108 108 1 113 113 113 113 113 113 113 2 1 1 1 113 113 1 35 35 35 35 35 35 35 35 35 35
35 35 35 35 35 35 17 17 17 17 17 17 17 111 111 17 17 111 111 111 111 18 110 110 110 110 110 110 110 110 110 110 110 110 110 90 108 108 108 90 113 113 113 113 113 113 113 1 1 1 2 113 113 2 35 35 35 35 35 35 35 35 35 35
35 35 35 35 35 35 17 111 111 111 111 111 111 111 111 17 17 17 17 17 17 17 110 110 110 110 110 110 110 110 110 110 110 110 110 1 108 108 108 2 113 113 113 113 113 113 113 2 1 1 1 113 113 1 35 35 35 35 35 35 35 35 35 35
35 35 35 35 35 35 17 111 111 111 111 111 111 111 111 17 17 17 17 17 17 17 110 110 110 110 110 110 110 1 2 1 2 1 2 1 108 108 108 1 1 2 1 2 113 113 113 1 1 1 2 113 113 2 35 35 35 35 35 35 35 35 35 35
35 35 35 35 35 35 17 111 111 17 17 17 17 111 111 17 17 17 17 17 17 17 18 91 18 91 18 17 17 2 1 2 1 2 1 2 1 108 108 2 1 1 1 1 113 113 113 2 1 2 6 113 113 1 35 35 35 35 35 35 35 35 35 35
35 35 35 35 35 35 17 111 111 17 17 17 17 111 111 111 111 111 111 111 111 111 111 111 17 111 111 17 1 108 108 108 108 108 108 108 2 108 108 2 1 1 1 2 113 113 113 113 113 113 113 113 113 2 35 35 35 35 35 35 35 35 35 35
35 35 35 35 35 35 17 111 111 17 17 17 17 111 111 111 111 111 111 111 111 111 111 111 17 111 111 17 2 108 108 108 108 108 108 108 1 108 108 1 1 1 1 1 113 113 113 113 113 113 113 113 113 1 35 35 35 35 35 35 35 35 35 35
35 35 35 35 35 35 17 111 111 17 17 17 17 17 17 17 111 111 17 17 17 17 17 17 17 111 111 17 1 108 108 1 2 1 108 108 2 108 108 2 1 2 1 1 34 34 34 33 93 33 34 34 34 2 35 35 35 35 35 35 35 35 35 35
35 35 35 35 35 35 17 111 111 17 17 17 17 17 17 17 111 111 17 17 17 17 17 17 17 111 111 17 2 108 108 2 13 2 108 108 1 108 108 108 108 108 3 21 34 34 115 115 115 115 115 34 35 35 35 35 35 35 35 35 35 35 35 35
35 35 35 35 35 35 17 111 111 17 17 17 17 111 111 111 111 111 111 111 111 111 111 111 111 111 111 17 1 108 108 1 108 1 108 108 2 108 108 108 108 108 100 143 21 34 115 115 115 115 115 34 35 35 35 35 35 35 35 35 35 35 35 35
35 35 35 35 35 35 17 111 111 17 17 17 17 111 111 111 111 111 111 111 111 111 111 111 111 111 111 17 2 108 108 2 108 2 108 108 1 108 108 108 108 108 3 21 34 34 115 115 33 115 115 34 35 35 35 35 35 35 35 35 35 35 35 35
35 35 35 35 35 35 17 111 111 17 17 17 17 111 111 17 17 17 17 17 111 111 17 17 17 111 111 17 1 108 108 1 108 108 108 108 2 108 108 1 108 1 34 34 34 34 115 115 34 115 115 34 34 34 34 34 35 35 35 35 35 35 35 35
35 35 35 35 35 35 17 111 111 111 111 111 111 111 111 17 17 17 17 17 111 111 17 17 17 111 111 17 2 108 108 2 108 108 108 108 1 108 108 1 95 2 34 115 115 115 115 115 34 115 115 115 115 115 115 34 35 35 35 35 35 35 35 35
35 35 35 35 35 35 18 111 111 111 111 111 111 111 111 111 111 17 17 17 111 111 17 17 17 111 111 17 1 108 108 1 2 1 2 1 2 108 108 108 108 1 34 115 115 115 115 115 34 115 115 115 115 115 115 34 35 35 35 35 35 35 35 35
35 35 35 35 35 35 17 91 18 17 17 17 17 111 111 111 111 17 17 17 111 111 111 111 111 111 111 17 2 108 108 108 108 108 108 108 108 108 108 108 108 2 34 115 115 34 34 34 34 34 34 34 34 115 115 34 35 35 35 35 35 35 35 35
35 35 35 35 35 35 112 112 112 35 35 35 17 17 17 111 111 17 17 17 111 111 111 111 111 111 111 17 1 108 108 108 108 108 108 108 108 108 108 108 6 1 34 115 115 34 115 115 115 115 115 34 34 115 115 34 35 35 35 35 35 35 35 35
35 35 35 35 39 112 112 112 112 112 35 35 35 35 17 111 111 17 17 17 17 17 111 111 17 17 17 17 2 1 4 1 2 1 2 1 2 1 2 1 2 1 34 115 115 34 115 115 115 115 115 34 34 115 115 34 35 35 35 35 35 35 35 35
35 35 35 35 35 112 112 112 112 112 39 35 35 35 17 111 111 17 17 17 17 17 111 111 17 35 35 35 35 35 35 35 35 34 34 34 34 34 34 34 34 34 33 115 115 34 115 115 34 34 115 115 115 115 115 34 35 35 35 35 35 35 35 35
35 35 35 35 112 112 112 112 112 112 112 35 35 35 17 111 111 17 17 17 17 17 111 111 17 35 35 35 35 35 35 35 35 34 115 115 115 115 115 115 115 115 115 115 115 34 115 115 34 34 115 115 115 115 115 34 35 35 35 35 35 35 35 35
35 35 35 35 112 112 112 112 112 112 112 39 35 35 17 111 111 111 111 111 111 111 111 111 17 35 35 35 35 35 35 35 35 34 115 115 115 115 115 115 115 115 115 115 115 34 115 115 34 34 34 34 34 34 34 34 35 35 35 35 35 35 35 35
35 35 35 39 112 112 112 112 112 112 112 35 35 35 17 111 111 111 111 111 111 111 111 111 17 35 35 35 35 35 35 35 35 34 115 115 34 34 34 34 34 34 34 33 34 34 115 115 34 34 34 34 35 35 35 35 35 35 35 35 35 35 35 35
35 35 35 35 112 112 112 112 112 112 112 35 35 35 17 17 17 17 17 17 17 17 17 17 17 35 35 35 35 35 35 35 35 34 115 115 115 115 115 115 115 115 115 115 115 34 115 115 115 115 115 34 35 35 35 35 35 35 35 35 35 35 35 35
35 35 35 35 35 112 112 112 112 112 35 35 35 35 35 35 35 35 35 35 35 35 35 35 35 35 35 35 35 35 35 35 35 34 115 115 115 115 115 115 115 115 115 115 115 34 115 115 115 115 115 34 35 35 35 35 35 35 35 35 35 35 35 35
35 35 35 35 35 35 112 112 112 39 35 35 35 35 35 35 35 35 35 35 35 35 35 35 35 35 35 35 35 35 35 35 35 34 115 115 115 115 115 115 115 115 115 115 115 34 34 34 34 115 115 34 35 35 35 35 35 35 35 35 35 35 35 35
35 35 35 35 35 35 35 112 35 35 35 35 35 35 35 35 35 35 35 35 35 35 35 35 35 35 35 35 35 35 35 35 35 34 115 115 115 115 115 115 115 115 115 115 115 34 34 34 34 115 115 34 35 35 35 35 35 35 35 35 35 35 35 35
35 35 35 35 35 35 35 39 35 35 35 35 35 35 35 35 35 35 35 35 35 35 35 35 35 35 35 35 35 35 35 35 35 33 115 115 115 115 115 115 115 115 115 115 115 34 34 34 34 115 115 33 35 35 35 35 35 35 35 35 35 35 35 35
35 35 35 35 35 35 35 35 35 35 35 35 35 35 35 35 35 35 35 35 35 35 35 35 35 35 35 35 35 35 35 35 35 34 115 115 115 115 115 115 115 115 115 115 115 34 34 34 34 115 115 34 35 35 35 35 35 35 35 35 35 35 35 35
35 35 35 35 35 35 35 35 35 35 35 35 35 35 35 35 35 35 35 35 35 35 35 35 35 35 35 35 35 35 35 35 35 34 115 115 115 115 115 115 115 115 115 115 115 33 34 34 34 115 115 34 35 35 35 35 35 35 35 35 35 35 35 35
35 35 35 35 35 35 35 35 35 35 35 35 35 35 35 35 35 35 35 35 35 35 35 35 35 35 35 35 35 35 35 35 35 34 115 115 115 115 115 115 115 115 115 115 115 115 115 115 115 115 115 34 35 35 35 35 35 35 35 35 35 35 35 35
35 35 35 35 35 35 35 35 35 35 35 35 35 35 35 35 35 35 35 35 35 35 35 35 35 35 35 35 35 35 35 35 35 34 115 115 115 115 115 115 115 115 115 115 115 115 115 115 115 115 115 34 35 35 35 35 35 35 35 35 35 35 35 35
35 35 35 35 35 35 35 35 35 35 35 35 35 35 35 35 35 35 35 35 35 35 35 35 35 35 35 35 35 35 35 35 35 34 34 34 34 34 34 34 33 34 34 34 34 34 34 34 34 34 34 34 35 35 35 35 35 35 35 35 35 35 35 35
35 35 35 35 35 35 35 35 35 35 35 35 35 35 35 35 35 35 35 35 35 35 35 35 35 35 35 35 35 35 35 35 35 35 35 35 35 35 35 35 35 35 35 35 35 35 35 35 35 35 35 35 35 35 35 35 35 35 35 35 35 35 35 35
35 35 35 35 35 35 35 35 35 35 35 35 35 35 35 35 35 35 35 35 35 35 35 35 35 35 35 35 35 35 35 35 35 35 35 35 35 35 35 35 35 35 35 35 35 35 35 35 35 35 35 35 35 35 35 35 35 35 35 35 35 35 35 35
35 35 35 35 35 35 35 35 35 35 35 35 35 35 35 35 35 35 35 35 35 35 35 35 35 35 35 35 35 35 35 35 35 35 35 35 35 35 35 35 35 35 35 35 35 35 35 35 35 35 35 35 35 35 35 35 35 35 35 35 35 35 35 35
35 35 35 35 35 35 35 35 35 35 35 35 35 35 35 35 35 35 35 35 35 35 35 35 35 35 35 35 35 35 35 35 35 35 35 35 35 35 35 35 35 35 35 35 35 35 35 35 35 35 35 35 35 35 35 35 35 35 35 35 35 35 35 35
35 35 35 35 35 35 35 35 35 35 35 35 35 35 35 35 35 35 35 35 35 35 35 35 35 35 35 35 35 35 35 35 35 35 35 35 35 35 35 35 35 35 35 35 35 35 35 35 35 35 35 35 35 35 35 35 35 35 35 35 35 35 35 35
35 35 35 35 35 35 35 35 35 35 35 35 35 35 35 35 35 35 35 35 35 35 35 35 35 35 35 35 35 35 35 35 35 35 35 35 35 35 35 35 35 35 35 35 35 35 35 35 35 35 35 35 35 35 35 35 35 35 35 35 35 35 35 35
35 35 35 35 35 35 35 35 35 35 35 35 35 35 35 35 35 35 35 35 35 35 35 35 35 35 35 35 35 35 35 35 35 35 35 35 35 35 35 35 35 35 35 35 35 35 35 35 35 35 35 35 35 35 35 35 35 35 35 35 35 35 35 35
35 35 35 35 35 35 35 35 35 35 35 35 35 35 35 35 35 35 35 35 35 35 35 35 35 35 35 35 35 35 35 35 35 35 35 35 35 35 35 35 35 35 35 35 35 35 35 35 35 35 35 35 35 35 35 35 35 35 35 35 35 35 35 35
35 35 35 35 35 35 35 35 35 35 35 35 35 35 35 35 35 35 35 35 35 35 35 35 35 35 35 35 35 35 35 35 35 35 35 35 35 35 35 35 35 35 35 35 35 35 35 35 35 35 35 35 35 35 35 35 35 35 35 35 35 35 35 35
35 35 35 35 35 35 35 35 35 35 35 35 35 35 35 35 35 35 35 35 35 35 35 35 35 35 35 35 35 35 35 35 35 35 35 35 35 35 35 35 35 35 35 35 35 35 35 35 35 35 35 35 35 35 35 35 35 35 35 35 35 35 35 35
