1 1 1 1 1 1 1 1 1 1 1 1 1 1 1 1 1 1 1 1 1 1 1 1 1 1 1 1 1 1 1 1 1 1 1 1 1 1 1 1 1 1 1 1 1 1 1 1 1 1 1 1 1 1 1 1 1 1 1 1 1 1 1 1
1 1 1 1 1 1 1 1 1 1 1 1 1 1 1 1 1 1 1 1 1 1 1 1 1 1 1 1 1 1 1 1 1 1 1 1 1 1 1 1 1 1 1 1 1 1 1 1 1 1 1 1 1 1 1 1 1 1 1 1 1 1 1 1
1 1 1 1 1 1 1 1 1 1 1 1 1 1 1 1 1 1 1 1 1 1 1 1 1 1 1 1 1 1 1 1 1 1 1 1 1 1 1 1 1 1 1 1 1 1 1 1 1 1 1 1 1 1 1 1 1 1 1 1 1 1 1 1
1 1 1 1 1 1 1 1 1 1 1 1 1 1 1 1 1 1 1 1 1 1 1 1 1 1 1 1 1 1 1 1 1 1 1 1 1 1 1 1 1 1 1 1 1 1 1 1 1 1 1 1 1 1 1 1 1 1 1 1 1 1 1 1
1 1 1 1 1 1 1 1 1 1 1 1 1 1 1 1 1 1 1 1 1 1 1 1 1 1 1 1 1 1 1 1 1 1 1 1 1 1 1 1 1 1 1 1 1 1 1 1 1 1 1 1 1 1 1 1 1 1 1 1 1 1 1 1
1 1 1 1 1 1 1 1 1 1 1 1 1 1 1 1 1 1 1 1 1 1 1 1 1 1 1 1 1 1 1 1 1 1 1 1 1 1 1 1 1 1 1 1 1 1 1 1 1 1 1 1 1 1 1 1 1 1 1 1 1 1 1 1
1 1 1 1 1 1 1 1 1 1 1 1 1 1 1 1 1 1 1 1 1 1 1 1 1 1 1 1 1 1 1 1 1 1 1 1 1 1 1 1 1 1 1 1 1 1 1 1 1 1 1 1 1 1 1 1 1 1 1 1 1 1 1 1
1 1 1 1 1 1 1 1 1 1 1 1 1 1 1 1 1 1 1 1 1 1 1 1 1 1 1 1 1 1 1 1 1 1 1 1 1 1 1 1 1 1 1 1 1 1 1 1 1 1 1 1 1 1 1 1 1 1 1 1 1 1 1 1
1 1 1 1 1 1 1 1 1 1 1 1 1 1 1 1 1 1 1 1 1 1 1 1 1 1 1 1 1 1 1 1 1 1 1 1 1 1 1 1 1 1 1 1 1 1 1 1 1 1 1 1 1 1 1 1 1 1 1 1 1 1 1 1
1 1 1 1 1 1 1 1 1 1 1 1 1 1 1 1 1 1 1 1 1 1 1 1 1 1 1 1 1 1 1 1 1 1 1 1 1 1 1 1 1 1 1 1 1 1 1 1 1 1 1 1 1 1 1 1 1 1 1 1 1 1 1 1
1 1 1 1 1 1 1 1 1 1 1 1 1 1 1 1 1 1 1 1 1 1 1 1 1 1 1 1 1 1 1 1 1 1 1 1 1 1 1 1 1 1 1 1 1 1 1 1 1 1 1 1 1 1 1 1 1 1 1 1 1 1 1 1
1 1 1 1 1 1 1 1 1 1 1 1 1 1 1 1 1 1 1 1 1 1 1 1 1 1 1 1 1 1 1 1 1 1 1 1 1 1 1 1 1 1 1 1 1 1 1 1 1 1 1 1 1 1 1 1 1 1 1 1 1 1 1 1
1 1 1 1 1 1 1 1 1 1 1 1 1 1 1 1 1 1 1 1 1 1 1 1 1 1 1 1 1 1 1 1 1 1 1 1 1 1 1 1 1 1 1 1 1 1 1 1 1 1 1 1 1 1 1 1 1 1 1 1 1 1 1 1
1 1 1 1 1 1 1 1 1 1 1 1 1 1 1 1 1 1 1 1 1 1 1 1 1 1 1 1 1 1 1 1 1 1 1 1 1 1 1 1 1 1 1 1 1 1 1 1 1 1 1 1 1 1 1 1 1 1 1 1 1 1 1 1
1 1 1 1 1 1 1 1 1 1 1 1 1 1 1 1 1 1 1 1 1 1 1 1 1 1 1 1 1 1 1 1 1 1 1 1 1 1 1 1 1 1 1 1 1 1 1 1 1 1 1 1 1 1 1 1 1 1 1 1 1 1 1 1
1 1 1 1 1 1 1 1 1 1 1 1 1 1 1 1 1 1 1 1 1 1 1 1 1 1 1 1 1 1 1 1 1 1 1 1 1 1 1 1 1 1 1 1 1 1 1 1 1 1 1 1 1 1 1 1 1 1 1 1 1 1 1 1
1 1 1 1 1 1 1 1 1 1 1 1 1 1 1 1 1 1 1 1 1 1 1 1 1 1 1 1 1 1 1 1 1 1 1 1 1 1 1 1 1 1 1 1 1 1 1 1 1 1 1 1 1 1 1 1 1 1 1 1 1 1 1 1
1 1 1 1 1 1 1 1 1 1 1 1 1 1 1 1 1 1 1 1 1 1 1 1 1 1 1 1 1 1 1 1 1 1 1 1 1 1 1 1 1 1 1 1 1 1 1 1 1 1 1 1 1 1 1 1 1 1 1 1 1 1 1 1
1 1 1 1 1 1 1 1 1 1 1 1 1 1 1 1 1 1 1 1 1 1 1 1 1 1 1 1 1 1 1 1 1 1 1 1 1 1 1 1 1 1 1 1 1 1 1 1 1 1 1 1 1 1 1 1 1 1 1 1 1 1 1 1
1 1 1 1 1 1 1 1 1 1 1 1 1 1 1 1 1 1 1 1 1 1 1 1 1 1 1 1 1 1 35 35 35 35 35 1 1 1 1 1 1 1 1 1 1 1 1 1 1 1 1 1 1 1 1 1 1 1 1 1 1 1 1 1
1 1 1 1 1 1 1 1 1 1 1 1 1 1 1 1 1 1 1 1 1 1 1 1 1 1 1 1 1 1 35 35 13 35 35 1 1 1 1 1 1 1 1 1 1 1 1 1 1 1 1 1 1 1 1 1 1 1 1 1 1 1 1 1
1 1 1 1 1 1 1 1 1 1 1 1 1 1 1 1 1 1 1 1 1 1 35 35 35 39 35 35 35 35 35 108 108 108 35 35 39 35 35 35 35 35 35 1 1 1 1 1 1 1 1 1 1 1 1 1 1 1 1 1 1 1 1 1
1 1 1 1 1 1 1 1 1 1 1 1 1 1 1 1 1 1 1 1 1 35 35 108 108 108 108 108 108 33 108 108 108 108 108 33 108 108 108 108 108 108 35 35 1 1 1 1 1 1 1 1 1 1 1 1 1 1 1 1 1 1 1 1
1 1 1 1 1 1 1 1 1 1 1 1 1 1 1 1 1 1 1 1 35 35 108 108 108 108 108 108 108 90 108 108 108 108 108 90 108 108 108 108 108 108 108 35 35 1 1 1 1 1 1 1 1 1 1 1 1 1 1 1 1 1 1 1
1 1 1 1 1 1 1 1 1 1 1 1 1 1 1 1 1 1 1 1 35 108 108 108 108 108 108 108 108 33 108 108 108 108 108 33 108 108 108 108 108 108 108 108 35 1 1 1 1 1 1 1 1 1 1 1 1 1 1 1 1 1 1 1
1 1 1 1 1 1 1 1 1 1 1 1 1 1 1 1 1 1 1 1 35 108 108 108 108 35 35 35 35 35 35 108 108 108 35 35 35 35 35 35 108 108 108 108 35 1 1 1 1 1 1 1 1 1 1 1 1 1 1 1 1 1 1 1
1 1 1 1 1 1 1 1 1 1 1 1 1 1 1 1 1 1 1 1 35 108 108 108 108 35 40 40 40 40 40 36 91 36 40 40 40 40 40 35 108 108 108 108 39 1 1 1 1 1 1 1 1 1 35 43 49 43 43 49 43 35 1 1
1 1 1 1 1 1 1 1 1 1 1 1 1 1 1 1 1 1 1 1 35 108 108 108 108 35 40 40 40 40 40 108 108 108 40 40 40 40 40 35 108 108 108 108 35 1 1 1 1 1 1 1 1 1 35 110 110 110 110 110 110 35 1 1
1 1 1 1 1 1 1 1 1 1 1 1 1 1 1 1 1 1 1 1 39 108 108 108 108 35 40 40 40 108 108 108 108 108 108 108 40 40 40 35 108 108 108 108 35 1 1 1 1 1 1 1 1 1 43 110 110 110 110 110 110 43 1 1
1 1 1 1 1 1 1 1 1 1 1 1 1 1 1 1 1 1 1 1 35 108 108 108 108 35 40 40 108 108 108 108 108 108 108 108 108 40 40 39 108 108 108 108 35 1 1 1 1 1 1 1 1 1 35 110 110 110 110 110 110 35 1 1
1 1 1 1 1 1 1 1 1 1 1 1 1 1 1 1 1 1 1 1 35 108 108 108 108 35 40 40 108 108 108 108 108 108 108 108 108 40 40 35 108 108 108 108 35 1 1 1 1 1 1 1 1 1 39 110 110 110 110 110 110 35 1 1
1 1 1 1 1 1 1 1 1 1 1 1 1 1 1 1 1 1 1 1 33 108 108 108 108 108 33 34 91 34 40 34 91 34 40 34 91 34 33 108 108 108 108 108 33 1 1 1 1 1 1 1 1 1 35 110 110 110 110 110 110 35 1 1
1 1 1 1 1 1 1 1 1 1 1 1 1 1 1 1 1 1 35 35 35 91 39 35 91 35 35 109 109 109 109 109 109 109 109 109 109 109 35 39 91 35 35 91 35 35 35 1 1 1 1 1 1 1 35 110 110 110 110 110 110 35 1 1
1 1 1 1 1 1 1 1 1 1 1 1 1 1 1 1 1 1 35 109 109 109 109 109 109 109 109 109 109 109 109 109 109 109 109 109 109 109 109 109 109 109 109 109 109 109 39 1 1 1 1 1 1 1 35 110 110 110 110 110 110 35 1 1
1 1 1 1 1 1 1 1 1 1 1 1 1 1 1 1 1 1 35 109 109 109 109 109 109 109 109 109 109 109 109 109 109 109 109 109 109 109 109 109 109 109 109 109 109 109 35 1 35 35 39 35 35 35 35 110 110 110 110 110 110 35 1 1
1 1 1 1 1 1 1 1 1 1 1 1 1 1 1 1 1 1 39 109 109 109 109 109 109 109 42 109 109 109 109 109 109 109 109 109 109 109 42 109 109 109 109 109 109 109 37 35 35 110 110 110 110 110 110 110 110 110 110 110 110 39 1 1
1 1 1 1 1 1 1 1 1 1 1 1 1 1 1 1 1 1 49 109 109 109 109 109 109 109 46 109 109 109 109 109 109 109 109 109 109 109 46 109 109 109 109 109 109 109 49 110 110 110 106 110 110 110 106 110 110 110 110 110 110 35 1 1
1 1 1 1 1 1 1 1 1 1 1 1 1 1 1 1 1 1 35 109 109 109 109 109 109 109 42 109 109 109 109 109 109 109 109 109 109 109 42 109 109 109 109 109 109 109 92 110 106 110 110 110 106 110 110 110 106 110 110 106 110 35 1 1
1 1 1 1 1 1 1 1 1 1 1 1 1 1 1 1 1 1 39 109 109 109 109 109 109 109 46 109 109 109 109 42 47 46 109 109 109 109 46 109 109 109 109 109 109 109 49 110 110 110 106 110 110 110 106 110 110 110 110 110 110 35 1 1
1 1 1 1 1 35 35 35 35 35 37 39 35 35 35 35 35 35 35 109 109 109 109 109 109 109 42 109 109 109 109 46 47 42 109 109 109 109 42 109 109 109 109 109 109 109 39 35 35 110 110 110 110 110 110 110 110 110 110 110 110 35 1 1
1 1 1 1 35 39 109 109 109 109 109 109 109 109 109 35 35 35 35 109 109 109 109 109 109 109 42 109 109 109 109 109 109 109 109 109 109 109 42 109 109 109 109 109 109 109 35 35 35 35 35 35 39 35 35 35 35 35 35 35 35 35 35 1
1 1 1 1 35 109 109 109 109 109 109 109 109 109 109 109 35 35 39 109 109 109 109 109 109 109 47 109 109 109 109 109 109 109 109 109 109 109 47 109 109 109 109 109 109 109 35 35 35 35 35 35 35 35 35 35 35 35 35 35 35 35 35 1
1 1 1 1 35 109 109 109 109 109 109 109 109 109 109 109 35 35 35 109 109 109 109 109 109 109 42 109 109 109 109 109 109 109 109 109 109 109 42 109 109 109 109 109 109 109 37 35 35 35 35 35 35 35 35 35 35 35 35 35 35 35 35 1
1 1 1 1 35 109 109 109 109 109 109 109 109 109 109 109 37 35 37 109 109 109 109 109 109 109 46 109 109 109 109 42 47 46 109 109 109 109 42 109 109 109 109 109 109 109 35 35 35 35 35 35 35 35 35 35 35 35 35 35 35 35 35 1
1 1 1 1 35 109 109 109 109 109 109 109 109 109 109 109 39 35 35 109 109 109 109 109 109 109 42 109 109 109 109 46 47 42 109 109 109 109 46 109 109 109 109 109 109 109 35 35 35 35 35 35 35 35 35 35 39 35 35 35 35 35 35 1
1 1 1 1 35 109 109 109 109 109 109 109 109 109 109 109 35 35 35 109 109 109 109 109 109 109 47 109 109 109 109 109 109 109 109 109 109 109 47 109 109 109 109 109 109 109 35 35 35 35 35 35 109 109 109 109 109 109 109 109 109 35 35 1
1 1 1 1 39 109 109 109 109 109 109 109 109 109 109 109 35 35 35 109 109 109 109 109 109 109 42 109 109 109 109 109 109 109 109 109 109 109 42 109 109 109 109 109 109 109 39 35 35 35 109 109 109 109 109 109 109 109 109 109 109 109 35 1
1 1 1 1 35 109 109 109 109 109 109 109 109 109 109 109 35 35 35 109 109 109 109 109 109 109 46 109 109 46 47 46 42 46 47 46 109 109 46 109 109 109 109 109 109 109 35 35 35 35 109 109 109 109 109 109 109 109 109 109 109 109 39 1
1 1 1 1 37 109 109 109 109 109 109 109 109 109 109 35 35 35 35 109 109 109 109 109 109 109 42 109 109 42 46 42 46 42 46 42 109 109 42 109 109 109 109 109 109 109 35 35 39 35 109 109 109 109 109 109 109 109 109 109 109 109 35 1
1 1 1 1 35 109 109 109 109 109 109 109 109 109 109 39 109 109 49 109 109 109 109 109 109 109 109 109 109 109 109 109 109 109 109 109 109 109 109 109 109 109 109 109 109 109 49 109 109 39 109 109 109 109 109 109 109 109 109 109 109 109 35 1
1 1 1 1 35 109 109 109 109 109 109 109 109 109 109 35 35 109 35 109 109 109 109 109 109 109 109 109 109 109 109 109 109 109 109 109 109 109 109 109 109 109 109 109 109 109 35 109 35 35 109 109 109 109 109 109 109 109 109 109 109 109 35 1
1 1 1 1 35 109 109 109 109 109 109 109 109 109 109 109 109 109 35 35 35 91 39 35 37 35 35 91 35 35 109 109 109 109 109 35 35 91 35 35 37 35 39 91 35 35 35 109 109 109 109 109 109 109 109 109 109 109 109 109 109 109 35 1
1 1 1 1 35 109 109 109 109 109 109 109 109 109 109 109 109 109 35 35 141 141 141 141 141 141 141 141 141 35 109 109 109 109 109 35 138 138 138 138 138 138 138 138 138 35 35 35 35 35 109 109 109 109 109 109 109 109 109 109 109 109 35 1
1 1 1 1 35 35 109 109 109 109 109 109 109 109 109 109 109 109 35 35 141 141 141 141 141 141 141 141 141 35 35 35 109 35 39 35 138 138 138 138 138 138 138 138 138 39 35 1 1 35 35 35 109 109 109 109 109 109 109 109 109 35 35 1
1 1 1 1 1 35 35 35 39 35 35 37 35 35 35 39 35 35 35 35 141 141 141 141 141 141 141 141 141 39 35 35 49 35 35 35 138 138 138 138 138 138 138 138 138 35 35 1 1 1 1 35 35 35 35 35 35 35 35 39 35 35 1 1
1 1 1 1 1 1 1 1 1 1 1 1 1 1 1 1 1 1 35 35 141 141 141 35 49 35 141 141 141 35 35 35 35 35 35 35 138 138 138 35 49 35 138 138 138 35 35 1 1 1 1 1 1 1 1 1 1 1 1 1 1 1 1 1
1 1 1 1 1 1 1 1 1 1 1 1 1 1 1 1 1 1 35 37 141 141 35 35 35 35 35 141 141 37 35 35 35 35 35 37 138 138 35 35 35 35 35 138 138 37 35 1 1 1 1 1 1 1 1 1 1 1 1 1 1 1 1 1
1 1 1 1 1 1 1 1 1 1 1 1 1 1 1 1 1 1 35 35 141 141 141 35 49 35 141 141 141 35 35 35 35 35 35 35 138 138 138 35 49 35 138 138 138 35 35 1 1 1 1 1 1 1 1 1 1 1 1 1 1 1 1 1
1 1 1 1 1 1 1 1 1 1 1 1 1 1 1 1 1 1 35 35 141 141 141 141 141 141 141 141 141 35 35 35 35 35 35 35 138 138 138 138 138 138 138 138 138 35 35 1 1 1 1 1 1 1 1 1 1 1 1 1 1 1 1 1
1 1 1 1 1 1 1 1 1 1 1 1 1 1 1 1 1 1 35 39 141 141 141 141 141 141 141 141 141 35 35 35 35 35 35 39 138 138 138 138 138 138 138 138 138 35 35 1 1 1 1 1 1 1 1 1 1 1 1 1 1 1 1 1
1 1 1 1 1 1 1 1 1 1 1 1 1 1 1 1 1 1 35 35 141 141 141 141 141 141 141 141 141 35 35 35 35 35 35 35 138 138 138 138 138 138 138 138 138 35 35 1 1 1 1 1 1 1 1 1 1 1 1 1 1 1 1 1
1 1 1 1 1 1 1 1 1 1 1 1 1 1 1 1 1 1 35 35 35 35 35 35 35 39 35 35 35 35 35 35 35 35 35 35 35 35 35 39 35 35 35 39 35 35 35 1 1 1 1 1 1 1 1 1 1 1 1 1 1 1 1 1
1 1 1 1 1 1 1 1 1 1 1 1 1 1 1 1 1 1 35 35 35 35 35 35 35 35 35 35 35 35 35 35 35 35 35 35 35 35 35 35 35 35 35 35 35 35 35 1 1 1 1 1 1 1 1 1 1 1 1 1 1 1 1 1
1 1 1 1 1 1 1 1 1 1 1 1 1 1 1 1 1 1 1 1 1 1 1 1 1 1 1 1 1 1 1 1 1 1 1 1 1 1 1 1 1 1 1 1 1 1 1 1 1 1 1 1 1 1 1 1 1 1 1 1 1 1 1 1
