29 29 29 29 29 29 29 29 29 29 29 29 29 29 29 29 29 29 29 29 29 29 29 29 29 29 29 29 29 29 29 29 29 29 29 29 29 29 29 29 29 29 29 29 29 29 29 29 29 29 29 29 29 29 29 29 29 29 29 29 29 29 29 29
29 29 29 29 29 29 29 29 29 29 29 29 29 29 29 29 29 29 29 29 29 29 29 29 29 29 29 29 29 29 29 29 29 29 29 29 120 120 120 120 120 120 120 120 120 120 120 29 29 29 29 29 29 29 29 29 29 29 29 29 29 29 29 29
29 29 29 29 29 29 29 29 29 29 29 29 29 29 29 29 29 29 29 29 29 29 29 29 29 29 29 29 29 29 29 29 29 29 29 120 120 120 120 120 120 120 120 120 120 120 120 29 29 29 29 29 29 29 29 29 29 29 29 29 29 29 29 29
29 29 29 29 29 29 29 29 29 29 29 29 29 29 29 29 29 29 29 29 29 29 29 29 29 29 29 29 29 29 29 29 29 13 29 120 120 120 120 120 120 120 120 120 120 120 120 29 29 29 29 29 29 29 29 29 29 29 29 29 29 29 29 29
29 29 29 29 29 29 29 29 29 29 29 29 29 29 29 29 29 29 29 29 29 29 29 29 29 29 29 29 29 29 29 29 29 120 29 29 29 29 29 29 29 29 29 29 29 29 29 29 29 29 29 29 29 29 29 29 29 29 29 29 29 29 29 29
29 29 29 29 29 29 29 29 29 29 29 29 29 29 29 29 29 29 29 29 29 29 29 29 29 29 29 29 29 120 120 120 120 120 120 120 120 120 29 29 29 29 29 29 29 29 29 29 29 29 29 29 29 29 29 29 29 29 29 29 29 29 29 29
29 29 29 29 29 29 29 29 29 29 29 29 29 29 29 29 29 29 29 29 29 29 29 29 29 29 29 29 29 120 29 29 29 120 29 29 29 120 29 29 29 29 29 29 29 29 29 29 29 29 29 29 29 29 29 29 29 29 29 29 29 29 29 29
29 29 29 29 29 29 29 29 29 29 29 29 29 29 29 29 29 29 29 29 29 29 29 29 29 29 29 29 29 120 29 29 29 120 30 29 29 120 29 29 29 29 29 29 29 29 29 29 29 29 29 29 29 29 29 29 29 29 29 29 29 29 29 29
29 29 29 29 29 29 29 29 29 29 29 29 29 29 29 29 29 29 29 29 29 29 29 29 29 29 29 29 29 120 29 29 29 120 29 29 29 120 29 29 29 29 29 29 29 29 29 29 29 29 29 29 29 29 29 29 29 29 29 29 29 29 29 29
29 29 29 29 29 29 29 29 29 29 29 29 29 29 29 29 29 29 29 29 29 29 29 29 29 120 120 120 120 120 120 120 120 120 120 120 120 120 120 120 120 120 29 29 29 29 29 29 29 29 29 29 29 29 29 29 29 29 29 29 29 29 29 29
29 29 29 29 29 29 29 29 29 29 29 29 29 29 29 29 29 29 29 29 29 29 29 29 29 120 29 29 29 120 29 29 29 29 29 29 29 120 29 29 29 120 29 29 29 29 29 29 29 29 29 29 29 29 29 29 29 29 29 29 29 29 29 29
29 29 29 29 29 29 29 29 29 29 29 29 29 29 29 29 29 29 29 29 29 29 29 29 29 120 29 29 29 120 29 29 29 29 29 29 29 120 30 29 29 120 29 29 29 29 29 29 29 29 29 29 29 29 29 29 29 29 29 29 29 29 29 29
29 29 29 29 29 29 29 29 29 29 29 29 29 29 29 29 29 29 29 29 29 29 29 29 29 120 29 29 29 120 29 29 29 29 29 29 29 120 29 29 29 120 29 29 29 29 29 29 29 29 29 29 29 29 29 29 29 29 29 29 29 29 29 29
29 29 29 29 29 29 29 29 29 29 29 29 29 29 29 29 29 29 29 29 29 120 120 120 120 120 120 120 120 120 120 120 120 120 120 120 120 120 120 120 120 120 120 120 120 120 29 29 29 29 29 29 29 29 29 29 29 29 29 29 29 29 29 29
29 29 29 29 29 29 29 29 29 29 29 29 29 29 29 29 29 29 29 29 29 120 29 29 29 120 29 29 29 120 29 29 29 120 29 29 29 120 29 30 29 120 29 29 29 120 29 29 29 29 29 29 29 29 29 29 29 29 29 29 29 29 29 29
29 29 29 29 29 29 29 29 29 29 29 29 29 29 29 29 29 29 29 29 29 120 29 29 29 120 29 29 29 120 29 29 29 120 29 29 29 120 29 29 29 120 30 29 29 120 29 29 29 29 29 29 29 29 29 29 29 29 29 29 29 29 29 29
29 29 29 29 29 29 29 29 29 29 29 29 29 29 29 29 29 29 29 29 29 120 29 29 29 120 29 29 29 120 29 29 29 120 29 29 29 120 29 29 29 120 29 29 29 120 29 29 29 29 29 29 29 29 29 29 29 29 29 29 29 29 29 29
29 29 29 29 29 29 29 29 29 29 29 29 29 29 29 29 29 120 120 120 120 120 29 29 29 120 120 120 120 120 120 120 120 120 120 120 120 120 120 120 120 120 120 120 120 120 120 120 120 120 29 29 29 29 29 29 29 29 29 29 29 29 29 29
29 29 29 29 29 29 29 29 29 29 29 29 29 29 29 29 29 120 29 29 29 120 29 29 29 120 29 29 29 120 29 29 29 120 29 29 29 120 29 29 29 120 29 29 29 120 29 29 29 120 29 29 29 29 29 29 29 29 29 29 29 29 29 29
29 29 29 29 29 29 29 29 29 29 29 29 29 29 29 29 29 120 29 29 29 120 29 29 29 120 29 29 29 120 29 29 29 120 29 29 29 120 29 29 29 120 30 29 29 120 29 29 29 120 29 29 29 29 29 29 29 29 29 29 29 29 29 29
29 29 29 29 29 29 29 29 29 29 29 29 29 29 29 29 29 120 29 29 29 120 29 29 29 120 29 29 29 120 29 29 29 120 29 29 29 120 29 29 29 120 29 30 29 120 29 29 29 120 29 29 29 29 29 29 29 29 29 29 29 29 29 29
29 29 29 29 29 29 29 29 29 29 29 29 29 120 120 120 120 120 120 120 120 120 120 120 120 120 120 120 120 120 120 120 120 120 29 29 29 120 120 120 120 120 120 120 120 120 120 120 120 120 120 120 120 120 29 29 29 29 29 29 29 29 29 29
29 29 29 29 29 29 29 29 29 29 29 29 29 120 29 29 29 120 29 29 29 120 29 29 29 120 29 29 29 120 29 29 29 120 29 29 29 120 29 29 29 29 29 29 29 120 29 29 29 120 29 29 29 120 29 29 29 29 29 29 29 29 29 29
29 29 29 29 29 29 29 29 29 29 29 29 29 120 29 29 29 120 29 29 29 120 29 29 29 120 29 29 29 120 29 29 29 120 29 29 29 120 29 29 29 29 29 29 29 120 30 29 29 120 29 29 29 120 29 29 29 29 29 29 29 29 29 29
29 29 29 29 29 29 29 29 29 29 29 29 29 120 29 29 29 120 29 29 29 120 29 29 29 120 29 29 29 120 29 29 29 120 29 29 29 120 29 29 29 29 29 29 29 120 29 29 29 120 29 29 29 120 29 29 29 29 29 29 29 29 29 29
29 29 29 29 29 29 29 29 29 120 120 120 120 120 120 120 120 120 29 29 29 120 120 120 120 120 120 120 120 120 120 120 120 120 120 120 120 120 120 120 120 120 120 120 120 120 29 29 29 120 120 120 120 120 120 120 120 120 29 29 29 29 29 29
29 29 29 29 29 29 29 29 29 120 29 29 29 120 29 29 29 120 29 29 29 120 29 29 29 120 29 29 29 29 29 29 29 120 29 29 29 120 29 29 29 120 29 29 29 120 29 29 29 120 29 29 29 29 29 29 29 120 29 29 29 29 29 29
29 29 29 29 29 29 29 29 29 120 29 29 29 120 29 29 29 120 29 29 29 120 29 29 29 120 29 29 29 29 29 29 29 120 29 29 29 120 29 29 29 120 29 29 30 120 29 29 29 120 29 29 29 29 29 29 29 120 29 29 29 29 29 29
29 29 29 29 29 29 29 29 29 120 29 29 29 120 29 29 29 120 29 29 29 120 29 29 29 120 29 29 29 29 29 29 29 120 29 29 29 120 29 29 29 120 29 29 29 120 29 29 29 120 29 29 29 29 29 29 29 120 29 29 29 29 29 29
29 29 29 29 29 120 120 120 120 120 120 120 120 120 120 120 120 120 120 120 120 120 120 120 120 120 120 120 120 120 120 120 120 120 120 120 120 120 120 120 120 120 120 120 120 120 120 120 120 120 120 120 120 120 120 120 120 120 120 120 120 120 29 29
29 29 29 29 29 120 29 29 29 120 29 29 29 120 29 29 29 120 29 29 29 120 29 29 29 120 29 29 29 120 29 29 29 120 29 29 29 120 29 29 29 120 29 29 29 120 29 29 29 120 29 29 29 120 29 29 29 120 29 29 29 120 29 29
29 29 29 29 29 120 29 29 29 120 29 29 29 120 29 29 29 120 29 29 29 120 29 29 29 120 29 29 29 120 29 29 29 120 29 29 29 120 29 29 30 120 29 29 29 120 29 29 29 120 29 29 29 120 29 29 29 120 29 29 29 120 29 29
29 29 29 29 29 120 29 29 29 120 29 29 29 120 29 29 29 120 29 29 29 120 29 29 29 120 29 29 29 120 29 29 29 120 29 29 29 120 29 29 29 120 29 29 29 120 29 29 29 120 29 29 29 120 29 29 29 120 29 29 29 120 29 29
29 120 120 120 120 120 120 120 120 120 120 120 120 120 120 120 120 120 120 120 120 120 120 120 120 120 120 120 120 120 120 120 120 120 120 120 120 120 120 120 120 120 29 29 29 120 120 120 120 120 120 120 120 120 120 120 120 120 120 120 120 120 29 29
29 120 29 29 29 120 29 29 29 29 29 29 29 120 29 29 29 120 29 29 29 120 29 29 29 120 29 29 29 120 29 29 29 120 29 29 29 120 29 30 29 120 29 29 29 120 29 29 29 120 29 29 29 120 29 29 29 120 29 29 29 120 29 29
29 120 29 29 29 120 29 29 29 29 29 29 29 120 29 29 29 120 29 29 29 120 29 29 29 120 29 29 29 120 29 29 29 120 29 29 29 120 30 29 29 120 29 29 29 120 29 29 29 120 29 29 29 120 29 29 29 120 29 29 29 120 29 29
29 120 29 29 29 120 29 29 29 29 29 29 29 120 29 29 29 120 29 29 29 120 29 29 29 120 29 29 29 120 29 30 29 120 29 29 29 120 29 29 29 120 29 29 29 120 29 29 29 120 29 29 29 120 29 29 29 120 29 29 29 120 29 29
29 120 120 120 120 120 120 120 120 120 120 120 120 120 120 120 120 120 120 120 120 120 29 29 29 120 120 120 120 120 120 120 120 120 120 120 120 120 29 29 29 120 120 120 120 120 120 120 120 120 120 120 120 120 29 29 29 120 120 120 120 120 29 29
29 29 29 29 29 120 29 29 29 120 29 29 29 120 29 29 29 120 29 29 29 120 29 29 29 120 29 29 29 120 29 29 29 29 29 30 29 120 29 29 29 120 29 29 29 120 29 29 29 120 29 29 29 120 29 29 29 120 29 29 29 29 29 29
29 29 29 29 29 120 29 29 29 120 29 29 29 120 29 29 29 120 29 29 29 120 29 29 29 120 29 29 29 120 30 29 29 29 29 29 29 120 29 29 29 120 29 29 29 120 29 29 29 120 29 29 29 120 29 29 29 120 29 29 29 29 29 29
29 29 29 29 29 120 29 29 29 120 29 29 29 120 29 29 29 120 29 29 29 120 29 29 29 120 29 30 29 120 29 29 29 29 29 29 29 120 29 29 29 120 29 29 29 120 29 29 29 120 29 29 29 120 29 29 29 120 29 29 29 29 29 29
29 29 29 29 29 120 120 120 120 120 29 29 29 120 120 120 120 120 120 120 120 120 120 120 120 120 120 120 120 120 120 120 120 120 120 120 120 120 120 120 120 120 120 120 120 120 120 120 120 120 120 120 120 120 120 120 120 120 29 29 29 29 29 29
29 29 29 29 29 29 29 29 29 120 29 29 29 120 29 29 29 120 29 29 29 120 29 29 29 120 29 29 29 120 29 29 29 29 29 29 29 120 29 29 29 120 29 29 29 120 29 29 29 120 29 29 29 120 29 29 29 29 29 29 29 29 29 29
29 29 29 29 29 29 29 29 29 120 29 29 29 120 29 29 29 120 29 29 29 120 29 29 30 120 29 29 29 120 29 29 29 29 29 29 29 120 29 29 29 120 29 29 29 120 29 29 29 120 29 29 29 120 29 29 29 29 29 29 29 29 29 29
29 29 29 29 29 29 29 29 29 120 29 29 29 120 29 29 29 120 29 29 29 120 29 29 29 120 29 29 29 120 29 29 29 29 29 29 29 120 120 120 120 120 29 29 29 120 29 29 29 120 29 29 29 120 29 29 29 29 29 29 29 29 29 29
29 29 29 29 29 29 29 29 29 120 120 120 120 120 120 120 120 120 120 120 120 120 120 120 120 120 120 120 120 120 29 29 29 29 29 21 29 120 29 29 29 120 29 29 29 120 120 120 120 120 120 120 120 120 29 29 29 29 29 29 29 29 29 29
29 29 29 29 29 29 29 29 29 29 29 29 29 120 29 29 29 120 29 29 29 29 29 29 29 120 29 29 29 120 29 29 29 29 21 108 100 120 29 29 29 120 29 29 29 120 29 29 29 120 29 29 29 29 29 29 29 29 29 29 29 29 29 29
29 29 29 29 29 29 29 29 29 29 29 29 29 120 29 29 29 120 29 29 29 29 29 29 29 120 30 29 29 120 29 29 29 29 29 21 29 120 30 29 29 120 29 29 29 120 29 29 29 120 29 29 29 29 29 29 29 29 29 29 29 29 29 29
29 29 29 29 29 29 29 29 29 29 29 29 29 120 29 29 29 120 29 29 29 29 29 29 29 120 29 29 29 120 29 29 29 29 29 29 29 120 29 29 29 120 29 29 29 120 29 29 29 120 29 29 29 29 29 29 29 29 29 29 29 29 29 29
29 29 29 29 29 29 29 29 29 29 29 29 29 120 120 120 120 120 120 120 120 120 120 120 120 120 120 120 120 120 120 120 120 120 120 120 120 120 120 120 120 120 120 120 120 120 120 120 120 120 29 29 29 29 29 29 29 29 29 29 29 29 29 29
29 29 29 29 29 29 29 29 29 29 29 29 29 29 29 29 29 120 29 29 29 120 29 29 29 120 29 29 29 29 29 29 29 120 29 30 29 120 29 29 29 120 29 29 29 120 29 29 29 29 29 29 29 29 29 29 29 29 29 29 29 29 29 29
29 29 29 29 29 29 29 29 29 29 29 29 29 29 29 29 29 120 29 29 29 120 29 29 30 120 29 29 29 29 29 29 30 120 29 29 29 120 29 29 29 120 29 29 29 120 29 29 29 29 29 29 29 29 29 29 29 29 29 29 29 29 29 29
29 29 29 29 29 29 29 29 29 29 29 29 29 29 29 29 29 120 29 29 29 120 29 29 29 120 29 30 29 29 29 29 29 120 29 29 29 120 29 29 29 120 29 29 29 120 29 29 29 29 29 29 29 29 29 29 29 29 29 29 29 29 29 29
29 29 29 29 29 29 29 29 29 29 29 29 29 29 29 29 29 120 120 120 120 120 120 120 120 120 120 120 120 120 120 120 120 120 120 120 120 120 120 120 120 120 120 120 120 120 29 29 29 29 29 29 29 29 29 29 29 29 29 29 29 29 29 29
29 29 29 29 29 29 29 29 29 29 29 29 29 29 29 29 29 29 29 29 29 120 29 29 29 120 29 29 29 120 29 30 29 120 29 29 29 29 29 29 29 120 29 29 29 29 29 29 29 29 29 29 29 29 29 29 29 29 29 29 29 29 29 29
29 29 29 29 29 29 29 29 29 29 29 29 29 29 29 29 29 29 29 29 29 120 29 29 29 120 29 29 29 120 29 29 29 120 29 29 29 29 29 29 29 120 29 29 29 29 29 29 29 29 29 29 29 29 29 29 29 29 29 29 29 29 29 29
29 29 29 29 29 29 29 29 29 29 29 29 29 29 29 29 29 29 29 29 29 120 29 29 29 120 29 29 29 120 29 29 29 120 29 29 29 29 29 29 29 120 29 29 29 29 29 29 29 29 29 29 29 29 29 29 29 29 29 29 29 29 29 29
29 29 29 29 29 29 29 29 29 29 29 29 29 29 29 29 29 29 29 29 29 120 120 120 120 120 29 29 29 120 120 120 120 120 120 120 120 120 120 120 120 120 29 29 29 29 29 29 29 29 29 29 29 29 29 29 29 29 29 29 29 29 29 29
29 29 29 29 29 29 29 29 29 29 29 29 29 29 29 29 29 29 29 29 29 29 29 29 29 120 29 29 29 120 29 29 29 120 29 29 29 120 29 29 29 29 29 29 29 29 29 29 29 29 29 29 29 29 29 29 29 29 29 29 29 29 29 29
29 29 29 29 29 29 29 29 29 29 29 29 29 29 29 29 29 29 29 29 29 29 29 29 29 120 29 29 29 120 29 29 29 120 29 29 29 120 29 29 29 29 29 29 29 29 29 29 29 29 29 29 29 29 29 29 29 29 29 29 29 29 29 29
29 29 29 29 29 29 29 29 29 29 29 29 29 29 29 29 29 29 29 29 29 29 29 29 29 120 29 29 29 120 29 29 29 120 29 29 29 120 29 29 29 29 29 29 29 29 29 29 29 29 29 29 29 29 29 29 29 29 29 29 29 29 29 29
29 29 29 29 29 29 29 29 29 29 29 29 29 29 29 29 29 29 29 29 29 29 29 29 29 120 120 120 120 120 120 120 120 120 120 120 120 120 29 29 29 29 29 29 29 29 29 29 29 29 29 29 29 29 29 29 29 29 29 29 29 29 29 29
29 29 29 29 29 29 29 29 29 29 29 29 29 29 29 29 29 29 29 29 29 29 29 29 29 29 29 29 29 29 29 29 29 29 29 29 29 29 29 29 29 29 29 29 29 29 29 29 29 29 29 29 29 29 29 29 29 29 29 29 29 29 29 29
29 29 29 29 29 29 29 29 29 29 29 29 29 29 29 29 29 29 29 29 29 29 29 29 29 29 29 29 29 29 29 29 29 29 29 29 29 29 29 29 29 29 29 29 29 29 29 29 29 29 29 29 29 29 29 29 29 29 29 29 29 29 29 29
