1 1 1 1 1 1 1 1 1 1 1 1 1 1 1 1 1 1 1 1 1 1 1 1 1 1 1 1 1 1 1 1 1 1 1 1 1 1 1 1 1 1 1 1 1 1 1 1 1 1 1 1 1 1 1 1 1 1 1 1 1 1 1 1
1 1 1 1 1 1 1 1 1 1 1 1 1 1 1 1 1 1 1 1 1 1 1 1 1 1 1 1 1 1 1 1 1 1 1 1 1 1 1 1 1 1 1 1 1 1 1 1 1 1 1 1 1 1 1 1 1 1 1 1 1 1 1 1
1 1 1 1 1 1 1 1 1 1 1 1 1 1 1 1 1 1 1 1 1 1 1 1 1 1 1 1 1 1 1 1 1 1 1 1 1 1 1 1 1 1 1 1 1 1 1 1 1 1 1 1 1 1 1 1 1 1 1 1 1 1 1 1
1 1 1 1 1 1 1 1 1 1 1 1 1 1 1 1 1 1 1 1 1 1 1 1 1 1 1 1 1 1 1 1 1 1 1 1 1 1 1 1 1 1 1 1 1 1 1 1 1 1 1 1 1 1 1 1 1 1 1 1 1 1 1 1
1 1 1 1 1 1 1 1 1 1 1 1 1 1 1 1 1 1 1 1 1 1 1 1 1 1 1 1 1 1 1 1 1 1 1 1 1 1 1 1 1 1 1 1 1 1 1 1 1 1 1 1 1 1 1 1 1 1 1 1 1 1 1 1
1 1 1 1 1 1 1 1 1 1 1 1 1 1 1 1 1 1 1 1 1 1 1 1 1 1 1 1 1 1 1 1 1 1 1 1 1 1 1 1 1 1 1 1 1 1 1 1 1 1 1 1 1 1 1 1 1 1 1 1 1 1 1 1
1 1 1 1 1 1 1 1 1 1 1 1 1 1 1 1 1 1 1 1 1 1 1 1 1 1 1 1 1 1 1 1 1 1 1 1 1 1 1 1 1 1 1 1 1 1 1 1 1 1 1 1 1 1 1 1 1 1 1 1 1 1 1 1
1 1 1 1 1 1 1 1 1 1 1 1 1 1 1 1 1 1 1 1 1 1 1 1 1 1 1 1 1 1 1 1 1 1 1 1 1 1 1 1 1 1 1 1 1 1 1 1 1 1 1 1 1 1 1 1 1 1 1 1 1 1 1 1
1 1 1 1 1 1 1 1 1 1 1 1 1 1 1 1 1 1 1 1 1 1 1 1 1 1 1 1 1 1 1 1 1 1 1 1 1 1 1 1 1 1 1 1 1 1 1 1 1 1 1 1 1 1 1 1 1 1 1 1 1 1 1 1
1 1 1 1 1 1 1 1 1 1 1 1 1 1 1 1 1 1 1 1 1 1 1 1 1 1 1 1 1 1 1 1 1 1 1 1 1 1 1 1 1 1 1 1 1 1 1 1 1 1 1 1 1 1 1 1 1 1 1 1 1 1 1 1
1 1 1 1 1 1 1 1 1 1 1 1 1 1 1 1 1 1 1 1 1 1 1 1 1 1 1 1 1 1 1 1 1 1 1 1 1 1 1 1 1 1 1 1 1 1 1 1 1 1 1 1 1 1 1 1 1 1 1 1 1 1 1 1
1 1 1 1 1 1 1 1 1 1 1 1 1 1 1 1 1 1 1 1 1 1 1 1 1 1 1 1 1 1 1 1 1 1 1 1 1 1 1 1 1 1 1 1 1 1 1 1 1 1 1 1 1 1 1 1 1 1 1 1 1 1 1 1
1 1 1 1 1 1 1 1 1 1 1 1 1 1 1 1 1 1 1 1 1 1 1 1 1 1 1 1 1 1 1 1 1 1 1 1 1 1 1 1 1 1 1 1 1 1 1 1 1 1 1 1 1 1 1 1 1 1 1 1 1 1 1 1
1 1 1 1 1 1 1 1 1 1 1 1 1 1 1 1 1 1 1 1 1 1 1 1 1 1 1 1 1 1 1 1 1 1 1 1 1 1 1 1 1 1 1 1 1 1 1 1 1 1 1 1 1 1 1 1 1 1 1 1 1 1 1 1
1 1 1 1 1 1 1 1 1 1 1 1 1 1 1 1 1 1 1 1 1 1 1 1 1 1 1 1 1 1 1 1 1 1 1 1 1 1 1 1 1 1 1 1 1 1 1 1 1 1 1 1 1 1 1 1 1 1 1 1 1 1 1 1
1 1 1 1 1 1 1 1 1 1 1 1 1 1 1 1 1 1 1 1 1 1 1 17 17 17 17 1 1 1 1 1 1 1 1 1 1 1 1 1 1 1 1 1 1 1 1 1 1 1 1 1 1 1 1 1 1 1 1 1 1 1 1 1
1 1 1 1 1 1 1 1 1 1 1 1 1 1 1 1 1 1 1 17 17 17 17 17 112 112 17 1 1 1 1 1 1 1 1 1 1 1 1 1 1 1 1 1 1 1 1 1 1 1 1 1 1 1 1 1 1 1 1 1 1 1 1 1
1 1 1 1 1 1 1 1 1 1 1 1 1 1 1 1 1 1 1 17 112 112 106 112 112 112 17 1 1 1 1 1 1 1 1 1 1 1 1 1 1 1 1 1 1 1 1 1 1 1 1 1 1 1 1 1 1 1 1 1 1 1 1 1
1 1 1 1 1 1 1 1 1 1 1 1 1 1 1 1 1 1 1 17 112 17 20 17 112 17 17 1 6 1 2 1 1 1 1 1 6 1 1 1 1 1 1 1 1 1 1 1 1 1 1 1 1 1 1 1 1 1 1 1 1 1 1 1
1 1 1 1 1 1 1 1 1 1 1 1 1 1 1 1 17 17 17 17 112 18 17 18 112 17 1 110 110 110 1 1 1 1 1 110 110 110 2 1 1 1 1 1 1 1 1 1 1 1 1 1 1 1 1 1 1 1 1 1 1 1 1 1
1 1 1 1 1 1 1 1 1 1 1 1 1 1 1 1 17 17 17 17 112 17 20 17 112 17 2 110 110 110 2 1 1 1 2 110 110 110 1 1 1 1 1 1 1 1 1 1 1 1 1 1 1 1 1 1 1 1 1 1 1 1 1 1
1 1 1 17 17 20 17 17 1 1 1 1 1 1 1 1 17 112 112 106 112 112 112 112 112 17 1 110 110 110 1 1 2 1 1 110 110 110 1 1 1 1 1 1 1 1 1 1 1 1 1 1 1 1 1 1 1 1 1 1 1 1 1 1
1 1 1 17 106 112 112 17 1 1 1 1 1 1 1 1 17 112 17 17 112 17 17 17 17 17 2 1 2 110 2 1 110 2 1 110 2 1 1 1 1 1 1 1 1 1 1 1 1 1 1 1 1 1 1 1 1 1 1 1 1 1 1 1
1 1 1 17 112 112 112 17 1 1 1 1 1 17 17 17 17 112 17 17 112 17 1 1 1 1 1 1 1 110 110 110 110 110 110 110 1 1 1 1 1 1 1 1 1 1 1 1 1 1 1 1 1 1 1 1 1 1 1 1 1 1 1 1
1 1 1 17 106 112 112 17 1 1 1 1 1 17 112 112 112 112 112 112 112 17 1 1 1 2 1 3 2 1 2 1 4 1 2 1 1 3 1 2 1 1 1 1 1 1 1 1 1 1 1 1 1 1 1 1 1 1 1 1 1 1 1 1
1 1 1 17 17 112 17 17 1 1 1 1 1 17 112 17 17 17 112 17 17 17 1 1 2 110 110 110 110 110 110 110 110 110 110 110 110 110 110 110 2 1 1 1 1 1 1 1 1 1 1 1 1 1 1 1 1 1 1 1 1 1 1 1
1 1 1 17 17 112 17 17 1 1 1 1 17 17 112 17 17 17 106 17 17 17 1 1 1 110 110 110 110 110 110 110 110 110 110 110 110 110 110 110 1 1 1 1 1 1 1 1 1 1 1 1 1 1 1 1 1 1 1 1 1 1 1 1
1 1 1 17 17 112 17 17 17 17 17 17 17 112 112 112 17 17 112 17 17 17 1 1 1 110 110 110 110 110 110 110 110 110 110 110 110 110 110 110 1 1 1 1 1 1 1 1 1 1 1 1 1 1 1 1 1 1 1 1 1 1 1 1
1 1 1 17 17 112 112 112 112 112 112 112 112 112 112 112 112 112 112 17 1 1 1 1 2 110 110 110 110 110 110 110 110 110 110 110 110 110 110 110 2 1 1 1 1 1 1 1 1 1 1 1 1 1 1 1 1 1 1 1 1 1 1 1
1 1 1 17 17 17 17 112 17 17 112 17 17 112 112 112 17 17 17 17 1 1 1 1 1 110 110 110 110 110 110 110 110 110 110 110 110 110 110 110 1 1 1 1 1 1 1 1 1 1 1 1 1 1 1 1 1 1 1 1 1 1 1 1
1 1 17 17 17 17 17 112 17 17 112 17 17 17 17 17 17 17 17 17 1 1 1 6 110 110 110 110 110 110 110 110 110 110 110 110 110 110 110 110 110 6 1 1 1 1 1 1 1 1 1 1 1 1 1 1 1 1 1 1 1 1 1 1
1 1 17 17 17 17 17 112 17 17 112 112 112 112 112 112 17 17 17 1 1 1 1 1 1 110 110 110 110 110 110 110 110 110 110 110 110 110 110 110 1 1 1 1 1 1 1 1 1 1 1 1 1 1 1 1 1 1 1 1 1 1 1 1
1 1 17 112 112 112 112 106 17 17 112 112 112 112 112 106 17 17 17 1 1 1 1 1 2 110 110 110 110 110 110 110 110 110 110 110 110 110 110 110 2 1 1 1 1 1 1 1 1 2 1 1 4 1 2 1 1 1 1 1 1 1 1 1
1 1 17 112 17 17 17 17 17 17 17 17 112 112 17 17 17 17 17 1 1 1 1 1 1 110 110 110 110 110 110 110 110 110 110 110 110 110 110 110 1 1 1 1 1 1 1 2 111 111 111 111 111 111 111 111 111 2 1 1 1 1 1 1
1 1 17 112 17 1 1 1 1 1 1 17 112 112 17 18 17 17 17 1 1 1 1 1 2 110 110 110 110 110 110 110 110 110 110 110 110 110 110 110 2 1 1 1 1 1 1 1 2 1 2 111 111 111 1 2 1 1 1 1 1 1 1 1
1 17 17 112 17 17 1 1 1 1 1 17 112 112 112 112 112 112 17 1 1 1 1 1 1 110 110 110 110 110 110 110 110 110 110 110 110 110 110 110 1 1 1 1 1 1 1 1 1 1 1 111 111 111 1 1 1 1 1 1 1 1 1 1
1 17 112 112 106 17 1 1 1 1 1 17 112 112 17 18 17 112 17 1 1 1 1 1 1 2 1 110 2 110 110 110 110 110 110 110 1 110 2 2 1 1 1 1 1 1 1 1 1 1 2 111 111 111 1 1 1 1 1 1 1 1 1 1
1 17 112 112 112 17 1 1 1 1 1 17 112 106 17 1 112 112 112 2 1 2 1 4 1 2 2 110 1 1 2 91 1 91 1 2 1 110 1 2 1 4 2 1 1 1 1 1 1 1 1 111 111 111 2 1 1 1 1 1 1 1 1 1
1 17 112 112 112 17 1 1 1 1 1 17 17 17 17 2 112 112 112 112 1 109 109 109 109 109 2 1 1 1 109 109 109 109 109 1 2 2 1 109 109 109 109 109 2 2 1 1 1 2 1 111 111 111 1 1 1 1 1 1 1 1 1 1
1 17 17 20 17 1 3 1 1 1 1 1 1 1 2 112 112 112 112 112 3 109 109 109 109 109 109 109 109 109 109 109 109 109 109 109 109 109 109 109 109 109 109 109 3 111 111 111 111 111 111 111 111 111 1 1 1 1 1 1 1 1 1 1
1 1 1 1 2 112 112 112 2 1 1 1 1 1 6 112 112 112 112 112 90 109 109 15 109 109 109 109 109 109 109 109 109 109 109 109 109 109 109 109 109 15 109 109 90 111 111 111 111 111 111 111 111 111 6 1 1 1 1 1 1 1 1 1
1 1 1 1 4 112 12 112 4 1 1 1 1 1 1 112 112 112 112 112 3 109 109 109 109 109 109 109 109 109 109 109 109 109 109 109 109 109 109 109 109 109 109 109 3 111 111 111 111 111 111 111 111 111 1 1 1 1 1 1 1 1 1 1
1 1 1 1 1 112 106 112 1 1 1 1 1 1 1 2 112 112 112 112 2 109 109 109 109 109 35 35 49 35 35 109 35 109 35 35 49 39 35 109 109 109 109 109 1 1 1 2 1 2 1 111 111 111 2 1 1 1 1 1 1 1 1 1
1 1 1 1 1 2 112 2 1 1 1 1 1 1 1 1 112 112 112 1 1 2 1 4 1 2 35 35 35 49 35 109 109 109 35 49 35 35 35 2 1 4 1 2 1 1 1 1 1 1 2 111 111 111 1 1 1 1 1 1 1 1 1 1
1 1 1 1 1 1 112 1 1 2 1 1 2 1 2 1 1 112 1 2 1 1 1 1 1 1 35 109 109 109 109 109 109 109 109 109 109 109 35 1 1 1 1 1 1 1 1 1 1 1 1 111 111 111 2 1 1 1 1 1 1 1 1 1
1 1 1 1 1 2 112 112 112 112 112 112 112 112 112 112 112 112 112 112 112 112 112 112 112 1 49 109 109 109 109 109 109 109 109 109 109 109 49 1 1 1 1 1 1 1 1 1 2 1 1 111 111 111 2 1 1 1 1 1 1 1 1 1
1 1 1 1 1 1 1 112 112 112 112 112 112 112 112 112 112 112 112 112 112 112 112 112 112 1 35 109 109 109 109 109 109 109 109 109 109 109 35 1 1 1 1 1 1 1 1 111 1 111 1 111 111 111 1 111 1 111 1 1 1 1 1 1
1 1 1 29 29 29 112 112 2 1 2 3 1 2 2 1 3 1 2 1 2 3 1 1 1 1 35 109 109 109 109 109 109 109 109 109 109 109 39 1 1 1 1 1 1 1 3 106 111 106 111 111 111 111 111 106 111 106 3 1 1 1 1 1
1 1 1 29 29 29 112 29 29 29 29 29 29 29 29 29 29 29 29 29 29 29 30 29 1 1 49 109 109 109 109 109 109 109 109 109 109 109 49 1 1 1 1 1 1 1 1 111 1 111 2 1 4 2 1 111 2 111 1 1 1 1 1 1
1 1 1 29 30 112 112 112 29 29 112 112 112 29 29 112 112 112 29 29 112 106 112 29 1 1 35 109 109 109 109 109 109 109 109 109 109 109 35 1 1 1 1 1 1 1 1 1 1 1 1 1 1 1 1 1 1 1 1 1 1 1 1 1
1 1 1 29 29 112 15 112 112 112 112 15 112 112 112 112 15 112 112 112 112 15 112 29 1 1 39 109 109 109 109 109 109 109 109 109 109 109 35 1 1 1 1 1 1 1 1 1 1 1 1 1 1 1 1 1 1 1 1 1 1 1 1 1
1 1 1 29 29 112 112 112 29 29 112 112 112 29 29 112 112 112 29 29 112 112 112 30 1 1 49 109 109 109 109 109 109 109 109 109 109 109 49 1 1 1 1 1 1 1 1 1 1 1 1 1 1 1 1 1 1 1 1 1 1 1 1 1
1 1 1 29 29 29 112 29 29 29 29 112 29 29 29 29 112 29 112 112 29 112 29 29 1 1 35 109 109 109 109 109 109 109 109 109 109 109 35 1 1 1 1 1 1 1 1 1 1 1 1 1 1 1 1 1 1 1 1 1 1 1 1 1
1 1 1 29 29 29 112 29 29 29 29 112 29 29 29 29 112 29 112 112 29 112 29 29 1 1 35 109 109 109 109 109 109 109 109 109 109 109 35 1 1 1 1 1 1 1 1 1 1 1 1 1 1 1 1 1 1 1 1 1 1 1 1 1
1 1 1 29 29 112 112 112 29 29 112 112 112 29 29 112 112 112 29 29 112 112 112 29 29 29 49 109 109 109 109 109 109 109 109 109 109 109 49 1 1 1 1 1 1 1 1 1 1 1 1 1 1 1 1 1 1 1 1 1 1 1 1 1
1 1 1 29 29 112 15 112 112 112 112 15 112 112 106 112 15 112 112 112 112 15 112 112 112 29 39 109 109 109 109 109 109 109 109 109 109 109 35 1 1 1 1 1 1 1 1 1 1 1 1 1 1 1 1 1 1 1 1 1 1 1 1 1
1 1 1 29 30 112 112 112 29 29 112 112 112 29 29 112 112 112 29 29 112 112 112 29 112 29 35 35 35 35 109 109 109 109 109 35 35 35 35 1 1 1 1 1 1 1 1 1 1 1 1 1 1 1 1 1 1 1 1 1 1 1 1 1
1 1 1 29 29 29 106 29 29 29 29 112 29 112 112 29 112 29 29 29 29 112 29 29 112 29 29 37 109 109 109 109 109 109 109 109 109 37 35 1 1 1 1 1 1 1 1 1 1 1 1 1 1 1 1 1 1 1 1 1 1 1 1 1
1 1 1 29 29 29 112 29 29 29 29 112 29 112 112 29 112 29 29 29 29 112 29 29 112 29 139 29 35 35 109 109 109 109 109 35 39 35 35 1 1 1 1 1 1 1 1 1 1 1 1 1 1 1 1 1 1 1 1 1 1 1 1 1
1 1 1 29 29 112 112 112 29 29 112 112 112 29 29 112 112 112 29 29 112 112 112 30 112 92 139 29 21 35 35 109 109 109 35 35 1 1 1 1 1 1 1 1 1 1 1 1 1 1 1 1 1 1 1 1 1 1 1 1 1 1 1 1
1 1 1 29 29 112 15 112 112 112 112 15 112 112 112 112 15 112 112 112 112 15 106 29 106 29 139 100 143 21 35 109 109 109 35 1 1 1 1 1 1 1 1 1 1 1 1 1 1 1 1 1 1 1 1 1 1 1 1 1 1 1 1 1
1 1 1 29 29 112 112 112 29 29 112 106 112 29 29 112 112 112 29 29 112 112 112 29 112 92 139 29 21 1 39 109 109 109 35 1 1 1 1 1 1 1 1 1 1 1 1 1 1 1 1 1 1 1 1 1 1 1 1 1 1 1 1 1
1 1 1 29 29 29 29 29 29 29 29 29 29 29 29 30 29 29 29 29 29 30 29 29 29 29 139 29 29 1 35 109 109 109 35 1 1 1 1 1 1 1 1 1 1 1 1 1 1 1 1 1 1 1 1 1 1 1 1 1 1 1 1 1
1 1 1 29 29 29 29 29 29 29 29 29 29 29 29 29 29 29 29 29 29 29 29 29 29 29 29 29 29 1 35 16 16 16 35 1 1 1 1 1 1 1 1 1 1 1 1 1 1 1 1 1 1 1 1 1 1 1 1 1 1 1 1 1
