8 8 8 8 8 8 8 8 8 8 8 8 8 8 8 8 8 8 8 8 8 8 8 8 8 8 8 8 8 8 8 8 8 8 8 8 8 8 8 8 8 8 8 8 8 8 8 8 8 8 8 8 8 8 8 8 8 8 8 8 8 8 8 8
8 8 8 8 8 8 8 8 8 8 8 8 8 8 8 8 8 8 8 8 8 8 8 8 8 8 8 8 8 8 8 8 8 8 8 8 8 8 8 8 8 8 8 8 8 8 8 8 8 8 8 8 8 8 8 8 8 8 8 8 8 8 8 8
9 8 8 8 9 8 9 9 8 8 8 9 8 8 8 9 8 8 8 8 9 8 8 8 8 8 8 9 9 8 8 8 8 9 8 8 8 8 9 8 8 9 8 8 9 9 9 9 9 9 8 8 8 9 9 9 9 8 8 8 9 9 8 8
8 108 108 108 108 108 108 108 108 108 108 108 108 108 108 108 108 108 108 108 108 108 108 108 108 108 108 108 108 108 108 108 108 108 108 108 108 108 108 108 108 108 108 108 108 108 108 108 108 108 108 108 108 108 108 108 108 108 108 108 108 8 8 8
8 108 108 108 108 108 108 108 108 108 108 108 108 108 108 108 108 108 108 108 108 108 108 108 108 108 108 108 108 108 108 108 108 108 108 108 108 108 108 108 108 108 108 108 108 108 108 108 108 108 108 108 108 108 108 108 108 108 108 108 108 8 8 8
8 108 108 108 108 108 108 108 108 108 108 108 108 108 108 108 108 108 108 108 108 108 108 108 108 108 108 108 108 108 108 108 108 108 108 108 108 108 108 108 108 108 108 108 108 108 108 108 108 108 108 108 108 108 108 108 108 108 108 108 108 9 8 8
9 108 108 108 12 11 12 108 108 108 9 9 8 9 9 9 8 8 8 8 8 9 8 8 9 108 108 108 8 9 8 108 108 108 8 9 8 108 108 108 9 9 9 8 9 9 8 8 9 8 9 9 108 108 108 12 11 12 108 108 108 8 8 8
9 108 108 108 23 12 23 108 108 108 108 108 8 8 8 8 8 8 8 8 8 8 8 8 8 108 108 108 9 9 9 108 108 108 9 8 8 108 108 108 9 8 8 8 8 8 8 8 8 8 108 108 108 108 108 23 12 23 108 108 108 8 8 8
8 108 108 108 12 11 12 108 108 108 8 8 8 8 8 8 8 8 9 8 9 8 8 8 9 108 108 108 8 8 9 108 108 108 8 8 9 108 108 108 9 8 9 8 8 8 9 8 8 8 8 8 108 108 108 12 11 12 108 108 108 9 8 8
8 108 108 108 108 108 108 108 108 108 108 108 8 8 8 8 8 8 9 108 108 108 108 108 108 108 108 108 9 8 9 108 108 108 9 8 9 108 108 108 108 108 108 108 108 108 8 8 8 8 108 108 108 108 108 108 108 108 108 108 108 8 8 8
9 108 108 108 108 108 108 108 108 108 8 8 8 8 8 8 8 8 8 108 108 108 108 108 108 108 108 108 8 8 9 108 108 108 9 8 8 108 108 108 108 108 108 108 108 108 9 8 8 8 8 9 108 108 108 108 108 108 108 108 108 8 8 8
8 108 108 108 108 108 108 108 108 108 9 8 8 8 8 8 8 8 8 108 108 108 108 108 108 108 108 108 8 9 8 108 108 108 8 9 9 108 108 108 108 108 108 108 108 108 9 8 8 8 8 8 108 108 108 108 108 108 108 108 108 9 8 8
8 108 108 108 9 108 9 108 8 9 8 8 8 8 8 8 8 8 8 108 108 108 9 8 9 108 108 108 108 108 108 108 108 108 108 108 108 108 108 108 9 9 8 108 108 108 8 8 8 8 8 9 9 9 108 9 108 9 108 108 108 8 8 8
8 108 108 108 8 108 8 108 8 8 8 8 8 8 8 8 108 108 8 108 108 108 8 8 8 108 108 108 108 108 108 108 108 108 108 108 108 108 108 108 9 8 9 108 108 108 8 8 8 8 8 8 8 8 108 8 108 8 108 108 108 8 8 8
8 108 108 108 9 8 8 8 8 8 8 8 8 8 8 9 108 108 9 108 108 108 9 8 9 108 108 108 108 108 108 108 108 108 108 108 108 108 108 108 9 8 8 108 108 108 9 8 8 8 8 8 8 8 8 8 8 9 108 108 108 9 8 8
8 108 108 108 9 8 8 8 8 8 8 8 9 8 108 108 9 8 9 108 108 108 8 8 8 8 9 8 8 8 8 9 8 8 8 9 9 8 8 8 9 8 9 108 108 108 8 8 8 8 8 8 8 8 8 8 8 8 108 108 108 8 8 8
8 108 108 108 9 8 8 8 8 8 8 8 108 108 108 108 8 108 8 108 108 108 8 8 8 8 8 8 8 8 8 108 8 108 8 8 8 8 8 8 8 8 8 108 108 108 8 8 8 8 8 8 8 8 8 8 8 9 108 108 108 8 8 8
8 108 108 108 8 8 8 8 8 8 8 9 108 108 108 108 8 108 9 108 108 108 9 9 9 8 8 8 8 9 9 108 9 108 8 8 8 9 9 9 9 9 9 108 108 108 9 8 8 8 8 8 8 8 8 8 8 8 108 108 108 8 8 8
9 108 108 108 9 8 8 8 8 8 8 8 108 108 108 9 9 9 9 108 108 108 108 108 108 108 108 108 108 108 108 108 108 108 108 108 108 108 108 108 108 108 108 108 108 108 9 8 8 8 8 8 8 8 8 8 8 8 108 108 108 8 8 8
9 108 108 108 8 8 8 8 8 8 8 9 108 108 108 8 8 8 9 108 108 108 108 108 108 108 108 108 108 108 108 108 108 108 108 108 108 108 108 108 108 108 108 108 108 108 8 8 8 8 8 8 8 8 8 8 8 8 108 108 108 8 8 8
9 108 108 108 8 8 8 8 8 8 8 8 108 108 108 8 9 8 9 108 108 108 108 108 108 108 108 108 108 108 108 108 108 108 108 108 108 108 108 108 108 108 108 108 108 108 8 8 8 8 8 8 8 8 8 8 8 9 108 108 108 8 8 8
9 108 108 108 8 8 8 8 8 8 9 8 108 108 108 9 8 8 9 8 9 8 9 9 9 8 9 8 108 108 108 8 8 9 108 108 108 8 8 9 8 8 8 8 8 9 9 8 8 8 8 8 8 8 8 8 8 9 108 108 108 8 8 8
8 108 108 108 8 8 8 8 8 8 8 108 108 108 108 108 8 8 8 8 8 8 8 8 8 8 8 9 108 108 108 90 116 90 108 108 108 9 8 8 8 8 8 8 8 8 8 8 8 8 8 8 8 8 8 8 8 8 108 108 108 8 8 8
8 108 108 108 9 8 8 8 8 8 9 108 108 108 108 108 9 8 8 8 8 8 8 8 9 9 5 8 108 108 108 9 8 8 108 108 108 9 5 9 9 8 9 8 9 8 9 8 8 8 8 8 8 8 8 8 8 8 108 108 108 8 8 8
9 108 108 108 8 8 8 8 8 8 8 108 108 108 108 108 9 8 8 8 8 8 8 8 8 106 108 108 108 108 108 9 8 9 108 108 108 108 108 106 8 111 111 111 111 111 111 8 9 8 8 8 8 8 8 8 8 8 108 108 108 9 8 8
9 108 108 108 8 8 8 8 8 17 17 17 91 17 91 17 17 17 8 8 8 8 8 8 5 108 108 108 108 108 108 90 115 90 108 108 108 108 108 108 5 111 111 111 111 111 111 111 111 8 8 8 8 8 8 8 8 9 108 108 108 8 8 8
8 108 108 108 8 8 8 8 8 17 113 113 113 113 113 113 113 17 8 8 8 8 8 8 9 106 108 108 108 108 108 8 9 9 108 108 108 108 108 106 8 111 111 111 111 111 111 111 111 9 8 8 8 8 8 8 8 8 108 108 108 8 8 8
9 108 108 108 9 8 8 8 8 17 113 113 106 113 113 113 113 17 8 8 8 8 8 8 9 8 5 8 8 8 9 8 8 8 9 9 9 8 5 8 8 111 111 111 111 111 111 111 111 111 8 8 8 8 8 8 8 8 108 108 108 9 8 8
9 108 108 108 9 8 8 8 8 17 113 113 113 113 106 113 113 17 8 8 8 8 8 8 8 8 8 8 8 8 8 8 8 8 8 8 8 111 111 111 111 111 111 111 111 111 111 111 111 111 9 8 8 8 8 8 8 9 108 108 108 8 8 8
9 108 108 108 8 8 8 8 8 17 113 113 113 113 113 113 113 17 17 17 17 17 17 17 17 17 17 17 17 17 17 17 17 17 17 17 9 111 111 111 111 111 8 111 8 111 8 111 111 111 8 8 9 9 9 8 8 8 108 108 108 8 8 8
9 108 108 108 8 8 8 8 8 17 113 113 106 113 106 113 113 17 113 113 17 113 113 17 113 113 17 113 113 17 113 113 17 17 113 113 8 111 8 111 8 111 8 111 111 111 111 111 111 111 111 111 111 111 111 111 8 108 108 108 108 9 8 8
9 108 108 108 8 8 8 8 8 17 113 113 113 113 113 113 113 17 113 113 17 113 113 17 113 113 17 113 113 17 113 113 113 18 113 113 90 111 111 111 111 111 111 111 111 111 8 111 111 111 111 111 111 111 111 111 90 108 108 108 108 8 8 8
8 108 108 108 9 8 8 8 8 17 113 113 113 113 113 113 113 17 113 17 17 113 113 17 113 113 17 113 113 17 113 113 17 17 113 113 8 111 8 111 8 111 8 111 111 111 111 111 111 111 111 111 111 111 111 111 9 108 108 108 108 8 8 8
9 108 108 108 8 8 8 8 8 17 17 17 17 17 17 17 17 17 20 17 17 17 17 17 17 17 17 17 17 17 17 17 113 17 17 17 8 111 111 111 111 111 8 111 8 111 8 111 111 111 9 8 9 8 8 9 8 8 108 108 108 8 8 8
9 108 108 108 8 8 8 8 8 8 8 8 8 8 17 17 17 113 113 113 17 17 17 17 17 17 8 8 8 8 8 17 113 17 8 8 9 111 111 111 111 111 111 111 111 111 111 111 111 111 9 8 8 8 8 8 8 8 108 108 108 9 8 8
8 108 108 108 9 8 9 8 8 8 8 8 8 8 17 17 113 113 113 113 113 17 17 17 17 17 8 8 8 8 8 17 17 17 8 8 8 8 8 9 8 111 111 111 111 111 111 111 111 111 8 8 8 8 8 8 8 8 108 108 108 8 8 8
8 108 108 108 108 108 108 8 137 137 137 8 8 8 17 17 113 113 113 113 113 17 17 17 17 17 8 8 8 8 8 8 8 8 8 8 8 8 8 8 8 111 111 111 111 111 111 111 111 9 8 8 8 8 8 8 8 9 108 108 108 8 8 8
9 108 108 108 108 108 108 90 137 137 137 8 8 8 17 17 17 17 17 17 18 17 17 17 17 17 8 8 8 8 8 8 8 8 8 8 8 8 8 8 9 111 111 111 111 111 111 111 111 8 8 8 8 8 8 8 8 8 108 108 108 8 8 8
8 108 108 108 108 108 108 8 137 137 137 8 8 8 17 17 17 17 17 113 113 113 17 17 17 17 8 8 8 8 8 8 8 8 8 8 8 8 8 8 8 111 111 111 111 111 111 9 8 8 8 8 8 8 8 8 9 8 108 108 108 9 8 8
8 108 108 108 9 8 9 8 8 8 8 8 17 17 17 17 17 17 17 106 113 113 113 17 17 17 17 17 17 17 17 8 8 8 8 8 8 8 8 8 8 9 8 9 8 9 8 8 8 8 8 8 8 8 8 106 108 108 108 108 108 8 8 8
8 108 108 108 8 8 8 8 8 8 8 17 17 17 17 17 17 20 17 113 113 113 17 20 17 17 17 17 17 17 17 8 8 8 8 8 12 12 12 12 12 12 12 12 12 12 12 8 8 8 8 8 8 8 9 108 108 108 108 108 108 8 8 8
8 108 108 108 8 8 8 8 8 8 8 17 113 113 113 106 113 113 113 113 113 113 113 113 106 113 113 113 113 17 17 8 8 8 8 8 12 12 12 12 12 12 12 12 12 12 12 12 8 8 8 8 8 8 8 108 106 108 108 108 108 8 8 8
8 108 108 108 9 8 8 8 8 8 8 17 113 17 113 113 113 113 113 113 113 113 113 113 113 113 106 17 113 17 17 8 8 8 8 8 12 12 117 117 117 117 117 117 117 117 12 12 8 8 8 8 8 8 8 8 9 9 108 108 108 9 8 8
8 108 108 108 8 8 8 8 8 8 8 17 17 17 17 17 113 113 106 113 113 113 113 106 113 17 17 17 17 17 17 8 8 8 8 8 12 23 117 117 117 117 117 117 117 117 23 12 8 8 8 8 8 8 8 8 8 8 108 108 108 8 8 8
9 108 108 108 8 8 8 8 8 8 8 17 17 17 17 17 17 113 17 113 113 113 17 113 17 17 17 17 17 17 17 8 8 8 8 12 12 12 117 117 117 117 117 117 117 117 12 12 8 9 9 8 8 9 9 9 8 9 108 108 108 8 8 8
9 108 108 108 9 8 8 8 8 8 8 8 17 17 17 17 17 113 17 113 113 113 17 113 17 17 17 17 17 17 17 8 8 8 12 12 21 10 117 117 117 117 117 117 117 117 117 92 116 116 116 116 116 116 116 116 8 8 108 108 108 8 8 8
8 108 108 108 8 8 8 8 8 8 8 8 17 17 17 17 17 17 17 113 113 113 17 17 17 17 17 106 112 17 17 8 8 8 12 21 118 100 117 117 117 117 117 117 117 117 117 11 116 116 8 9 9 8 116 116 116 90 108 108 108 9 8 8
8 108 108 108 8 8 8 8 8 8 8 8 17 17 17 17 113 113 17 20 91 20 17 113 113 90 112 112 112 112 17 8 8 8 12 12 21 10 117 117 117 117 117 117 117 117 117 92 116 116 116 116 116 116 116 116 9 8 108 108 108 8 8 8
9 108 108 108 8 8 8 8 8 8 8 8 17 17 17 17 17 113 17 17 109 17 17 113 17 17 17 106 112 17 17 8 8 8 8 12 12 12 117 117 117 117 117 117 117 117 12 12 8 8 9 8 9 8 9 8 8 9 108 108 108 8 8 8
9 108 108 108 9 8 8 8 8 8 8 8 17 17 17 17 17 17 17 17 109 17 17 17 17 17 17 17 17 17 8 8 13 8 8 8 12 23 117 117 117 117 117 117 117 117 23 12 8 8 8 8 8 8 8 8 8 8 108 108 108 9 8 8
9 108 108 108 8 8 8 8 8 8 8 8 17 17 17 17 17 17 17 109 109 109 17 17 17 17 17 17 17 8 8 8 108 8 8 8 12 12 117 117 117 117 117 117 117 117 12 12 8 8 8 8 8 8 8 8 8 8 108 108 108 9 8 8
9 108 108 108 8 8 8 8 8 8 8 8 17 17 17 17 17 17 109 109 109 109 109 17 17 17 17 17 17 8 8 8 108 9 8 8 8 12 12 12 117 117 117 12 12 12 12 12 8 8 8 8 8 8 8 8 8 8 108 108 108 8 8 8
8 108 108 108 8 108 8 108 8 8 8 8 17 109 109 109 20 109 109 109 109 109 109 109 20 109 109 109 17 8 8 9 108 8 108 108 9 8 12 12 117 117 117 12 12 12 12 12 8 8 8 9 8 9 108 8 108 9 108 108 108 9 8 8
8 108 108 108 9 108 8 108 9 8 9 8 17 109 109 109 90 109 109 109 109 109 109 109 90 109 109 109 17 8 8 9 108 8 108 108 8 8 12 11 117 117 117 11 117 117 12 12 8 9 8 8 8 9 108 9 108 8 108 108 108 9 8 8
9 108 108 108 108 108 108 108 108 108 8 8 17 109 109 109 20 109 109 109 109 109 109 109 20 109 109 109 17 8 8 8 108 8 108 108 9 8 12 12 117 117 117 12 117 117 12 12 8 8 8 8 108 108 108 108 108 108 108 108 108 8 8 8
9 108 108 108 108 108 108 108 108 108 9 8 17 17 17 17 17 17 109 109 109 109 109 17 17 17 17 17 17 8 8 9 108 9 8 9 8 8 12 12 12 91 12 12 12 12 12 12 8 8 8 9 108 108 108 108 108 108 108 108 108 9 8 8
8 108 108 108 108 108 108 108 108 108 108 108 8 8 17 17 17 17 17 18 91 18 17 17 8 8 8 8 8 8 8 108 108 108 9 8 8 8 8 8 9 108 8 8 8 8 8 8 8 8 108 108 108 108 108 108 108 108 108 108 108 8 8 8
8 108 108 108 12 11 12 108 108 108 9 8 8 8 8 8 8 8 8 108 108 108 8 8 8 8 8 8 8 8 8 108 108 108 8 8 8 8 8 8 9 108 8 8 8 8 8 8 8 8 9 8 108 108 108 12 11 12 108 108 108 8 8 8
9 108 108 108 23 12 23 108 108 108 108 108 8 8 8 8 8 9 9 108 108 108 9 8 8 8 8 8 8 8 9 108 108 108 9 8 8 8 8 8 108 108 108 9 8 8 8 8 8 8 108 108 108 108 108 23 12 23 108 108 108 9 8 8
9 108 108 108 12 11 12 108 108 108 9 9 9 9 9 9 9 9 8 108 108 108 8 9 9 8 8 8 9 9 9 108 108 108 8 9 8 8 9 108 108 108 108 108 8 9 8 9 9 9 9 9 108 108 108 12 11 12 108 108 108 8 8 8
9 108 108 108 108 108 108 108 108 108 108 108 108 108 108 108 108 108 108 108 108 108 108 108 108 108 108 108 108 108 108 108 108 108 108 108 108 108 108 108 108 108 108 108 108 108 108 108 108 108 108 108 108 108 108 108 108 108 108 108 108 9 8 8
8 108 108 108 108 108 108 108 108 108 108 108 108 108 108 108 108 108 108 108 108 108 108 108 108 108 108 108 108 108 108 108 108 108 108 108 108 108 108 108 108 108 108 108 108 108 108 108 108 108 108 108 108 108 108 108 108 108 108 108 108 9 8 8
8 108 108 108 108 108 108 108 108 108 108 108 108 108 108 108 108 108 108 108 108 108 108 108 108 108 108 108 108 108 9 108 9 108 8 108 108 108 108 108 108 108 108 108 108 108 108 108 108 108 108 108 108 108 108 108 108 108 108 108 108 9 8 8
8 9 9 9 8 8 8 9 9 9 9 9 9 8 8 9 9 9 9 9 9 9 8 8 9 9 9 9 8 9 8 16 8 16 8 8 9 8 8 8 9 8 8 8 8 8 8 9 9 8 8 8 9 8 8 8 9 8 8 8 8 9 8 8
