17 17 17 17 17 17 17 17 17 17 17 17 17 17 17 17 17 17 17 17 17 17 17 17 17 17 17 17 17 17 17 17 17 17 17 17 17 17 17 17 17 17 17 17 17 17 17 17 17 17 17 17 17 17 17 17 17 17 17 17 17 17 17 17
17 17 17 17 17 17 17 17 17 17 17 17 17 17 17 17 17 17 17 17 17 17 17 17 17 17 17 17 17 17 17 17 17 17 17 17 17 17 17 17 17 17 17 17 17 17 17 17 17 17 17 17 17 17 17 17 17 17 17 17 17 17 17 17
17 17 17 108 108 108 108 108 108 108 108 108 108 108 17 17 17 17 17 17 17 17 17 17 17 17 17 17 17 17 17 17 17 17 17 17 17 17 17 17 17 17 17 17 17 17 17 17 17 17 17 17 17 17 17 17 17 17 17 17 17 17 17 17
17 17 108 108 108 108 108 108 108 108 108 108 108 108 108 17 17 17 17 17 109 109 109 109 109 17 109 17 109 109 109 109 109 17 17 17 109 109 109 109 109 17 109 17 109 109 109 109 109 17 17 17 17 17 17 17 17 17 17 17 17 17 17 17
17 13 108 108 108 108 108 108 108 108 108 108 108 108 108 20 17 17 17 17 109 109 109 109 109 109 109 109 109 109 109 109 109 20 17 20 109 109 109 109 109 109 109 109 109 109 109 109 109 20 17 17 17 17 17 17 17 17 17 17 17 17 17 17
17 17 108 108 108 108 108 108 12 10 12 108 108 108 108 17 17 17 17 17 109 109 109 109 109 109 109 109 109 109 109 109 109 17 18 17 109 109 109 109 109 109 109 109 109 109 109 109 109 17 17 17 17 17 17 17 20 17 17 17 17 17 17 17
17 17 17 108 108 108 108 12 12 12 12 12 108 108 108 18 109 109 109 109 109 109 109 15 15 15 14 15 15 15 109 109 109 109 109 109 109 109 109 15 15 15 14 15 15 15 109 109 109 109 109 109 109 109 109 109 109 109 17 17 17 17 17 17
17 17 17 17 108 108 108 10 12 12 12 10 108 108 108 90 109 109 109 109 109 109 109 14 15 15 15 15 15 14 109 109 109 109 109 109 109 109 109 14 15 15 15 15 15 14 109 109 109 109 109 109 109 109 109 109 109 109 17 17 17 17 17 17
17 17 17 17 108 108 108 12 12 12 12 12 108 108 108 18 109 109 109 109 109 109 109 15 15 15 14 15 15 15 109 109 109 109 109 109 109 109 109 15 15 15 14 15 15 15 109 109 109 109 109 109 109 109 109 109 109 109 17 17 17 17 17 17
17 17 17 17 108 108 108 108 12 10 12 108 108 108 108 17 17 17 17 17 109 109 109 109 109 109 109 109 109 109 109 109 109 17 18 17 109 109 109 109 109 109 109 109 109 109 109 109 109 17 17 17 17 17 17 109 109 109 17 17 17 17 17 17
17 17 17 17 108 108 108 108 108 108 108 108 108 108 108 20 17 17 17 17 109 109 109 109 109 109 109 109 109 109 109 109 109 20 17 20 109 109 109 109 109 109 109 109 109 109 109 109 109 20 17 17 109 109 17 109 109 109 17 17 17 17 17 17
17 17 17 17 108 108 108 108 108 108 108 108 108 108 108 17 17 17 17 17 109 109 109 109 109 17 109 17 109 109 109 109 109 17 17 17 109 109 109 109 109 17 109 17 109 109 109 109 109 17 17 17 109 109 109 109 109 109 17 17 17 17 17 17
17 17 17 17 17 108 108 108 108 108 108 108 108 108 17 17 17 17 17 17 91 17 17 17 17 17 17 17 17 17 17 17 17 17 17 17 17 17 17 17 17 17 109 17 17 17 17 17 17 17 17 17 109 109 109 109 109 109 17 17 17 17 17 17
17 17 17 17 17 17 17 17 18 91 18 17 17 17 17 17 20 17 17 17 117 117 117 117 117 117 117 117 17 117 117 117 117 117 117 117 17 17 17 17 17 17 109 17 17 17 17 17 17 17 17 17 109 109 17 109 109 109 17 17 17 17 17 17
17 17 17 115 115 17 110 110 110 110 110 110 110 17 112 112 112 112 112 17 91 17 17 17 17 17 17 117 117 117 17 17 18 17 17 117 117 17 17 17 17 17 109 109 17 17 17 17 17 17 17 17 17 17 17 109 109 109 17 17 17 17 17 17
17 17 115 115 115 90 110 110 110 110 110 110 110 90 112 112 112 112 112 90 116 90 118 118 118 118 17 17 117 17 17 122 122 122 17 17 117 17 17 17 17 17 109 109 17 109 109 109 109 109 109 109 109 109 109 109 109 109 17 17 17 17 17 17
17 17 115 115 115 17 110 110 110 110 110 110 110 17 112 112 112 112 112 17 91 17 118 118 118 118 118 17 117 17 122 122 122 122 122 17 117 17 17 17 17 17 17 17 17 109 109 109 109 109 109 109 109 109 109 109 109 109 17 17 17 17 17 17
17 17 115 115 115 17 17 91 17 20 17 91 17 17 17 17 20 17 17 17 119 17 118 118 118 118 118 17 117 18 122 122 122 122 122 90 117 20 17 17 17 17 17 17 17 109 109 109 109 109 109 109 109 109 109 109 109 109 17 17 17 17 17 17
17 17 115 115 17 17 114 114 114 17 113 113 113 17 17 17 17 17 17 17 119 17 118 118 118 118 118 17 117 17 122 122 122 122 122 17 117 17 17 17 17 17 17 17 17 109 109 109 17 17 17 17 17 17 17 17 20 17 17 17 17 17 17 17
17 17 17 17 17 17 114 114 114 17 113 113 113 17 17 17 17 17 17 17 119 17 118 118 118 118 118 17 117 17 17 122 122 122 17 17 117 17 17 17 17 17 17 17 18 109 109 109 18 17 17 17 17 17 17 17 17 17 17 17 17 17 17 17
17 17 17 17 17 17 114 114 114 17 113 113 113 17 17 17 17 17 17 17 119 17 17 17 17 17 17 17 117 117 17 17 91 17 17 117 117 17 17 17 17 17 17 17 17 109 109 109 17 17 17 17 17 17 17 17 17 17 17 17 17 17 17 17
17 17 17 17 17 17 17 114 114 17 113 113 113 17 17 17 17 17 17 119 119 119 17 17 17 17 17 17 17 117 117 117 117 117 117 117 17 17 17 17 106 109 106 109 109 109 109 109 109 106 106 109 106 17 17 17 17 17 17 17 17 17 17 17
17 17 17 17 17 17 17 114 114 17 113 113 113 17 17 17 17 17 119 119 119 119 119 17 17 17 17 17 17 17 17 17 20 17 17 17 17 17 17 20 109 109 109 109 109 106 106 109 109 109 109 106 109 20 17 17 17 17 17 17 17 17 17 17
17 17 17 17 17 17 17 17 17 17 113 113 113 17 17 17 17 18 119 119 119 119 119 18 17 17 17 17 17 17 17 17 17 20 17 17 17 17 17 17 109 109 109 109 109 109 109 109 109 109 106 109 106 17 17 17 17 17 17 17 17 17 17 17
17 17 17 17 17 17 17 17 17 17 113 113 113 17 17 17 17 17 119 119 119 119 119 17 17 17 17 17 17 120 120 120 120 120 120 120 120 120 17 20 106 109 109 109 109 106 109 106 109 109 109 106 109 20 17 17 17 17 17 17 17 17 17 17
17 17 121 121 121 121 121 121 121 17 113 113 113 17 17 17 17 17 17 119 119 119 17 17 17 17 17 120 106 120 120 120 120 120 120 120 120 120 17 17 106 109 106 109 109 109 109 109 109 109 109 109 106 17 17 17 17 17 17 17 17 17 17 17
17 17 121 121 121 17 17 17 17 17 113 113 113 17 17 17 17 17 17 17 20 17 17 17 17 17 17 17 17 120 120 120 120 120 120 120 120 120 17 20 109 106 109 109 109 106 106 106 109 109 109 109 106 20 17 17 17 17 17 17 17 17 17 17
17 121 121 121 121 121 90 113 113 113 113 113 113 113 113 113 17 120 120 120 120 120 120 120 120 120 120 120 120 120 120 120 120 120 120 120 120 120 17 17 106 109 109 109 109 109 109 109 109 109 109 109 109 17 17 17 17 17 17 17 17 17 17 17
17 121 121 121 121 121 18 113 113 113 113 113 113 113 113 113 92 120 120 120 120 120 120 120 120 120 120 120 120 120 120 120 120 120 120 120 120 120 20 17 17 17 17 17 17 18 91 18 17 17 17 17 17 17 17 17 17 17 17 17 17 17 17 17
17 121 121 121 121 121 90 113 113 113 113 113 113 113 113 113 17 120 120 120 120 120 120 120 120 120 120 120 120 120 120 120 120 120 120 120 120 120 17 17 17 17 17 17 111 111 111 111 111 17 17 17 17 17 17 17 17 17 17 17 17 17 17 17
17 17 121 121 121 17 17 17 17 17 17 18 17 17 17 17 17 17 17 17 20 17 17 17 17 17 17 17 17 120 120 120 120 120 120 120 120 120 17 17 17 17 17 111 111 106 106 111 111 111 17 17 17 17 17 17 17 17 17 17 17 17 17 17
17 17 121 121 121 121 121 121 121 17 17 17 27 27 27 27 27 27 27 27 27 2 1 2 27 1 17 120 106 120 120 120 120 120 120 120 120 120 106 120 17 17 17 111 111 111 111 106 111 111 17 17 17 17 17 17 17 17 17 17 17 17 17 17
17 17 17 17 17 17 17 17 17 17 17 17 27 1 27 2 27 2 27 27 1 27 120 120 120 27 17 17 17 120 120 120 120 120 120 120 120 120 17 17 17 17 17 106 106 111 111 111 111 111 17 17 17 17 17 17 17 17 17 17 17 17 17 17
17 17 17 17 17 17 17 17 17 17 1 27 27 1 120 120 120 120 120 120 27 27 106 120 106 27 17 17 17 17 106 17 120 120 120 17 106 17 17 17 17 17 17 111 111 111 106 111 111 111 17 17 17 17 17 17 17 17 17 17 17 17 17 17
17 17 17 17 17 17 17 17 17 17 1 120 120 27 120 27 27 1 27 120 2 27 1 120 1 2 1 27 17 17 120 17 120 120 120 17 120 17 17 17 17 17 17 17 17 17 20 17 17 17 17 17 17 17 17 17 17 17 17 17 17 17 17 17
17 17 17 17 17 17 17 17 17 17 27 120 120 2 120 1 27 27 27 120 27 27 1 120 120 120 106 27 17 17 17 17 120 120 120 17 17 17 17 17 17 17 17 17 17 17 17 17 17 17 17 17 17 17 17 17 17 17 17 17 17 17 17 17
27 27 27 27 27 27 27 27 27 27 27 27 27 1 120 1 27 27 1 120 1 27 27 27 2 27 120 27 1 27 2 120 120 120 120 18 21 17 17 17 17 17 17 17 17 17 17 17 17 17 17 17 17 17 17 17 17 17 17 17 17 17 17 17
27 27 27 27 1 1 2 27 27 27 27 2 1 27 91 27 27 2 27 120 27 27 27 27 27 27 120 120 120 120 120 120 120 120 120 100 123 21 17 17 17 17 17 17 17 17 17 17 17 17 17 17 17 17 17 17 17 17 17 17 17 17 17 17
27 27 124 124 124 124 124 124 27 3 1 124 124 124 124 124 124 124 27 120 2 1 2 1 27 1 120 2 1 1 27 120 120 120 120 18 21 17 27 1 27 4 1 2 27 27 17 17 17 17 17 17 17 17 17 17 17 17 17 17 17 17 17 17
2 124 124 124 124 124 124 124 124 124 124 124 124 124 124 124 124 124 1 120 27 1 120 120 120 120 106 1 27 27 27 17 17 20 17 17 17 17 27 125 125 125 125 125 27 27 17 17 17 17 17 17 17 17 17 17 17 17 17 17 17 17 17 17
27 124 124 124 124 124 124 124 124 124 124 124 124 124 124 124 124 2 27 120 1 1 120 1 27 27 27 27 27 27 1 27 2 27 2 27 1 2 1 125 125 125 125 125 1 27 17 17 17 17 17 17 17 17 17 17 17 17 17 17 17 17 17 17
3 124 124 124 124 124 124 124 124 124 124 124 124 124 124 124 124 6 2 120 27 27 120 1 2 27 1 27 2 27 1 120 120 120 120 120 120 120 90 125 125 125 125 125 3 27 17 17 17 17 17 17 17 17 17 17 17 17 17 17 17 17 17 17
27 124 124 124 124 124 124 124 124 124 124 124 124 124 124 124 124 1 27 120 120 120 120 120 120 120 27 2 120 120 120 120 1 27 1 27 120 2 27 125 125 125 125 125 1 27 17 17 17 17 17 17 17 17 17 17 17 17 17 17 17 17 17 17
1 124 124 124 124 124 124 124 124 124 124 124 124 124 124 124 124 124 1 27 2 1 27 2 27 120 27 1 120 2 27 120 27 27 120 120 120 1 27 125 125 125 125 125 2 27 17 17 17 17 17 17 17 17 17 17 17 17 17 17 17 17 17 17
27 27 124 124 124 124 124 124 27 3 27 124 124 124 124 124 124 124 1 27 27 27 27 27 1 120 120 120 120 1 27 120 1 27 120 1 27 27 27 1 2 4 27 1 27 27 17 17 17 17 17 17 17 17 17 17 17 17 17 17 17 17 17 17
27 27 1 2 27 1 1 27 27 27 1 1 27 2 27 2 1 1 27 27 27 27 27 27 27 27 1 2 27 1 27 120 1 27 120 1 27 27 27 27 27 27 27 27 27 27 17 17 17 17 17 17 17 17 17 17 17 17 17 17 17 17 17 17
27 27 27 27 27 27 27 27 27 27 27 27 27 27 27 27 27 27 27 27 27 27 27 27 27 27 27 27 27 27 2 120 120 120 120 2 27 27 17 17 17 17 17 17 17 17 17 17 17 17 17 17 17 17 17 17 17 17 17 17 17 17 17 17
17 17 17 17 17 17 17 17 17 17 17 17 17 17 17 17 17 17 17 17 17 27 27 27 27 27 27 27 27 27 27 2 1 27 1 27 27 27 17 17 17 17 17 17 17 17 17 17 17 17 17 17 17 17 17 17 17 17 17 17 17 17 17 17
17 17 17 17 17 17 17 17 17 17 17 17 17 17 17 17 17 17 17 17 17 27 27 27 27 27 27 2 27 27 27 27 120 120 27 27 27 27 17 17 17 17 17 17 17 17 17 17 17 17 17 17 17 17 17 17 17 17 17 17 17 17 17 17
17 17 17 17 17 17 17 17 17 17 17 17 17 17 17 17 17 17 17 17 17 27 27 27 21 3 126 126 126 4 120 2 120 120 1 27 27 27 17 17 17 17 17 17 17 17 17 17 17 17 17 17 17 17 17 17 17 17 17 17 17 17 17 17
17 17 17 17 17 17 17 17 17 17 17 17 17 17 17 17 17 17 17 17 17 27 27 21 107 100 126 126 126 90 120 120 120 27 27 27 27 27 17 17 17 17 17 17 17 17 17 17 17 17 17 17 17 17 17 17 17 17 17 17 17 17 17 17
17 17 17 17 17 17 17 17 17 17 17 17 17 17 17 17 17 17 17 17 17 27 27 27 21 3 126 126 126 4 120 27 1 27 27 27 27 27 17 17 17 17 17 17 17 17 17 17 17 17 17 17 17 17 17 17 17 17 17 17 17 17 17 17
17 17 17 17 17 17 17 17 17 17 17 17 17 17 17 17 17 17 17 17 17 27 27 27 27 27 27 1 1 27 27 27 27 27 27 27 27 27 17 17 17 17 17 17 17 17 17 17 17 17 17 17 17 17 17 17 17 17 17 17 17 17 17 17
17 17 17 17 17 17 17 17 17 17 17 17 17 17 17 17 17 17 17 17 17 27 27 27 27 27 27 27 27 27 27 27 27 27 27 27 27 27 17 17 17 17 17 17 17 17 17 17 17 17 17 17 17 17 17 17 17 17 17 17 17 17 17 17
17 17 17 17 17 17 17 17 17 17 17 17 17 17 17 17 17 17 17 17 17 17 17 17 17 17 17 17 17 17 17 17 17 17 17 17 17 17 17 17 17 17 17 17 17 17 17 17 17 17 17 17 17 17 17 17 17 17 17 17 17 17 17 17
17 17 17 17 17 17 17 17 17 17 17 17 17 17 17 17 17 17 17 17 17 17 17 17 17 17 17 17 17 17 17 17 17 17 17 17 17 17 17 17 17 17 17 17 17 17 17 17 17 17 17 17 17 17 17 17 17 17 17 17 17 17 17 17
17 17 17 17 17 17 17 17 17 17 17 17 17 17 17 17 17 17 17 17 17 17 17 17 17 17 17 17 17 17 17 17 17 17 17 17 17 17 17 17 17 17 17 17 17 17 17 17 17 17 17 17 17 17 17 17 17 17 17 17 17 17 17 17
17 17 17 17 17 17 17 17 17 17 17 17 17 17 17 17 17 17 17 17 17 17 17 17 17 17 17 17 17 17 17 17 17 17 17 17 17 17 17 17 17 17 17 17 17 17 17 17 17 17 17 17 17 17 17 17 17 17 17 17 17 17 17 17
17 17 17 17 17 17 17 17 17 17 17 17 17 17 17 17 17 17 17 17 17 17 17 17 17 17 17 17 17 17 17 17 17 17 17 17 17 17 17 17 17 17 17 17 17 17 17 17 17 17 17 17 17 17 17 17 17 17 17 17 17 17 17 17
17 17 17 17 17 17 17 17 17 17 17 17 17 17 17 17 17 17 17 17 17 17 17 17 17 17 17 17 17 17 17 17 17 17 17 17 17 17 17 17 17 17 17 17 17 17 17 17 17 17 17 17 17 17 17 17 17 17 17 17 17 17 17 17
17 17 17 17 17 17 17 17 17 17 17 17 17 17 17 17 17 17 17 17 17 17 17 17 17 17 17 17 17 17 17 17 17 17 17 17 17 17 17 17 17 17 17 17 17 17 17 17 17 17 17 17 17 17 17 17 17 17 17 17 17 17 17 17
17 17 17 17 17 17 17 17 17 17 17 17 17 17 17 17 17 17 17 17 17 17 17 17 17 17 17 17 17 17 17 17 17 17 17 17 17 17 17 17 17 17 17 17 17 17 17 17 17 17 17 17 17 17 17 17 17 17 17 17 17 17 17 17
17 17 17 17 17 17 17 17 17 17 17 17 17 17 17 17 17 17 17 17 17 17 17 17 17 17 17 17 17 17 17 17 17 17 17 17 17 17 17 17 17 17 17 17 17 17 17 17 17 17 17 17 17 17 17 17 17 17 17 17 17 17 17 17
17 17 17 17 17 17 17 17 17 17 17 17 17 17 17 17 17 17 17 17 17 17 17 17 17 17 17 17 17 17 17 17 17 17 17 17 17 17 17 17 17 17 17 17 17 17 17 17 17 17 17 17 17 17 17 17 17 17 17 17 17 17 17 17
