12 12 12 12 12 12 12 12 12 12 12 12 12 12 12 12 12 12 12 12 12 12 12 12 12 12 12 12 12 12 12 12 12 12 12 12 12 12 12 12 12 12 12 12 12 12 12 12 12 12 12 12 12 12 12 12 12 12 12 12 12 12 12 12
12 12 115 115 115 115 115 115 115 115 115 115 115 115 115 115 115 115 115 115 12 12 12 12 12 12 12 12 12 12 12 12 12 12 12 12 12 12 12 12 12 12 12 12 12 12 12 12 12 12 12 12 12 12 12 12 12 12 12 12 12 12 12 12
12 12 115 12 12 12 12 12 12 12 12 12 12 12 12 12 12 12 12 115 12 12 12 12 12 12 12 12 12 12 12 12 12 12 12 12 12 12 12 12 12 12 12 12 12 12 12 12 12 12 12 12 12 12 12 12 12 12 12 12 12 12 12 12
12 12 115 12 12 12 12 12 117 117 117 117 117 117 117 117 117 12 12 115 12 12 12 12 12 12 12 12 12 12 12 12 12 12 12 12 12 12 12 12 12 12 12 12 12 12 12 12 12 12 12 12 12 12 12 12 12 12 12 12 12 12 12 12
12 12 115 12 12 11 12 12 117 117 117 117 117 117 117 117 117 12 12 115 12 12 12 12 12 12 12 12 12 12 12 12 12 12 12 12 12 12 12 12 12 12 12 12 12 12 12 12 12 12 12 12 12 12 12 12 12 12 12 12 12 12 12 12
12 12 115 12 116 116 116 90 117 117 117 117 117 117 117 117 117 11 12 115 115 115 115 115 115 115 115 115 115 115 115 115 115 115 115 12 12 12 29 29 29 29 29 29 29 29 29 29 29 29 29 29 29 29 29 29 12 12 12 12 12 12 12 12
12 12 115 12 116 116 116 12 117 117 117 117 117 117 117 117 117 12 12 12 12 12 12 12 12 12 12 12 12 12 12 12 12 12 115 12 12 12 29 29 29 29 29 29 29 29 29 30 29 29 29 29 29 29 29 29 12 12 12 12 12 12 12 12
12 12 115 12 116 12 116 12 117 12 117 117 117 117 117 117 117 12 118 118 118 118 118 12 12 12 118 118 118 118 118 12 11 115 115 115 11 12 29 29 121 121 121 29 29 29 121 121 121 121 121 121 121 121 29 29 12 12 12 12 12 12 12 12
12 12 115 12 12 12 91 12 91 12 12 12 12 12 12 12 12 12 118 118 118 118 118 12 11 12 118 12 12 12 118 12 12 29 91 29 29 29 29 30 121 121 121 29 29 29 121 121 121 121 121 121 121 121 29 29 12 12 12 12 12 12 12 12
12 12 115 115 115 90 111 111 111 90 118 118 118 118 118 118 118 118 118 118 15 118 118 118 118 118 118 12 106 118 118 23 12 29 121 29 30 29 29 29 121 121 121 29 121 29 121 121 121 121 121 121 121 121 29 29 12 12 12 12 12 12 12 12
12 12 12 12 12 12 111 111 111 12 12 12 12 12 12 12 12 12 118 118 118 118 118 12 11 12 118 12 12 12 118 12 12 30 121 121 121 121 29 29 29 121 121 29 121 29 121 121 29 29 30 29 29 29 29 29 12 12 12 12 12 12 12 12
12 114 114 114 114 90 111 111 111 90 119 119 119 119 119 119 119 12 118 118 118 118 118 12 12 12 118 118 118 118 118 12 12 29 121 29 29 121 106 29 29 29 30 29 29 29 29 29 29 29 29 29 29 29 29 29 12 12 12 12 12 12 12 12
12 114 12 12 12 12 91 23 91 12 12 119 119 119 119 119 119 12 12 118 12 12 12 10 12 12 12 12 12 12 12 12 12 29 121 29 30 29 121 121 121 106 121 121 121 29 29 29 29 29 29 29 29 29 29 29 12 12 12 12 12 12 12 12
12 114 114 114 114 12 108 108 108 12 12 119 119 12 119 119 119 12 118 118 118 12 12 112 112 12 12 12 118 118 118 118 12 29 121 121 121 121 121 29 30 29 29 29 121 29 29 30 29 29 29 29 29 29 29 29 12 12 12 12 12 12 12 12
12 114 114 114 12 12 108 108 108 12 12 119 119 12 119 119 119 12 118 118 118 12 12 112 112 12 12 12 12 12 112 12 12 29 29 29 121 29 121 29 29 29 29 29 121 121 121 106 121 121 30 29 29 29 29 29 12 12 12 12 12 12 12 12
12 12 12 12 12 108 108 108 108 108 12 12 12 12 12 12 12 12 91 12 91 12 12 112 112 112 12 12 112 112 112 12 12 12 12 29 121 30 106 121 29 30 29 29 121 29 121 29 29 121 29 29 29 29 29 29 12 12 12 12 12 12 12 12
11 108 108 108 108 108 108 108 108 108 108 108 10 109 109 109 109 109 109 109 109 90 112 112 112 112 12 12 112 112 112 90 123 123 12 29 121 29 121 121 121 121 29 121 121 29 121 30 29 121 121 106 121 29 29 29 12 12 12 12 12 12 12 12
13 108 108 108 108 108 108 108 108 108 108 108 90 109 109 109 109 109 109 109 109 12 112 112 112 112 112 112 112 112 112 10 12 123 12 29 121 29 29 29 29 121 121 121 29 29 121 29 29 121 29 29 121 30 29 29 12 12 12 12 12 12 12 12
11 108 108 108 108 108 108 108 108 108 108 108 10 109 109 109 109 109 109 109 109 90 112 112 112 112 12 12 112 112 112 90 123 123 12 30 121 121 121 121 121 121 29 30 29 29 121 121 106 121 29 29 121 29 29 29 12 12 12 12 12 12 12 12
12 12 12 12 12 108 108 108 108 108 12 12 12 12 12 12 12 12 91 12 91 12 12 112 112 112 12 12 112 112 112 12 12 123 12 29 29 121 29 29 30 29 29 29 121 29 121 29 29 29 29 29 121 29 29 29 12 12 12 12 12 12 12 12
12 12 12 12 12 12 108 108 108 12 12 12 12 12 12 12 12 12 120 120 120 12 12 112 112 12 12 12 12 12 123 12 12 123 12 12 29 121 29 121 121 121 121 29 121 29 121 30 29 29 29 29 121 29 29 29 12 12 12 12 12 12 12 12
12 110 110 110 110 12 108 108 108 12 12 12 12 12 12 12 12 12 120 120 120 12 12 112 112 12 12 12 123 123 123 123 12 123 12 12 30 121 121 121 29 29 121 121 121 106 121 29 121 121 106 121 121 29 29 29 12 12 12 12 12 12 12 12
12 110 110 110 110 12 23 91 23 12 12 12 12 12 12 12 12 12 12 120 12 12 12 10 12 12 12 12 12 12 123 123 12 123 12 12 29 106 121 29 29 121 121 29 29 29 29 29 121 29 29 29 29 29 29 29 12 12 12 12 12 12 12 12
12 110 110 110 110 12 110 110 110 12 12 12 12 12 12 12 12 12 120 120 120 23 12 12 12 12 12 12 12 12 12 12 12 123 12 12 30 121 121 121 29 121 29 29 121 121 121 29 121 29 29 29 29 29 29 29 12 12 12 12 12 12 12 12
12 12 12 110 110 11 110 110 110 11 12 12 12 12 12 12 12 11 120 120 120 90 123 123 123 123 123 123 123 123 123 123 123 123 12 12 29 29 121 121 29 121 29 30 29 121 29 29 121 30 29 29 29 29 29 29 12 12 12 12 12 12 12 12
12 12 12 12 12 12 110 110 110 12 12 12 12 12 12 12 12 12 120 120 120 23 12 12 12 12 12 12 12 12 12 12 12 12 12 12 12 29 121 106 30 121 121 106 121 121 121 29 121 29 29 29 29 29 29 29 12 12 12 12 12 12 12 12
12 12 12 12 12 11 12 93 12 11 12 11 12 11 12 11 12 11 12 11 12 11 12 11 12 11 12 11 12 11 12 11 12 11 12 12 12 30 121 29 29 121 29 29 29 29 121 29 106 29 121 121 121 121 121 29 12 12 12 12 12 12 12 12
12 12 12 12 113 113 113 113 113 113 113 113 113 113 113 113 113 113 113 113 113 113 113 113 113 113 113 113 113 113 113 113 113 113 11 12 12 29 121 121 121 121 29 121 121 30 121 121 121 29 121 121 121 121 121 29 12 12 12 12 12 12 12 12
12 12 12 12 12 113 113 113 113 113 12 11 12 11 12 113 12 11 12 11 12 113 12 11 12 11 12 113 12 11 12 11 12 113 12 12 12 29 29 30 29 29 29 121 121 29 29 29 30 29 121 121 121 121 121 29 12 12 12 12 12 12 12 12
12 113 113 113 113 12 113 113 113 12 12 12 12 12 11 113 11 12 12 12 11 113 11 12 12 12 11 113 11 113 113 12 11 113 11 12 12 29 121 121 121 121 121 121 29 29 29 29 29 29 121 121 121 121 121 29 12 12 12 12 12 12 12 12
12 113 113 12 12 113 12 10 12 12 12 12 12 12 12 113 12 12 12 12 12 113 12 12 12 12 12 106 12 113 113 12 12 113 12 12 12 29 121 121 121 121 121 121 29 29 29 29 29 29 121 121 121 121 121 29 12 12 12 12 12 12 12 12
12 113 113 12 12 113 12 12 12 12 12 12 12 12 11 106 11 12 12 12 11 113 11 12 12 12 11 113 11 12 12 12 11 113 11 12 12 29 121 121 121 121 121 121 30 29 29 29 29 29 121 121 121 121 121 29 12 12 12 12 12 12 12 12
12 113 113 12 113 113 12 12 12 12 12 12 12 12 12 113 12 11 12 11 12 113 12 11 12 11 12 113 12 11 12 11 12 113 12 12 12 29 121 121 121 121 121 121 29 29 29 29 29 29 121 121 121 121 121 29 12 12 12 12 12 12 12 12
12 113 113 12 113 113 12 12 12 12 12 12 12 12 11 113 113 113 113 113 113 113 113 113 106 113 113 113 113 113 113 113 113 113 11 12 12 29 29 29 29 29 29 29 29 29 29 29 29 29 121 121 121 121 121 29 12 12 12 12 12 12 12 12
12 113 113 12 113 113 12 12 12 12 12 12 12 12 12 113 12 11 12 11 12 113 12 11 12 11 12 113 12 11 12 11 12 113 12 12 12 12 12 12 12 12 12 12 12 12 12 12 12 29 121 121 121 121 121 29 12 12 12 12 12 12 12 12
12 113 113 12 113 113 12 12 12 12 12 12 12 12 11 106 11 12 12 12 11 113 11 12 21 21 11 113 11 12 12 12 11 106 11 12 12 12 12 12 12 12 12 12 12 12 12 12 12 29 29 29 29 29 29 29 12 12 12 12 12 12 12 12
12 113 113 12 12 12 12 12 12 12 12 12 12 12 12 113 12 12 12 12 12 106 12 21 140 140 100 113 12 12 12 12 12 113 12 12 12 12 12 12 12 12 12 12 12 12 12 12 12 12 12 12 12 12 12 12 12 12 12 12 12 12 12 12
12 113 113 12 12 12 12 12 12 12 12 12 12 12 11 113 11 12 12 12 11 113 11 12 21 21 11 113 11 12 12 12 11 113 11 12 12 12 12 12 12 12 12 12 12 12 12 12 12 12 12 12 12 12 12 12 12 12 12 12 12 12 12 12
12 113 113 12 12 12 12 12 12 12 12 12 12 12 12 113 12 11 12 11 12 113 12 11 12 11 12 113 12 11 12 11 12 113 12 12 12 12 12 12 12 12 12 12 12 12 12 12 12 12 12 12 12 12 12 12 12 12 12 12 12 12 12 12
12 12 12 12 12 12 12 12 12 12 12 12 12 12 11 113 113 113 113 113 113 113 113 113 106 113 113 113 113 113 106 113 113 113 11 12 12 12 12 12 12 12 12 12 12 12 12 12 12 12 12 12 12 12 12 12 12 12 12 12 12 12 12 12
12 12 12 12 12 12 12 12 12 12 12 12 12 12 12 106 12 11 12 11 12 113 12 11 12 11 12 113 12 11 12 11 12 113 12 12 12 12 12 12 12 12 12 12 12 12 12 12 12 12 12 12 12 12 12 12 12 12 12 12 12 12 12 12
12 12 12 12 12 12 12 12 12 12 12 12 12 12 11 113 11 12 12 12 11 113 11 12 12 12 11 113 11 12 12 12 11 113 11 12 12 12 12 12 12 12 12 12 12 12 12 12 12 12 12 12 12 12 12 12 12 12 12 12 12 12 12 12
12 12 12 12 12 12 12 12 12 12 12 12 12 12 12 113 12 12 12 12 12 113 12 12 12 12 12 106 12 12 12 12 12 106 12 12 12 12 12 12 12 12 12 12 12 12 12 12 12 12 12 12 12 12 12 12 12 12 12 12 12 12 12 12
12 12 12 12 12 12 12 12 12 12 12 12 12 12 11 113 11 12 12 12 11 113 11 12 12 12 11 113 11 12 12 12 11 113 11 12 12 12 12 12 12 12 12 12 12 12 12 12 12 12 12 12 12 12 12 12 12 12 12 12 12 12 12 12
12 12 12 12 12 12 12 12 12 12 12 12 12 12 12 113 12 11 12 11 12 113 12 11 12 11 12 113 12 11 12 11 12 113 12 12 12 12 12 12 12 12 12 12 12 12 12 12 12 12 12 12 12 12 12 12 12 12 12 12 12 12 12 12
12 12 12 12 12 12 12 12 12 12 12 12 12 12 11 113 113 113 113 106 113 113 113 113 106 113 113 113 113 113 113 113 113 113 11 12 12 12 12 12 12 12 12 12 12 12 12 12 12 12 12 12 12 12 12 12 12 12 12 12 12 12 12 12
12 12 12 12 12 12 12 12 12 12 12 12 12 12 12 11 12 11 12 11 12 11 12 11 12 11 12 11 12 11 12 11 12 11 12 12 12 12 12 12 12 12 12 12 12 12 12 12 12 12 12 12 12 12 12 12 12 12 12 12 12 12 12 12
12 12 12 12 12 12 12 12 12 12 12 12 12 12 12 12 12 12 12 12 12 12 12 12 12 12 12 12 12 12 12 12 12 12 12 12 12 12 12 12 12 12 12 12 12 12 12 12 12 12 12 12 12 12 12 12 12 12 12 12 12 12 12 12
12 12 12 12 12 12 12 12 12 12 12 12 12 12 12 12 12 12 12 12 12 12 12 12 12 12 12 12 12 12 12 12 12 12 12 12 12 12 12 12 12 12 12 12 12 12 12 12 12 12 12 12 12 12 12 12 12 12 12 12 12 12 12 12
12 12 12 12 12 12 12 12 12 12 12 12 12 12 12 12 12 12 12 12 12 12 12 12 12 12 12 12 12 12 12 12 12 12 12 12 12 12 12 12 12 12 12 12 12 12 12 12 12 12 12 12 12 12 12 12 12 12 12 12 12 12 12 12
12 12 12 12 12 12 12 12 12 12 12 12 12 12 12 12 12 12 12 12 12 12 12 12 12 12 12 12 12 12 12 12 12 12 12 12 12 12 12 12 12 12 12 12 12 12 12 12 12 12 12 12 12 12 12 12 12 12 12 12 12 12 12 12
12 12 12 12 12 12 12 12 12 12 12 12 12 12 12 12 12 12 12 12 12 12 12 12 12 12 12 12 12 12 12 12 12 12 12 12 12 12 12 12 12 12 12 12 12 12 12 12 12 12 12 12 12 12 12 12 12 12 12 12 12 12 12 12
12 12 12 12 12 12 12 12 12 12 12 12 12 12 12 12 12 12 12 12 12 12 12 12 12 12 12 12 12 12 12 12 12 12 12 12 12 12 12 12 12 12 12 12 12 12 12 12 12 12 12 12 12 12 12 12 12 12 12 12 12 12 12 12
12 12 12 12 12 12 12 12 12 12 12 12 12 12 12 12 12 12 12 12 12 12 12 12 12 12 12 12 12 12 12 12 12 12 12 12 12 12 12 12 12 12 12 12 12 12 12 12 12 12 12 12 12 12 12 12 12 12 12 12 12 12 12 12
12 12 12 12 12 12 12 12 12 12 12 12 12 12 12 12 12 12 12 12 12 12 12 12 12 12 12 12 12 12 12 12 12 12 12 12 12 12 12 12 12 12 12 12 12 12 12 12 12 12 12 12 12 12 12 12 12 12 12 12 12 12 12 12
12 12 12 12 12 12 12 12 12 12 12 12 12 12 12 12 12 12 12 12 12 12 12 12 12 12 12 12 12 12 12 12 12 12 12 12 12 12 12 12 12 12 12 12 12 12 12 12 12 12 12 12 12 12 12 12 12 12 12 12 12 12 12 12
12 12 12 12 12 12 12 12 12 12 12 12 12 12 12 12 12 12 12 12 12 12 12 12 12 12 12 12 12 12 12 12 12 12 12 12 12 12 12 12 12 12 12 12 12 12 12 12 12 12 12 12 12 12 12 12 12 12 12 12 12 12 12 12
12 12 12 12 12 12 12 12 12 12 12 12 12 12 12 12 12 12 12 12 12 12 12 12 12 12 12 12 12 12 12 12 12 12 12 12 12 12 12 12 12 12 12 12 12 12 12 12 12 12 12 12 12 12 12 12 12 12 12 12 12 12 12 12
12 12 12 12 12 12 12 12 12 12 12 12 12 12 12 12 12 12 12 12 12 12 12 12 12 12 12 12 12 12 12 12 12 12 12 12 12 12 12 12 12 12 12 12 12 12 12 12 12 12 12 12 12 12 12 12 12 12 12 12 12 12 12 12
12 12 12 12 12 12 12 12 12 12 12 12 12 12 12 12 12 12 12 12 12 12 12 12 12 12 12 12 12 12 12 12 12 12 12 12 12 12 12 12 12 12 12 12 12 12 12 12 12 12 12 12 12 12 12 12 12 12 12 12 12 12 12 12
12 12 12 12 12 12 12 12 12 12 12 12 12 12 12 12 12 12 12 12 12 12 12 12 12 12 12 12 12 12 12 12 12 12 12 12 12 12 12 12 12 12 12 12 12 12 12 12 12 12 12 12 12 12 12 12 12 12 12 12 12 12 12 12
12 12 12 12 12 12 12 12 12 12 12 12 12 12 12 12 12 12 12 12 12 12 12 12 12 12 12 12 12 12 12 12 12 12 12 12 12 12 12 12 12 12 12 12 12 12 12 12 12 12 12 12 12 12 12 12 12 12 12 12 12 12 12 12
12 12 12 12 12 12 12 12 12 12 12 12 12 12 12 12 12 12 12 12 12 12 12 12 12 12 12 12 12 12 12 12 12 12 12 12 12 12 12 12 12 12 12 12 12 12 12 12 12 12 12 12 12 12 12 12 12 12 12 12 12 12 12 12
12 12 12 12 12 12 12 12 12 12 12 12 12 12 12 12 12 12 12 12 12 12 12 12 12 12 12 12 12 12 12 12 12 12 12 12 12 12 12 12 12 12 12 12 12 12 12 12 12 12 12 12 12 12 12 12 12 12 12 12 12 12 12 12
