29 29 29 29 29 29 29 29 29 29 29 29 29 29 29 29 29 29 29 30 29 29 29 29 29 29 30 29 29 30 29 29 30 29 29 29 29 29 29 29 29 29 29 29 29 29 29 29 29 29 29 29 29 29 29 29 29 29 29 29 29 29 29 29
29 29 29 30 29 108 29 108 29 108 29 108 29 30 29 29 29 29 120 120 120 120 29 29 119 119 119 106 119 106 119 119 119 29 30 29 121 121 121 29 29 29 29 29 29 29 29 29 29 29 29 29 29 29 29 29 29 29 29 29 29 29 29 29
13 108 108 108 108 108 108 108 108 108 108 108 108 108 108 29 30 29 29 120 120 120 120 90 119 119 119 12 11 12 119 119 119 90 121 121 121 121 121 121 29 29 29 29 29 29 29 29 29 29 29 29 29 29 29 29 29 29 29 29 29 29 29 29
29 29 29 108 108 108 108 108 108 108 108 108 108 108 108 108 108 108 29 29 120 120 120 29 119 119 119 11 12 11 119 119 119 29 121 121 121 121 121 121 29 29 29 29 29 29 29 29 29 29 29 29 29 29 29 29 29 29 29 29 29 29 29 29
29 108 108 29 29 108 29 108 29 108 29 108 29 29 29 29 29 108 108 29 120 120 29 29 29 119 119 12 11 12 119 119 29 29 29 121 121 121 121 121 29 29 29 29 29 29 29 29 29 29 29 29 29 29 29 29 29 29 29 29 29 29 29 29
29 108 108 29 29 29 29 29 29 29 29 29 29 108 108 108 29 29 108 29 29 29 30 29 30 119 119 119 119 119 119 119 29 29 121 121 121 121 121 29 29 29 30 29 29 29 29 29 29 29 29 29 29 29 29 29 29 29 29 29 29 29 29 29
29 30 29 30 29 29 29 29 29 29 108 108 108 108 29 108 108 108 108 29 116 116 116 116 29 29 119 119 119 119 119 29 29 29 29 29 29 30 29 29 29 29 122 122 122 29 29 29 29 29 29 29 29 29 29 29 29 29 29 29 29 29 29 29
29 29 108 108 108 108 108 108 108 108 108 108 29 108 29 29 108 108 29 29 116 116 116 116 29 30 119 119 119 119 119 30 29 29 29 29 29 122 122 29 29 122 122 122 122 29 29 29 29 29 29 29 29 29 29 29 29 29 29 29 29 29 29 29
29 108 108 108 108 108 29 29 108 108 29 108 108 108 108 29 108 29 29 30 116 116 29 29 29 29 29 29 91 29 29 29 30 29 29 29 122 122 122 122 122 122 122 122 29 29 29 29 29 29 29 29 29 29 29 29 29 29 29 29 29 29 29 29
29 108 108 108 108 108 108 108 108 108 108 108 29 29 108 108 108 30 29 29 116 116 116 116 90 114 114 29 114 29 114 114 114 90 122 122 122 122 122 122 122 122 122 29 29 29 29 29 29 30 29 29 29 29 29 29 29 29 29 29 29 29 29 29
29 29 108 29 29 30 29 30 29 29 29 29 30 108 108 108 108 29 29 29 29 29 30 29 29 29 114 29 114 29 106 29 29 29 29 29 29 29 122 122 122 122 122 29 29 141 141 141 141 141 141 141 141 141 29 29 29 29 29 29 29 29 29 29
29 29 91 29 29 29 29 29 29 29 29 29 29 30 29 29 29 30 111 111 29 29 29 29 29 29 106 29 106 29 114 29 123 29 123 123 123 29 29 122 122 29 29 29 30 141 29 29 29 29 29 29 29 141 30 29 29 29 29 29 29 29 29 29
29 29 109 29 29 29 29 29 29 29 29 30 29 111 111 111 111 111 111 111 111 111 29 29 29 29 114 29 114 29 106 30 123 29 123 29 29 29 29 29 30 29 139 29 29 141 30 139 139 139 139 139 29 141 29 29 29 29 29 29 29 29 29 29
29 29 109 29 29 29 29 29 29 29 29 111 111 111 111 111 111 111 111 111 111 111 111 111 90 114 114 114 114 114 114 29 123 123 123 123 123 30 29 29 29 139 139 139 29 141 29 139 139 139 139 139 29 141 29 29 29 29 29 29 29 29 29 29
29 29 109 30 29 29 29 29 29 29 111 111 111 111 111 111 111 111 111 111 111 29 29 29 29 29 106 29 106 29 106 29 29 29 123 29 123 29 29 29 29 29 91 29 29 91 29 29 29 91 29 29 29 141 29 29 29 29 29 29 29 29 29 29
29 29 109 29 29 29 30 29 111 111 111 111 111 111 29 29 29 29 29 111 111 29 115 115 90 114 114 29 114 29 114 90 123 123 123 29 106 29 29 113 113 113 113 113 113 113 113 113 113 113 113 113 29 141 29 29 29 29 29 29 29 29 29 29
29 109 109 109 90 111 111 111 111 111 111 111 111 29 29 113 113 29 29 29 91 29 29 29 29 29 29 29 91 29 29 29 29 29 29 29 29 29 29 113 29 29 91 29 91 29 29 113 29 29 29 113 29 141 29 29 29 29 29 29 29 29 29 29
29 29 109 29 29 29 29 29 111 111 111 29 30 29 29 113 113 113 113 113 113 113 113 113 29 29 29 29 117 117 117 117 117 117 29 29 29 29 29 113 29 138 138 29 137 137 29 113 29 136 29 113 29 141 29 29 29 29 29 29 29 29 29 29
29 29 91 29 29 110 29 29 29 111 111 111 29 29 29 113 106 29 29 29 29 29 30 113 113 113 113 29 117 117 117 117 29 29 29 113 113 113 113 113 29 138 138 29 137 137 30 113 90 136 29 113 29 141 29 29 29 29 29 29 29 29 29 29
29 29 110 29 29 110 110 29 30 111 111 111 111 29 30 29 29 29 111 111 111 29 29 29 29 29 113 29 117 117 117 117 117 117 29 113 29 29 29 113 29 29 29 29 29 29 29 113 29 136 29 113 29 141 29 29 29 29 29 29 29 29 29 29
29 29 110 29 29 29 29 29 29 29 29 111 111 111 111 111 111 111 111 111 111 111 29 29 29 29 113 29 29 29 29 117 29 29 29 113 29 29 29 113 29 29 30 29 29 113 113 113 29 136 30 113 29 141 29 27 27 27 27 27 27 27 29 29
29 30 110 29 106 106 29 29 29 29 29 29 111 111 111 111 111 111 111 111 111 111 111 29 29 29 113 113 113 113 29 117 117 117 29 113 30 29 29 113 113 113 113 113 113 113 113 29 29 136 29 113 29 141 29 27 27 27 2 27 27 27 29 29
29 29 110 29 110 110 106 29 29 29 29 29 30 29 111 111 111 111 111 111 111 111 111 90 118 29 29 29 29 113 29 117 29 29 29 113 29 29 29 29 29 113 29 29 29 29 113 29 136 136 29 113 29 141 29 27 2 140 140 140 27 27 29 29
29 29 110 110 110 110 110 110 29 29 29 29 29 29 29 111 111 111 111 111 111 111 111 29 118 118 118 118 29 113 29 29 29 30 29 113 29 29 29 29 29 113 29 135 29 29 113 29 29 29 29 113 29 141 29 27 27 140 140 140 2 27 29 29
29 29 110 110 110 110 110 110 110 30 29 29 29 29 29 29 111 111 111 111 111 111 29 29 29 118 118 118 29 113 113 113 113 113 113 113 113 113 113 113 113 113 30 135 135 90 113 113 113 113 113 113 30 141 29 27 27 27 2 27 27 27 29 29
29 29 110 110 110 110 110 110 110 29 29 29 29 29 29 29 29 111 111 111 111 29 29 29 29 118 118 118 29 29 29 29 30 29 29 29 29 29 30 29 29 113 29 135 135 29 113 29 29 29 29 29 29 141 29 27 2 140 140 140 2 27 29 29
29 29 29 110 110 110 110 110 29 29 29 29 29 29 29 29 29 29 111 111 111 111 29 29 118 118 118 118 118 29 29 27 27 1 2 27 2 27 29 29 29 113 29 29 29 29 113 29 141 141 141 141 141 141 29 27 140 140 140 140 140 2 29 29
29 29 29 30 29 91 29 29 29 29 29 29 29 29 29 29 29 29 29 29 111 111 29 118 118 118 118 118 118 29 27 27 142 142 142 142 142 27 29 29 29 113 113 113 113 113 113 29 141 29 29 29 29 29 29 27 140 140 140 140 140 27 29 29
29 29 29 29 112 112 112 112 29 30 29 29 29 29 29 29 29 29 29 29 30 29 29 29 118 118 118 118 29 29 27 142 142 142 142 142 142 90 141 141 29 29 29 29 30 29 29 29 141 29 29 29 29 29 29 2 140 140 140 140 140 27 29 29
29 29 29 112 112 112 112 112 112 112 29 29 29 29 29 29 29 29 29 29 29 29 29 29 118 118 118 29 29 29 27 27 142 142 142 142 142 27 29 141 106 141 106 141 106 141 106 141 141 29 29 27 27 27 27 27 106 140 140 140 106 27 27 27
29 29 29 112 112 29 29 112 112 112 29 29 29 29 29 29 29 29 29 29 29 29 29 29 29 118 29 29 29 27 27 2 142 142 142 142 142 2 29 29 30 29 29 29 29 29 29 29 29 29 29 27 27 27 27 2 27 27 101 27 2 27 27 27
29 29 30 112 112 29 29 29 112 112 112 29 29 29 29 29 29 29 29 29 29 29 29 29 29 29 29 27 27 27 21 3 142 142 142 142 142 27 21 21 27 27 29 29 29 29 29 29 29 29 29 27 27 21 21 1 143 143 143 143 143 2 21 27
29 29 29 29 112 112 29 29 29 112 112 112 29 29 29 29 29 29 29 29 29 29 29 29 29 27 27 27 27 21 142 100 142 142 142 142 142 100 142 142 21 27 29 29 29 29 29 29 29 27 27 27 21 143 143 100 143 143 143 143 143 100 143 21
29 29 29 29 112 112 112 29 29 29 112 112 30 29 29 29 29 29 29 29 29 29 29 29 29 27 27 27 27 27 21 3 142 142 142 142 142 2 21 21 27 27 29 29 29 29 29 29 29 27 27 27 27 21 21 27 143 143 143 143 143 27 21 27
29 29 29 29 29 112 112 112 29 29 112 112 29 29 29 29 29 29 29 29 29 29 29 29 29 27 27 27 27 27 27 2 142 142 142 142 142 27 27 2 27 27 29 29 29 29 29 29 29 27 27 2 1 27 2 27 143 143 143 143 143 1 27 27
29 29 29 29 29 112 112 112 112 112 112 112 29 29 29 29 29 29 29 29 29 29 29 29 29 27 27 27 27 142 27 27 142 142 142 142 142 27 27 142 2 27 29 29 29 29 29 29 29 27 143 143 143 143 143 143 143 143 143 143 143 2 27 27
29 29 29 29 29 29 29 112 112 112 112 29 29 29 29 29 29 29 29 29 29 29 29 29 29 27 27 27 1 142 142 142 142 142 142 142 142 142 142 142 27 27 29 29 29 29 29 29 29 2 143 143 143 143 143 143 143 143 143 143 143 27 27 27
29 29 29 29 29 29 29 30 29 29 29 29 29 29 29 29 29 29 29 29 29 29 29 29 29 27 27 27 27 142 27 2 1 2 4 27 27 2 27 142 2 27 27 27 27 27 27 27 27 27 143 143 143 143 143 143 143 143 143 143 143 2 27 27
29 29 29 29 29 29 29 29 29 29 29 29 29 29 29 29 29 29 29 29 29 29 29 29 29 27 27 27 27 91 27 27 27 27 27 27 27 27 27 91 1 27 2 1 27 27 27 27 27 27 2 95 27 95 27 95 27 1 27 1 1 27 27 27
29 29 29 29 29 29 29 29 29 29 29 29 29 29 29 29 29 29 29 29 29 29 29 29 29 27 27 2 134 134 134 2 27 27 27 27 27 27 1 133 133 133 133 133 27 27 27 27 27 2 130 130 130 130 130 130 130 130 130 130 130 130 130 27
29 29 29 29 29 29 29 29 29 29 29 29 29 29 29 29 29 29 29 29 29 29 29 29 29 27 27 134 134 134 134 134 27 2 27 2 27 27 2 133 133 27 1 133 133 2 27 27 27 2 130 130 130 130 130 130 130 130 130 130 130 130 130 2
29 29 29 29 29 29 29 29 29 29 29 29 29 29 29 29 29 29 29 29 29 29 29 29 29 27 2 134 134 15 134 134 134 134 134 134 134 134 27 133 133 133 27 2 133 27 27 27 27 3 130 130 130 130 130 130 130 130 130 130 130 130 130 3
29 29 29 29 29 29 29 29 29 29 29 29 29 29 29 29 29 29 29 29 29 29 29 29 29 27 27 134 134 134 134 134 27 27 134 134 27 134 27 27 27 133 133 2 133 133 27 2 27 27 130 130 130 130 130 130 130 130 130 130 130 130 130 27
29 29 29 29 29 29 29 29 29 29 29 29 29 29 29 29 29 29 29 29 29 29 29 29 29 27 27 27 134 134 134 1 27 27 2 134 2 134 90 133 133 27 133 133 133 133 133 133 133 2 130 130 130 130 130 130 130 130 130 130 130 130 130 2
29 29 29 29 29 29 29 29 29 29 29 29 29 29 29 29 29 29 29 29 29 29 29 29 29 27 27 27 27 27 27 27 27 27 27 27 27 1 27 133 133 27 2 27 133 1 2 27 133 27 27 27 27 2 27 93 4 93 2 27 27 2 1 27
29 29 29 29 29 29 29 29 29 29 29 29 29 29 29 29 29 29 29 29 29 29 29 29 29 27 27 27 27 27 27 27 27 27 27 27 27 27 27 27 27 27 27 27 133 133 133 133 133 2 27 27 27 27 131 131 131 131 131 27 27 27 27 27
29 29 29 29 29 29 29 29 29 29 29 29 29 29 29 29 29 29 29 29 29 29 29 29 29 27 27 27 27 27 27 27 27 27 27 27 27 27 27 27 27 27 27 27 1 2 27 133 133 133 27 27 27 27 27 131 131 131 2 27 27 27 27 27
29 29 29 29 29 29 29 29 29 29 29 29 29 29 29 29 29 29 29 29 29 29 29 29 29 27 27 27 27 27 27 27 27 27 27 27 27 27 27 27 27 27 27 27 27 27 133 133 133 133 133 27 27 27 27 27 131 27 27 27 27 27 27 27
29 29 29 29 29 29 29 29 29 29 29 29 29 29 29 29 29 29 29 29 29 29 29 29 29 27 27 27 27 27 27 27 27 27 27 27 27 27 27 27 27 27 27 27 27 133 133 133 133 133 133 133 27 2 27 27 131 2 27 2 27 27 27 27
29 29 29 29 29 29 29 29 29 29 29 29 29 29 29 29 29 29 29 29 29 29 29 29 29 27 27 27 27 27 27 27 27 27 27 27 27 27 27 27 27 27 27 27 1 91 27 27 91 27 27 91 27 2 27 2 131 131 131 131 27 27 27 27
29 29 29 29 29 29 29 29 29 29 29 29 29 29 29 29 29 29 29 29 29 29 29 29 29 27 27 27 27 27 27 27 2 27 4 27 27 2 27 27 27 27 27 27 132 132 132 132 132 132 132 132 132 27 27 27 27 2 27 131 27 27 27 27
29 29 29 29 29 29 29 29 29 29 29 29 29 29 29 29 29 29 29 29 29 29 29 29 29 27 27 27 27 27 27 129 129 129 129 129 129 129 27 1 2 27 2 132 132 132 132 132 132 132 132 132 132 132 27 27 27 27 27 131 2 27 27 27
29 29 29 29 29 29 29 29 29 29 29 29 29 29 29 29 29 29 29 29 29 29 29 29 29 27 27 27 27 27 2 129 129 129 129 129 129 129 27 132 132 27 132 132 132 17 132 132 132 132 132 17 132 132 132 2 132 132 2 131 27 27 27 27
29 29 29 29 29 29 29 29 29 29 29 29 29 29 29 29 29 29 29 29 29 29 29 29 29 27 27 27 27 27 2 129 129 15 14 15 129 129 90 132 132 2 132 132 132 132 132 132 132 132 132 132 132 132 132 27 132 132 90 131 1 27 27 27
29 29 29 29 29 29 29 29 29 29 29 29 29 29 29 29 29 29 29 29 29 29 29 29 29 27 27 27 27 27 4 129 129 14 15 14 129 129 27 132 132 132 132 132 132 132 132 17 20 17 132 132 132 132 132 132 132 132 27 27 27 27 27 27
29 29 29 29 29 29 29 29 29 29 29 29 29 29 29 29 29 29 29 29 29 29 29 29 29 27 27 27 27 27 27 129 129 15 14 15 129 129 90 132 132 132 132 132 132 132 132 17 20 17 132 132 132 132 132 132 132 132 2 27 27 27 27 27
29 29 29 29 29 29 29 29 29 29 29 29 29 29 29 29 29 29 29 29 29 29 29 29 29 27 27 27 27 27 2 129 129 129 129 129 129 129 27 132 132 2 132 132 132 132 132 132 132 132 132 132 132 132 132 27 132 132 1 27 27 27 27 27
29 29 29 29 29 29 29 29 29 29 29 29 29 29 29 29 29 29 29 29 29 29 29 29 29 27 27 27 27 27 27 129 129 129 129 129 129 129 2 132 132 1 132 132 132 17 132 132 132 132 132 17 132 132 132 27 132 132 2 27 27 27 27 27
29 29 29 29 29 29 29 29 29 29 29 29 29 29 29 29 29 29 29 29 29 29 29 29 29 27 27 27 27 27 27 27 1 2 4 27 2 1 27 132 132 27 27 132 132 132 132 132 132 132 132 132 132 132 2 2 132 132 1 27 27 27 27 27
29 29 29 29 29 29 29 29 29 29 29 29 29 29 29 29 29 29 29 29 29 29 29 29 29 27 27 27 27 27 27 27 27 27 27 27 27 27 2 132 132 2 27 2 132 132 132 132 132 132 132 132 132 1 27 1 132 132 27 27 27 27 27 27
29 29 29 29 29 29 29 29 29 29 29 29 29 29 29 29 29 29 29 29 29 29 29 29 29 27 27 27 27 27 27 27 27 27 27 27 27 27 1 132 132 27 2 27 27 132 2 27 132 27 2 132 27 27 2 27 132 132 27 27 27 27 27 27
29 29 29 29 29 29 29 29 29 29 29 29 29 29 29 29 29 29 29 29 29 29 29 29 29 27 27 27 27 27 27 27 27 27 27 27 27 27 2 132 132 132 132 132 132 132 132 132 132 132 132 132 132 132 132 132 132 132 1 27 27 27 27 27
29 29 29 29 29 29 29 29 29 29 29 29 29 29 29 29 29 29 29 29 29 29 29 29 29 27 27 27 27 27 27 27 27 27 27 27 27 27 27 132 132 132 132 132 132 132 132 132 132 132 132 132 132 132 132 132 132 132 27 27 27 27 27 27
29 29 29 29 29 29 29 29 29 29 29 29 29 29 29 29 29 29 29 29 29 29 29 29 29 27 27 27 27 27 27 27 27 27 27 27 27 27 27 27 2 27 27 1 1 27 27 1 2 27 27 1 2 2 1 27 2 27 27 27 27 27 27 27
