8 8 8 8 8 8 8 8 8 8 8 8 8 8 8 8 8 8 8 8 8 8 8 8 8 8 8 8 8 8 8 8 8 8 8 8 8 8 8 8 8 8 8 8 8 8 8 8 8 8 8 8 8 8 8 8 8 8 8 8 8 8 8 8
8 108 108 108 108 108 108 108 108 108 108 108 108 108 108 108 108 108 8 8 8 8 8 8 8 8 8 8 8 8 12 12 12 12 12 12 12 12 12 12 12 12 12 12 12 12 12 12 12 12 8 8 8 8 8 8 8 8 8 8 8 8 8 8
8 108 108 108 108 108 108 108 108 108 108 108 108 108 108 108 108 108 108 108 8 8 8 8 8 8 8 8 8 8 12 12 12 12 12 12 12 12 12 12 12 12 12 12 12 12 12 12 12 12 8 8 8 8 8 8 8 8 8 8 8 8 8 8
8 108 108 108 108 108 108 108 17 18 17 108 108 108 108 108 108 108 8 8 8 8 8 8 8 8 8 8 8 8 12 12 12 12 12 12 12 12 12 12 12 12 12 12 12 12 12 12 12 12 8 8 8 8 8 8 8 8 8 8 8 8 8 8
8 108 108 108 108 108 108 108 18 17 18 108 108 108 108 108 108 108 108 108 108 90 113 113 8 8 8 8 8 8 12 12 12 12 12 12 12 12 12 12 12 12 12 12 12 12 12 12 12 12 8 8 8 8 8 8 8 8 8 8 8 8 8 8
8 108 108 108 108 108 108 108 17 18 17 108 108 108 108 108 108 108 8 8 8 8 8 8 8 8 8 8 8 8 12 12 12 12 142 142 142 142 142 12 12 12 12 12 12 12 12 12 12 12 8 8 8 8 8 8 8 8 8 8 8 8 8 8
8 108 108 108 108 108 108 108 108 108 108 108 108 108 108 108 108 108 108 108 8 8 8 8 8 8 8 8 8 8 12 12 12 12 142 142 142 142 142 12 12 12 12 12 12 12 12 12 12 12 8 8 8 8 8 8 8 8 8 8 8 8 8 8
8 108 108 108 108 108 108 108 108 108 108 108 108 108 108 108 108 108 8 8 8 8 8 8 8 8 8 8 8 8 12 12 12 12 142 142 142 142 142 12 12 12 12 12 12 12 12 12 12 12 8 8 8 8 8 8 8 8 8 8 8 8 8 8
8 108 8 8 108 108 108 8 8 8 8 8 108 108 108 8 8 108 108 108 108 108 90 114 114 114 114 114 114 8 12 12 12 12 142 142 142 142 142 12 12 12 12 12 12 12 12 12 12 12 8 8 8 8 8 8 8 8 8 8 8 8 8 8
8 108 8 8 108 108 108 8 8 8 8 8 108 108 108 8 8 108 8 8 8 8 8 8 8 8 8 8 8 8 12 12 12 12 142 142 142 142 142 12 12 12 12 12 12 12 12 12 12 12 8 8 8 8 8 8 8 8 8 8 8 8 8 8
8 108 8 8 8 91 8 8 8 8 8 8 8 91 8 8 8 108 108 108 8 8 8 8 8 8 8 8 8 8 12 12 12 12 142 142 142 142 142 12 10 12 12 12 12 12 12 12 12 12 8 8 8 8 8 8 8 8 8 8 8 8 8 8
8 108 8 8 110 110 110 110 110 110 90 111 111 111 111 8 8 108 8 8 8 8 8 8 8 8 8 8 8 8 12 12 12 12 12 12 12 142 142 12 142 12 12 12 12 12 12 12 12 12 8 8 8 8 8 8 8 8 8 8 8 8 8 8
8 108 8 8 110 110 110 110 8 8 8 111 111 111 111 8 8 108 108 108 108 90 115 115 115 8 8 8 8 8 12 12 12 12 12 12 12 12 12 12 142 12 12 12 12 12 12 12 12 12 8 8 8 8 8 8 8 8 8 8 8 8 8 8
8 108 8 8 110 110 110 110 8 8 8 111 111 111 111 8 8 108 8 8 8 8 8 8 8 8 8 8 8 8 12 12 12 12 12 12 11 12 12 142 142 142 12 12 11 12 12 12 12 12 8 8 8 8 8 8 8 8 8 8 8 8 8 8
8 108 8 8 110 110 110 110 90 111 111 111 111 111 111 8 8 108 108 108 8 8 8 8 8 8 8 8 8 8 12 12 12 12 12 142 142 142 142 142 142 142 142 142 142 142 12 12 12 12 8 8 8 8 8 8 8 8 8 8 8 8 8 8
8 108 8 8 8 8 8 8 8 8 8 8 8 8 8 8 8 108 8 8 8 8 8 8 8 8 8 8 8 8 12 12 12 12 12 142 142 142 142 142 142 142 142 142 142 142 12 12 12 12 8 8 8 8 8 8 8 8 8 8 8 8 8 8
8 108 8 8 8 8 8 8 8 111 111 111 111 111 111 8 8 108 108 90 116 8 8 8 8 8 8 8 8 8 12 12 12 12 11 142 142 142 142 142 142 142 142 142 142 142 11 12 12 12 8 8 8 8 8 8 8 8 8 8 8 8 8 8
8 108 8 13 8 8 8 8 8 111 111 111 111 111 111 8 8 108 8 8 8 8 8 8 8 8 8 8 8 8 12 12 12 12 12 142 142 142 142 142 142 142 142 142 142 142 12 12 12 12 8 8 8 8 8 8 8 8 8 8 8 8 8 8
8 108 108 108 108 8 8 8 8 8 111 111 111 111 111 8 8 108 108 8 8 8 8 8 8 8 8 8 8 8 12 12 12 12 12 142 142 142 142 142 142 142 142 142 142 142 12 12 12 12 8 8 8 8 8 8 8 8 8 8 8 8 8 8
8 108 108 108 108 8 8 8 8 8 8 8 8 8 8 8 8 108 8 8 8 8 8 8 8 8 8 8 8 8 12 12 12 12 12 12 93 12 93 12 12 12 93 12 93 12 12 12 12 12 8 8 8 8 8 8 8 8 8 8 8 8 8 8
8 108 108 108 108 108 108 108 108 108 108 8 8 8 8 8 8 108 108 8 8 8 8 8 8 8 8 8 8 8 12 12 12 12 138 138 138 138 138 138 12 139 139 139 139 139 12 12 12 12 12 12 12 12 12 12 12 12 12 12 12 12 12 12
8 108 108 108 108 8 8 8 8 8 8 8 8 8 8 8 8 108 8 8 8 8 8 8 8 8 8 8 117 8 12 12 12 12 12 138 138 138 138 138 90 139 139 139 139 139 12 12 12 12 12 12 12 12 12 12 12 12 12 12 12 12 12 12
8 108 108 108 108 8 8 8 8 8 8 8 8 8 8 8 8 108 108 108 108 108 108 90 117 117 117 117 117 8 12 12 12 11 138 138 138 138 138 138 12 139 139 139 139 139 11 12 12 12 12 12 12 12 12 12 12 12 12 12 12 12 12 12
8 108 8 13 8 8 8 8 8 8 8 8 8 8 8 8 8 108 8 8 8 8 8 8 8 8 8 8 8 8 12 12 12 12 12 138 138 138 138 138 90 139 139 139 139 139 12 12 12 12 12 11 12 12 112 112 112 112 112 112 112 12 12 12
8 108 8 8 8 8 8 8 8 8 8 8 8 8 8 8 8 108 108 8 8 8 8 8 8 8 8 8 12 12 12 12 12 12 138 138 138 138 138 138 12 139 139 139 139 139 12 12 12 12 135 135 135 90 112 112 112 112 112 112 112 12 12 12
8 108 8 8 8 8 8 8 8 8 8 8 8 8 8 8 8 108 8 8 8 8 8 8 8 8 8 8 12 12 12 11 12 12 12 12 12 11 12 12 12 12 12 91 12 12 12 12 12 12 135 135 135 10 112 112 112 112 112 112 112 11 21 12
8 108 8 8 8 8 8 8 8 8 8 8 8 8 8 8 8 108 108 108 108 90 118 118 118 118 118 8 12 141 141 141 141 141 12 136 136 136 136 136 12 137 137 137 137 137 137 11 12 12 135 135 135 90 112 112 112 112 112 112 112 100 112 21
8 108 8 8 8 8 8 8 8 8 8 8 8 8 8 8 8 108 8 8 8 8 8 8 8 8 8 8 12 141 141 141 141 141 12 136 136 136 136 136 12 137 137 137 137 137 12 12 12 12 135 135 135 10 112 112 112 112 112 112 112 11 21 12
8 108 8 8 8 8 8 8 8 8 8 8 8 8 8 8 8 108 108 108 8 8 8 8 8 8 8 8 11 141 141 141 141 141 90 136 136 136 136 136 90 137 137 137 137 137 137 11 12 12 135 135 135 90 112 112 112 112 112 112 112 12 12 12
8 108 8 8 8 8 8 8 8 8 8 8 8 8 8 8 8 108 8 8 8 8 8 8 8 8 8 8 12 141 141 141 141 141 12 136 136 136 136 136 12 137 137 137 137 137 12 12 12 12 135 135 135 12 112 112 112 112 112 112 112 12 12 12
8 108 8 8 8 8 8 8 8 8 8 8 8 8 8 8 8 108 108 108 90 119 119 8 8 8 8 8 12 141 141 141 141 141 12 136 136 136 136 136 12 137 137 137 137 137 137 11 12 12 135 135 135 12 12 12 12 12 12 12 12 12 12 12
8 108 8 8 8 8 8 8 8 8 8 8 8 8 8 8 8 108 8 8 8 8 8 8 8 8 8 8 12 12 12 91 12 12 12 12 12 91 12 12 12 137 12 137 12 137 12 12 12 12 135 135 135 12 12 12 12 12 12 12 12 12 12 12
8 108 8 8 8 8 8 8 8 8 8 8 8 8 8 8 8 108 108 108 8 8 8 8 8 8 8 8 12 140 140 140 140 140 12 135 135 135 135 135 12 11 12 11 12 11 12 12 12 12 135 135 135 12 12 12 12 12 12 12 12 12 12 12
8 108 8 8 8 8 8 8 8 8 8 8 8 8 8 8 8 108 8 8 8 8 8 8 8 8 8 8 12 140 140 140 140 140 12 135 135 135 135 135 12 12 12 12 12 12 12 12 12 12 135 135 135 12 12 12 12 12 12 12 12 12 12 12
8 108 8 8 8 8 8 8 8 8 8 8 8 8 8 8 8 108 108 108 90 120 120 120 120 120 8 8 11 140 140 140 140 140 11 135 135 135 135 135 11 12 12 12 12 12 12 12 12 12 135 135 135 12 12 12 8 8 8 8 8 8 8 8
8 108 8 8 8 8 8 8 8 8 8 8 8 8 8 8 8 108 8 8 8 8 8 8 8 8 8 8 12 140 140 140 140 140 12 135 135 135 135 135 12 134 134 12 12 12 134 134 12 12 12 12 135 12 12 12 8 8 8 8 8 8 8 8
8 108 8 8 8 8 8 8 8 8 8 8 8 8 8 8 8 108 108 108 8 8 8 8 8 8 8 8 12 140 140 140 140 140 12 135 135 135 135 135 90 134 134 134 12 134 134 134 12 12 12 12 135 12 12 12 8 8 8 8 8 8 8 8
8 108 8 8 8 8 8 8 8 8 8 8 8 8 8 8 8 108 8 8 8 8 8 8 8 8 8 8 8 12 12 11 12 12 12 12 12 11 12 12 12 12 134 134 134 134 134 12 12 135 135 135 135 12 12 12 8 8 8 8 8 8 8 8
8 108 8 8 8 8 8 8 8 8 8 8 8 8 8 8 8 108 108 108 90 121 121 121 121 121 121 121 8 12 12 12 12 12 12 12 12 12 12 12 12 12 12 134 134 134 12 12 12 135 135 135 135 12 12 12 8 8 8 8 8 8 8 8
8 108 8 8 8 8 8 8 8 8 8 8 8 8 8 8 8 108 8 8 8 8 8 8 8 8 8 8 8 8 8 8 8 8 8 8 8 8 8 12 12 12 12 134 134 134 12 12 12 135 135 135 135 12 12 12 8 8 8 8 8 8 8 8
8 108 8 8 8 8 8 8 8 8 8 8 8 8 8 8 8 108 108 108 90 122 122 122 122 122 122 122 122 122 122 122 122 122 122 8 8 8 8 12 12 12 12 23 93 23 12 12 12 23 95 23 12 12 12 12 8 8 8 8 8 8 8 8
8 108 8 13 8 8 8 8 8 8 8 8 8 8 8 8 8 108 8 8 8 8 8 8 8 8 8 8 8 8 8 8 8 8 8 8 8 8 8 12 12 12 12 133 133 133 12 12 12 133 133 133 12 12 12 12 8 8 8 8 8 8 8 8
8 108 108 108 108 8 8 8 8 8 8 8 8 8 8 8 8 108 108 108 90 123 123 123 123 123 8 8 8 8 8 8 8 8 8 8 8 8 8 12 12 12 12 133 133 133 12 12 12 133 133 133 12 12 12 12 8 8 8 8 8 8 8 8
8 108 108 108 108 8 8 8 8 8 8 8 8 8 8 8 8 108 8 8 8 8 8 8 8 8 8 8 8 8 8 8 8 8 8 8 8 8 8 12 12 12 12 133 133 133 12 10 12 133 133 133 12 12 12 12 8 8 8 8 8 8 8 8
8 108 108 108 108 108 108 108 108 8 8 8 8 8 8 8 8 108 8 8 8 8 8 8 8 8 8 8 8 8 8 8 8 8 8 8 8 8 8 12 12 12 12 133 133 133 133 133 133 133 133 133 12 12 12 12 8 8 8 8 8 8 8 8
8 108 108 108 108 8 8 8 8 8 8 8 8 8 8 8 8 108 108 108 108 108 108 108 108 90 124 124 124 124 124 8 8 8 8 8 8 8 8 12 12 12 12 133 133 133 133 133 133 133 133 133 12 12 12 12 8 8 8 8 8 8 8 8
8 108 108 108 108 8 8 8 8 8 8 8 8 8 8 8 8 108 8 8 8 8 8 8 8 8 8 8 8 8 8 8 8 8 8 8 8 8 8 8 12 12 12 133 133 133 133 133 133 133 133 133 12 12 12 12 8 8 8 8 8 8 8 8
8 108 8 13 8 8 8 8 8 8 8 8 8 8 8 8 8 108 108 108 108 90 125 125 125 8 8 8 8 8 8 8 8 8 131 131 131 131 131 8 12 12 12 12 12 12 12 12 12 133 133 133 12 12 12 12 8 8 8 8 8 8 8 8
8 108 8 8 8 8 8 8 8 8 8 8 8 8 8 8 8 108 8 8 8 8 8 8 8 8 8 8 8 8 8 8 8 8 131 8 8 8 131 131 23 132 132 132 132 132 132 132 23 133 133 133 12 12 12 12 8 8 8 8 8 8 8 8
8 108 8 8 109 109 109 109 109 109 109 109 109 109 109 8 8 108 108 90 126 92 131 131 131 131 131 131 131 131 131 131 131 131 131 8 8 8 131 131 90 132 132 132 11 132 132 132 90 133 133 133 11 12 12 12 8 8 8 8 8 8 8 8
8 108 8 8 109 109 109 109 109 109 109 109 109 109 109 8 8 108 8 8 8 8 8 8 8 8 8 8 8 8 8 8 8 8 131 8 8 8 131 131 23 132 132 132 132 132 132 132 23 133 133 133 12 12 12 12 8 8 8 8 8 8 8 8
8 108 8 8 109 109 109 109 109 109 109 109 109 109 109 8 8 108 108 108 108 90 127 127 127 127 127 127 8 8 8 8 8 8 131 131 131 131 131 8 12 12 12 12 12 12 12 12 12 133 133 133 12 12 12 12 8 8 8 8 8 8 8 8
8 108 8 8 109 109 109 8 8 8 8 8 109 109 109 8 8 108 8 8 8 8 8 8 8 8 8 8 8 8 8 8 8 8 8 8 8 8 8 8 8 12 12 133 133 133 133 133 133 133 133 133 12 12 12 12 8 8 8 8 8 8 8 8
8 108 8 8 8 91 8 8 8 8 8 8 8 91 8 8 8 108 108 108 8 8 8 8 8 8 8 8 8 8 8 8 8 8 8 8 8 8 8 8 8 12 12 133 133 15 133 133 133 15 133 133 12 12 12 12 8 8 8 8 8 8 8 8
8 108 8 8 108 108 108 8 8 8 8 8 108 108 108 8 8 108 8 8 8 8 8 8 8 8 8 8 8 8 8 8 8 8 8 8 8 8 8 8 8 12 12 133 15 14 133 133 133 14 15 133 12 12 12 12 8 8 8 8 8 8 8 8
8 108 8 8 108 108 108 8 8 8 8 8 108 108 108 8 8 108 108 108 90 128 128 128 128 128 128 128 128 8 8 8 8 8 8 8 8 8 8 8 8 12 12 133 15 15 15 91 15 15 15 133 12 12 12 12 8 8 8 8 8 8 8 8
8 108 108 108 108 108 108 108 108 108 108 108 108 108 108 108 108 108 8 8 8 8 8 8 8 8 8 8 8 8 8 8 8 8 8 8 8 8 8 8 8 12 12 133 15 143 143 143 15 143 15 133 12 12 12 12 8 8 8 8 8 8 8 8
8 108 108 108 108 108 108 108 108 108 108 108 108 108 108 108 108 108 108 108 8 8 8 8 8 8 8 8 8 8 8 8 8 8 8 8 8 8 8 8 8 12 12 133 15 143 15 15 15 143 15 133 12 12 12 12 8 8 8 8 8 8 8 8
8 108 108 108 108 108 108 108 17 18 17 108 108 108 108 108 108 108 8 8 8 8 8 8 8 8 8 8 8 8 8 8 8 8 8 8 8 8 8 8 8 12 12 133 15 143 143 143 143 143 15 133 12 12 12 12 8 8 8 8 8 8 8 8
8 108 108 108 108 108 108 108 18 17 18 108 108 108 108 108 108 108 108 108 90 129 129 129 129 129 129 129 129 129 8 8 8 8 8 8 8 8 8 8 8 12 12 133 15 15 15 15 15 15 15 133 12 12 12 12 8 8 8 8 8 8 8 8
8 108 108 108 108 108 108 108 17 18 17 108 108 108 108 108 108 108 8 8 8 8 8 8 8 8 8 8 8 8 8 8 8 8 8 8 8 8 8 8 8 12 12 133 133 133 133 133 133 133 133 133 12 12 12 12 8 8 8 8 8 8 8 8
8 108 108 108 108 108 108 108 108 108 108 108 108 108 108 108 108 108 108 108 90 130 130 130 130 130 130 8 8 8 8 8 8 8 8 8 8 8 8 8 8 12 12 12 12 12 12 10 12 12 12 12 12 12 12 12 8 8 8 8 8 8 8 8
8 108 108 108 108 108 108 108 108 108 108 108 108 108 108 108 108 108 8 8 8 8 8 8 8 8 8 8 8 8 8 8 8 8 8 8 8 8 8 8 8 12 12 12 12 12 12 12 12 12 12 12 12 12 12 12 8 8 8 8 8 8 8 8
8 8 8 8 8 8 8 8 8 8 8 8 8 8 8 8 8 8 8 8 8 8 8 8 8 8 8 8 8 8 8 8 8 8 8 8 8 8 8 8 8 8 8 8 8 8 8 8 8 8 8 8 8 8 8 8 8 8 8 8 8 8 8 8
