17 17 17 17 17 38 17 17 17 17 17 17 17 17 17 17 17 17 17 17 17 17 17 17 17 17 17 17 17 17 17 17 17 17 17 17 17 17 17 17 17 17 17 17 17 17 17 17 17 17 17 17 17 17 17 17 17 17 17 17 17 17 17 17
17 141 141 141 141 141 141 141 141 17 17 17 17 17 17 17 17 17 17 20 17 17 17 17 17 17 17 17 17 17 17 17 17 17 17 17 17 17 17 17 17 17 17 17 17 17 17 17 17 17 17 17 17 17 17 17 17 17 17 17 17 17 17 17
17 141 141 141 141 141 141 141 141 141 141 141 141 17 17 17 109 106 109 109 109 106 109 17 17 17 17 17 17 17 17 17 17 17 17 17 17 17 17 27 27 27 27 27 27 27 27 27 27 17 17 17 17 17 17 17 17 17 17 17 17 17 17 17
17 141 141 141 141 141 141 141 141 17 17 38 17 17 38 109 109 17 17 109 17 17 109 109 17 17 17 17 17 17 17 17 17 17 17 17 17 17 17 27 27 27 27 27 6 27 27 27 27 17 17 17 17 17 17 17 17 17 17 17 17 17 17 17
38 141 141 141 141 17 17 91 17 17 17 17 17 17 17 109 17 17 17 17 17 17 17 109 17 17 17 17 17 17 17 17 17 17 17 27 27 27 27 27 27 1 6 27 122 1 6 27 27 17 17 17 17 17 17 17 17 17 17 17 17 17 17 17
17 141 141 141 141 17 38 109 17 17 17 17 109 109 20 109 17 38 17 20 17 17 17 109 20 17 17 17 17 17 17 17 17 17 17 27 122 122 122 27 27 122 122 122 122 122 122 122 1 17 17 17 17 17 17 17 17 17 17 17 17 17 17 17
17 141 141 141 141 17 17 109 17 109 109 20 109 109 17 109 17 109 109 109 109 109 17 109 17 17 17 17 17 17 17 17 17 17 17 27 122 122 122 27 2 122 122 122 122 122 122 122 27 17 17 17 17 17 17 17 17 17 17 17 17 17 17 17
17 141 141 141 141 141 90 109 109 109 17 17 109 109 17 109 109 109 109 109 109 109 109 109 38 17 17 17 17 17 17 17 17 17 17 27 122 122 122 122 1 122 122 122 12 122 122 122 2 17 17 17 17 17 17 17 17 17 17 17 17 17 17 17
17 17 17 17 38 17 17 17 17 17 38 17 17 17 17 17 17 109 109 109 109 109 17 17 17 17 17 17 17 17 17 17 17 17 17 27 27 27 122 122 27 122 12 122 11 122 12 122 27 17 17 17 17 17 17 17 17 17 17 17 17 17 17 17
17 17 17 17 17 17 17 17 109 109 109 109 109 17 17 17 17 17 109 109 109 17 17 17 17 17 17 17 17 20 17 20 17 17 17 27 27 27 27 27 1 122 11 122 12 122 11 122 27 17 17 17 17 17 17 17 17 17 17 17 17 17 17 17
17 17 17 17 17 17 17 17 17 17 17 17 109 17 17 17 17 17 17 109 17 17 17 17 17 17 17 114 114 114 114 114 114 114 17 17 17 17 17 27 2 122 12 122 122 122 12 122 1 17 17 17 17 17 17 17 17 17 17 17 17 17 17 17
17 17 17 17 17 17 17 17 17 17 17 17 17 17 17 17 17 17 17 109 17 17 17 17 17 17 17 114 114 114 114 114 114 114 17 17 17 17 17 27 1 122 122 122 122 122 122 122 2 17 17 17 17 17 17 17 17 17 17 17 17 17 17 17
17 17 17 17 17 17 17 17 17 17 17 17 17 17 38 17 17 17 38 109 17 17 17 17 17 17 20 114 114 114 114 114 114 114 20 17 17 17 17 27 27 122 122 122 122 122 122 122 1 17 17 17 17 17 17 17 17 17 17 17 17 17 17 17
17 110 110 110 110 110 17 17 17 109 109 109 109 109 109 109 109 17 17 109 17 17 17 17 17 17 17 114 114 114 114 114 114 114 17 17 17 17 17 27 27 27 122 122 122 122 122 27 27 17 17 17 17 17 17 17 17 17 17 17 17 17 17 17
17 110 17 17 17 110 17 17 17 109 17 17 17 17 17 17 109 17 17 109 17 17 17 17 17 17 20 114 114 114 114 114 114 114 20 17 17 17 17 27 27 27 2 122 122 122 1 27 27 17 17 17 17 17 17 17 17 17 17 17 17 17 17 17
17 110 17 17 17 110 17 17 38 109 17 17 17 17 17 38 109 17 17 109 17 17 17 17 17 17 17 114 114 114 114 114 114 114 17 17 17 17 17 27 27 27 27 1 122 2 27 27 27 27 27 27 27 27 27 27 27 27 27 27 27 27 27 27
17 110 17 17 17 110 17 17 17 109 109 109 109 109 17 17 109 17 17 109 17 17 17 17 17 17 17 114 114 114 114 114 114 114 17 17 17 17 17 27 27 27 27 27 95 27 27 27 27 27 27 27 27 27 27 2 6 1 27 1 27 27 27 27
17 110 110 110 110 110 17 17 17 17 17 17 17 109 17 17 109 109 109 109 17 17 17 17 17 17 17 17 17 91 18 91 17 17 17 17 17 17 17 27 27 27 2 27 121 27 1 27 27 27 27 27 27 21 3 124 124 124 4 119 119 2 27 27
17 17 17 110 17 17 17 17 17 17 17 17 38 109 17 17 17 17 17 17 17 17 17 17 17 17 17 17 17 108 108 108 17 17 17 17 17 17 17 27 27 27 121 121 121 121 121 2 27 27 27 27 21 124 100 124 124 124 90 119 119 3 27 27
17 17 17 110 17 17 17 17 17 17 17 17 17 109 17 17 17 17 17 17 17 17 17 17 17 17 17 17 17 108 108 108 17 17 17 27 27 27 27 27 27 2 121 27 27 1 121 1 27 27 27 27 27 21 3 124 124 124 4 119 119 27 27 27
17 17 17 110 110 110 17 17 17 17 17 17 17 91 17 38 17 17 17 112 112 112 17 17 17 17 17 17 20 108 108 108 20 17 17 27 27 1 4 2 27 27 121 121 27 1 121 2 27 27 27 27 27 27 27 1 6 2 2 119 119 1 27 27
17 17 17 17 17 110 17 17 17 17 108 108 108 108 108 108 108 108 17 112 112 112 17 17 17 17 17 17 17 108 108 108 17 17 17 27 27 113 113 113 1 27 27 2 1 121 121 27 27 4 2 1 4 27 27 27 27 27 1 119 119 27 27 27
17 110 110 110 110 110 17 17 17 38 108 108 108 108 108 108 108 108 90 112 112 112 17 17 17 17 17 17 17 108 108 108 17 27 27 27 1 113 113 113 113 90 121 121 121 121 2 27 119 119 119 119 119 119 3 27 27 27 119 119 119 119 2 27
17 110 17 17 17 17 17 17 17 17 108 108 108 108 108 108 108 108 17 17 17 17 17 17 17 17 17 17 108 108 108 108 17 27 1 3 2 113 3 113 2 27 1 27 1 2 27 2 119 1 27 2 27 119 27 1 1 119 119 119 119 119 119 27
17 110 17 17 17 17 17 17 17 17 108 108 108 17 17 108 108 108 108 108 108 108 108 18 108 108 108 108 108 108 108 108 108 6 113 113 113 113 113 113 113 90 119 119 119 119 119 119 119 27 119 106 119 119 119 119 94 119 119 119 119 119 119 6
17 110 110 110 110 110 110 110 110 90 108 108 108 20 13 108 108 108 108 108 108 108 108 92 108 108 108 108 108 108 108 108 108 90 113 113 113 113 113 113 27 27 1 27 1 2 27 27 119 2 27 1 27 119 2 1 27 119 119 119 119 119 119 27
17 110 17 17 17 17 17 17 17 17 108 108 108 17 17 108 108 108 108 108 108 108 108 18 108 108 108 108 108 108 108 108 108 6 113 113 113 113 113 113 113 90 120 120 120 120 120 27 119 119 119 119 119 119 3 27 27 2 119 119 119 119 1 27
17 110 17 17 110 110 110 17 17 17 108 108 108 108 108 108 108 108 17 17 38 17 17 17 17 17 17 17 108 108 108 108 17 27 2 3 27 113 3 113 2 27 27 2 1 27 120 1 27 4 1 1 4 1 27 27 27 27 27 1 2 27 27 27
17 110 110 110 110 110 110 17 17 38 108 108 108 108 108 108 108 108 90 112 112 112 17 116 116 116 116 17 17 108 108 108 17 27 27 27 2 113 113 113 113 90 120 120 120 120 120 2 27 27 27 27 27 27 27 27 27 27 27 27 27 27 27 27
17 17 17 17 110 110 110 17 17 17 108 108 108 108 108 108 108 108 17 112 112 112 17 116 17 17 116 116 17 108 108 108 17 17 17 27 27 113 113 113 27 27 27 2 120 15 120 27 27 27 27 27 27 27 27 27 27 27 27 27 27 27 27 27
17 17 17 17 17 17 17 17 17 17 17 17 17 91 17 17 38 17 17 112 112 112 17 116 17 17 17 116 17 108 108 108 17 17 17 27 27 27 4 2 27 27 27 1 120 120 120 1 27 27 27 27 27 27 27 27 27 27 27 27 27 27 27 27
17 17 17 17 17 17 17 17 17 17 17 17 111 111 111 17 17 17 17 17 17 17 17 116 17 116 17 116 17 108 108 108 17 17 17 27 27 27 27 27 27 27 27 27 27 2 27 27 27 27 27 27 27 27 27 27 27 27 27 27 27 27 27 27
17 17 17 17 17 17 17 17 17 17 17 17 111 111 111 17 17 17 17 17 17 17 17 116 17 116 116 116 17 108 108 108 17 17 17 17 17 17 17 17 20 17 17 17 17 17 17 17 17 17 17 17 17 17 17 17 17 17 17 17 17 17 17 17
17 17 17 17 17 17 17 17 17 17 17 17 17 111 17 17 17 17 17 116 116 116 17 116 17 17 17 17 17 18 91 18 17 17 17 17 17 17 17 118 118 118 17 17 17 17 17 17 17 17 17 17 17 17 17 17 17 17 17 17 17 17 17 17
17 17 17 17 17 17 17 17 17 17 17 17 17 111 17 17 17 17 17 116 17 116 17 116 17 115 115 115 115 115 115 115 115 115 115 115 17 17 118 118 118 118 118 17 17 17 17 17 17 17 17 17 17 17 17 17 17 17 17 17 17 17 17 17
17 17 17 17 17 17 17 17 17 111 111 17 17 111 17 17 111 111 17 116 17 116 17 116 90 115 115 115 115 115 115 115 115 115 115 115 90 118 118 118 15 118 118 118 20 17 17 17 17 17 17 17 17 17 17 17 17 17 17 17 17 17 17 17
17 17 17 17 17 17 17 17 17 111 111 111 111 111 111 111 111 111 17 116 17 17 17 116 17 115 115 115 12 11 12 11 12 115 115 115 17 17 118 118 118 118 118 17 17 17 17 17 17 17 17 17 17 17 17 17 17 17 17 17 17 17 17 17
17 17 17 17 17 17 17 17 17 111 111 17 17 17 17 17 111 111 17 116 116 116 116 116 17 17 115 115 115 12 12 12 115 115 115 17 17 17 17 118 118 118 17 17 17 17 17 17 17 17 17 17 17 17 17 17 17 17 17 17 17 17 17 17
17 17 17 17 17 17 17 17 17 17 17 17 17 17 17 17 17 17 17 17 17 17 17 17 17 17 17 115 115 115 12 115 115 115 17 17 17 17 17 17 20 17 17 17 17 17 17 17 17 17 17 17 17 17 17 17 17 17 17 17 17 17 17 17
17 17 17 17 17 17 17 17 17 17 17 17 17 17 17 17 17 17 17 17 17 17 17 17 17 17 17 17 115 115 115 115 115 17 17 17 17 17 17 17 17 17 17 17 17 17 17 17 17 17 17 17 17 17 17 17 17 17 17 17 17 17 17 17
17 17 17 17 17 17 17 17 17 17 17 17 17 17 17 17 17 17 17 17 17 17 17 17 17 17 17 17 17 115 115 115 17 17 17 17 17 17 17 17 17 17 17 17 17 17 17 17 17 17 17 17 17 17 17 17 17 17 17 17 17 17 17 17
17 17 17 17 17 17 17 17 17 17 17 17 17 17 17 17 17 17 17 17 17 17 17 17 17 17 17 17 17 17 91 17 17 17 17 17 17 17 17 17 17 17 17 17 17 17 17 17 17 17 17 17 17 17 17 17 17 17 17 17 17 17 17 17
17 17 17 17 17 17 17 17 17 17 17 17 17 17 17 17 17 17 17 17 17 17 17 17 17 17 17 17 117 117 117 117 117 17 17 17 17 17 17 17 17 17 17 17 17 17 17 17 17 17 17 17 17 17 17 17 17 17 17 17 17 17 17 17
17 17 17 17 17 17 17 17 17 17 17 17 17 17 17 17 17 17 17 17 17 17 17 17 17 17 17 17 117 12 11 12 117 17 17 17 17 17 17 17 17 17 17 17 17 17 17 17 17 17 17 17 17 17 17 17 17 17 17 17 17 17 17 17
17 17 17 17 17 17 17 17 17 17 17 17 17 17 17 17 17 17 17 17 17 17 17 17 17 17 17 17 117 117 117 117 117 17 17 17 17 17 17 17 17 17 17 17 17 17 17 17 17 17 17 17 17 17 17 17 17 17 17 17 17 17 17 17
17 17 17 17 17 17 17 17 17 17 17 17 17 17 17 17 17 17 17 17 17 17 17 17 17 17 17 17 17 17 117 17 17 17 17 17 17 17 17 17 17 17 17 17 17 17 17 17 17 17 17 17 17 17 17 17 17 17 17 17 17 17 17 17
17 17 17 17 17 17 17 17 17 17 17 17 17 17 17 17 17 17 17 17 17 17 117 117 117 117 117 17 117 117 117 117 117 17 117 117 117 117 117 17 17 17 17 17 17 17 17 17 17 17 17 17 17 17 17 17 17 17 17 17 17 17 17 17
17 17 17 17 17 17 17 17 17 17 17 17 17 17 17 17 17 17 17 17 17 17 117 12 11 12 117 117 117 12 10 12 117 117 117 12 11 12 117 17 17 17 17 17 17 17 17 17 17 17 17 17 17 17 17 17 17 17 17 17 17 17 17 17
17 17 17 17 17 17 17 17 17 17 17 17 17 17 17 17 17 17 17 17 17 17 117 117 117 117 117 17 117 117 117 117 117 17 117 117 117 117 117 17 17 17 17 17 17 17 17 17 17 17 17 17 17 17 17 17 17 17 17 17 17 17 17 17
17 17 17 17 17 17 17 17 17 17 17 17 17 17 17 17 17 17 17 17 17 17 17 17 17 17 17 17 17 17 117 17 17 17 17 17 17 17 17 17 17 17 17 17 17 17 17 17 17 17 17 17 17 17 17 17 17 17 17 17 17 17 17 17
17 17 17 17 17 17 17 17 17 17 17 17 17 17 17 17 17 17 17 17 17 17 17 17 17 17 17 17 117 117 117 117 117 17 17 17 17 17 17 17 17 17 17 17 17 17 17 17 17 17 17 17 17 17 17 17 17 17 17 17 17 17 17 17
17 17 17 17 17 17 17 17 17 17 17 17 17 17 17 17 17 17 17 17 17 17 17 17 17 17 17 17 117 12 11 12 117 17 17 17 17 17 17 17 17 17 17 17 17 17 17 17 17 17 17 17 17 17 17 17 17 17 17 17 17 17 17 17
17 17 17 17 17 17 17 17 17 17 17 17 17 17 17 17 17 17 17 17 17 17 17 17 17 17 17 17 117 117 117 117 117 17 17 17 17 17 17 17 17 17 17 17 17 17 17 17 17 17 17 17 17 17 17 17 17 17 17 17 17 17 17 17
17 17 17 17 17 17 17 17 17 17 17 17 17 17 17 17 17 17 17 17 17 17 17 17 17 17 17 17 17 17 17 17 17 17 17 17 17 17 17 17 17 17 17 17 17 17 17 17 17 17 17 17 17 17 17 17 17 17 17 17 17 17 17 17
17 17 17 17 17 17 17 17 17 17 17 17 17 17 17 17 17 17 17 17 17 17 17 17 17 17 17 17 17 17 17 17 17 17 17 17 17 17 17 17 17 17 17 17 17 17 17 17 17 17 17 17 17 17 17 17 17 17 17 17 17 17 17 17
17 17 17 17 17 17 17 17 17 17 17 17 17 17 17 17 17 17 17 17 17 17 17 17 17 17 17 17 17 17 17 17 17 17 17 17 17 17 17 17 17 17 17 17 17 17 17 17 17 17 17 17 17 17 17 17 17 17 17 17 17 17 17 17
17 17 17 17 17 17 17 17 17 17 17 17 17 17 17 17 17 17 17 17 17 17 17 17 17 17 17 17 17 17 17 17 17 17 17 17 17 17 17 17 17 17 17 17 17 17 17 17 17 17 17 17 17 17 17 17 17 17 17 17 17 17 17 17
17 17 17 17 17 17 17 17 17 17 17 17 17 17 17 17 17 17 17 17 17 17 17 17 17 17 17 17 17 17 17 17 17 17 17 17 17 17 17 17 17 17 17 17 17 17 17 17 17 17 17 17 17 17 17 17 17 17 17 17 17 17 17 17
17 17 17 17 17 17 17 17 17 17 17 17 17 17 17 17 17 17 17 17 17 17 17 17 17 17 17 17 17 17 17 17 17 17 17 17 17 17 17 17 17 17 17 17 17 17 17 17 17 17 17 17 17 17 17 17 17 17 17 17 17 17 17 17
17 17 17 17 17 17 17 17 17 17 17 17 17 17 17 17 17 17 17 17 17 17 17 17 17 17 17 17 17 17 17 17 17 17 17 17 17 17 17 17 17 17 17 17 17 17 17 17 17 17 17 17 17 17 17 17 17 17 17 17 17 17 17 17
17 17 17 17 17 17 17 17 17 17 17 17 17 17 17 17 17 17 17 17 17 17 17 17 17 17 17 17 17 17 17 17 17 17 17 17 17 17 17 17 17 17 17 17 17 17 17 17 17 17 17 17 17 17 17 17 17 17 17 17 17 17 17 17
17 17 17 17 17 17 17 17 17 17 17 17 17 17 17 17 17 17 17 17 17 17 17 17 17 17 17 17 17 17 17 17 17 17 17 17 17 17 17 17 17 17 17 17 17 17 17 17 17 17 17 17 17 17 17 17 17 17 17 17 17 17 17 17
17 17 17 17 17 17 17 17 17 17 17 17 17 17 17 17 17 17 17 17 17 17 17 17 17 17 17 17 17 17 17 17 17 17 17 17 17 17 17 17 17 17 17 17 17 17 17 17 17 17 17 17 17 17 17 17 17 17 17 17 17 17 17 17
17 17 17 17 17 17 17 17 17 17 17 17 17 17 17 17 17 17 17 17 17 17 17 17 17 17 17 17 17 17 17 17 17 17 17 17 17 17 17 17 17 17 17 17 17 17 17 17 17 17 17 17 17 17 17 17 17 17 17 17 17 17 17 17
