26 26 26 26 26 26 26 26 26 26 26 26 26 26 26 26 26 26 26 26 26 26 26 26 26 26 26 26 26 26 26 26 24 26 26 24 26 26 26 26 26 26 26 26 26 26 17 17 17 17 17 17 17 17 17 17 17 17 17 17 17 17 17 17
26 26 109 109 109 109 26 26 109 109 109 26 26 109 109 109 109 26 109 109 109 26 26 26 26 26 24 26 24 26 26 115 115 115 115 115 115 26 26 24 26 26 26 26 26 26 17 17 17 17 17 17 17 134 17 134 17 134 17 134 17 17 17 17
26 109 109 26 26 109 26 109 109 26 109 26 109 109 26 26 109 26 109 26 109 109 26 26 26 115 115 115 115 115 115 115 115 24 115 115 115 115 115 115 115 26 26 26 26 26 17 17 17 17 133 17 17 134 134 134 134 134 134 134 17 17 17 17
24 109 26 26 26 109 109 109 26 26 109 109 109 26 26 26 109 109 109 26 26 109 109 26 115 115 115 26 115 115 115 115 115 24 115 115 24 115 26 115 115 115 115 26 26 26 17 17 17 17 133 133 17 17 134 134 134 134 134 17 17 15 17 17
26 109 26 26 109 109 109 26 26 109 109 26 109 26 109 109 109 109 26 26 26 109 26 24 115 115 115 115 115 24 115 115 115 115 115 115 115 115 115 115 24 115 115 115 26 26 17 17 133 17 133 133 133 17 17 134 134 134 17 17 17 135 17 17
26 109 109 109 109 26 109 109 109 109 26 26 109 109 109 26 26 109 109 109 109 109 26 26 115 115 115 24 115 115 115 26 115 115 115 115 115 24 115 115 115 115 115 115 24 26 17 17 133 133 133 133 133 17 20 134 134 134 20 17 135 135 135 17
26 26 91 26 24 26 1 1 26 26 2 1 26 24 26 1 2 26 26 26 26 26 26 26 26 115 115 115 115 115 115 115 115 24 24 115 115 115 115 115 24 24 115 115 26 26 17 17 17 133 133 133 17 17 17 134 134 134 17 17 17 135 17 17
26 108 108 108 108 108 108 108 108 108 108 108 108 108 108 108 108 108 24 26 26 26 26 26 26 26 115 115 26 115 115 115 115 115 115 115 115 115 115 115 115 115 115 115 26 26 17 17 133 133 133 133 133 17 134 134 134 134 134 17 135 135 135 17
24 108 108 108 108 108 108 108 108 108 108 108 108 108 108 108 108 108 26 26 26 26 26 26 26 24 115 115 115 115 115 24 115 115 24 115 115 24 115 115 115 115 115 26 26 26 17 17 17 17 95 17 17 17 17 17 95 17 17 17 17 95 17 17
26 26 24 26 26 24 26 108 108 108 108 108 108 108 108 108 108 108 108 26 26 26 26 26 26 26 26 115 115 115 115 115 115 115 115 115 115 115 115 24 115 115 26 26 26 26 17 17 113 113 113 113 113 17 113 113 113 113 113 17 113 113 113 17
26 26 26 26 26 26 13 108 108 108 108 108 108 108 108 108 108 108 108 108 108 108 26 26 26 26 26 26 115 115 115 115 115 115 115 24 115 115 115 115 115 115 26 26 26 26 17 20 113 106 113 106 113 113 113 106 113 106 113 20 113 113 113 20
1 26 26 24 26 1 26 108 108 108 108 108 108 108 108 108 108 108 108 26 26 26 26 26 26 26 26 26 26 26 24 26 26 115 115 115 115 115 115 26 26 24 26 26 26 26 17 17 113 113 113 113 113 17 113 113 113 113 113 17 113 106 113 17
1 108 108 108 108 108 108 108 108 108 108 108 108 108 108 108 108 108 26 26 26 26 26 26 26 26 26 26 26 26 26 26 26 26 26 26 115 26 26 3 26 17 17 17 20 17 17 17 17 17 113 17 17 17 17 17 113 17 17 17 17 113 17 17
26 108 108 108 108 108 108 108 108 108 108 108 108 108 108 108 108 108 24 26 26 26 26 26 26 26 26 26 26 26 26 26 26 26 26 26 93 26 141 141 141 17 113 113 113 113 113 17 113 113 113 113 113 17 113 113 113 106 113 17 113 113 113 17
26 1 91 26 1 26 24 26 26 2 1 26 1 2 26 24 26 26 26 112 112 112 112 112 26 26 26 26 26 26 26 26 26 26 112 26 112 24 141 141 141 90 113 113 113 113 113 113 113 113 113 113 113 113 113 113 113 113 113 113 113 113 113 20
2 110 110 110 26 106 110 110 26 106 110 110 1 26 26 26 26 26 26 112 26 26 26 112 26 26 26 1 6 2 26 26 26 26 112 26 112 26 141 141 141 17 113 113 113 113 113 17 113 113 106 113 113 17 113 113 113 113 113 17 113 113 113 17
1 110 11 110 26 110 11 110 26 110 11 110 26 26 26 26 26 26 112 112 112 26 26 112 112 112 112 112 112 112 112 112 112 112 26 112 112 26 26 141 26 17 17 17 20 17 17 17 17 17 20 17 17 17 17 17 17 20 17 17 17 113 17 17
26 110 110 110 110 110 110 110 110 110 110 110 110 106 24 26 26 112 112 112 112 112 26 112 12 112 17 112 15 112 17 112 12 112 112 26 26 26 141 141 141 26 17 17 17 17 17 17 17 17 17 17 17 17 17 17 113 113 113 17 113 113 113 17
26 1 26 110 11 110 24 110 11 110 1 110 11 110 90 112 112 112 112 112 112 112 112 112 112 112 112 112 112 112 112 112 112 112 112 92 141 141 141 141 141 3 8 9 8 8 8 9 8 8 8 8 8 8 8 20 106 113 113 113 113 113 113 20
26 26 24 110 110 106 26 110 110 110 26 110 110 106 1 26 26 112 112 112 112 112 26 112 12 112 17 112 15 112 17 112 12 112 112 26 24 26 141 141 141 26 8 8 114 114 114 114 114 9 8 8 8 8 8 17 113 106 113 17 113 113 113 17
26 26 26 26 1 1 26 26 24 26 26 26 91 26 26 26 26 26 112 112 112 26 26 112 112 112 112 112 112 112 112 112 112 112 26 26 26 26 26 26 26 26 8 9 114 8 9 8 114 8 8 8 8 8 8 17 17 113 17 17 17 17 17 17
26 26 26 26 26 26 26 26 26 26 26 111 111 111 26 26 26 26 26 112 26 26 26 112 26 26 26 27 6 2 26 26 26 26 112 92 142 8 8 8 9 8 9 8 114 8 8 9 114 8 9 8 9 8 8 17 113 113 113 17 113 113 113 17
26 26 26 26 26 26 26 26 26 26 26 111 111 111 26 26 26 26 26 112 112 112 112 112 26 26 26 26 26 26 26 26 26 112 112 9 91 8 8 9 114 114 114 114 114 9 9 8 114 114 114 114 114 8 8 20 106 113 113 106 113 113 106 20
26 26 26 26 26 26 26 26 26 26 26 26 111 111 111 26 26 26 26 26 26 26 26 26 26 26 26 26 26 26 26 26 8 112 112 9 114 114 114 114 114 8 9 8 114 114 114 114 114 8 9 8 106 8 8 17 113 113 113 17 113 113 113 17
26 26 26 26 26 26 26 26 26 26 26 26 111 111 111 26 26 26 26 26 26 26 26 26 26 26 26 26 26 26 26 26 8 8 8 8 114 9 8 9 114 8 8 9 114 114 114 114 114 9 9 9 114 9 8 17 17 20 17 17 17 106 17 17
26 26 26 26 26 26 26 26 26 26 26 26 26 111 111 111 26 26 26 26 26 26 26 26 26 26 26 26 26 26 26 26 8 8 9 9 114 8 8 9 114 9 8 9 114 8 8 8 114 8 8 8 114 9 8 8 29 29 29 29 113 113 113 17
26 26 26 26 26 26 26 26 26 26 26 26 26 111 111 111 26 26 26 26 26 26 26 26 26 26 26 26 26 26 26 26 8 8 8 8 114 8 9 8 114 9 8 8 114 8 137 90 114 114 114 114 114 114 114 8 29 116 90 113 113 113 113 20
26 26 26 26 26 26 26 26 111 111 111 111 111 111 111 111 111 111 111 111 111 26 26 26 26 26 26 26 26 26 26 26 8 9 114 114 114 114 114 114 114 8 8 9 114 8 137 8 114 114 8 8 9 9 114 9 29 116 29 29 113 113 113 17
26 26 26 26 26 26 111 111 111 111 111 111 111 111 111 111 111 111 111 111 111 111 111 26 26 26 26 26 26 26 26 26 8 8 114 8 9 9 8 114 114 114 106 114 114 8 8 8 114 114 8 9 8 8 114 9 29 116 116 30 17 20 17 17
26 26 26 26 26 111 111 111 111 111 111 111 1 2 2 27 1 111 111 111 111 111 111 111 26 26 26 26 26 26 26 26 8 9 114 9 139 139 90 114 8 8 9 8 114 114 106 114 114 114 9 9 8 8 114 8 29 116 116 29 29 29 29 29
26 26 26 26 111 111 111 111 111 2 1 1 4 2 6 27 4 1 2 1 111 111 111 111 111 26 26 26 26 26 26 26 8 8 114 8 8 9 8 114 9 8 8 9 114 114 8 9 8 114 114 114 114 114 114 9 29 116 116 116 30 29 29 29
26 26 26 111 111 111 111 111 1 1 2 1 111 111 111 111 111 2 1 1 2 111 111 111 111 111 26 26 26 26 26 26 8 9 114 114 114 114 114 114 8 9 8 8 114 114 9 143 9 114 8 9 9 114 9 8 29 116 116 116 29 29 29 29
26 26 26 111 111 111 111 2 1 1 111 111 111 111 111 111 111 111 111 1 1 1 111 111 111 111 26 26 26 26 26 26 8 8 8 8 114 114 114 114 114 114 114 114 114 114 9 143 9 114 9 8 8 114 8 8 29 116 116 116 116 29 29 29
26 26 111 111 111 111 1 1 1 106 111 111 111 111 111 111 111 111 111 106 1 2 1 111 111 111 111 26 26 26 26 26 8 8 8 9 114 8 9 9 114 114 114 114 114 114 8 143 9 114 8 9 8 114 8 8 29 116 116 116 116 29 29 29
26 26 111 111 111 1 1 1 27 106 111 111 111 111 111 111 111 111 111 106 1 2 1 2 111 111 111 26 26 26 26 26 8 8 8 8 106 9 8 9 114 114 8 9 9 114 8 143 9 114 114 114 114 114 9 8 29 29 116 116 116 116 29 29
26 26 111 111 111 2 1 1 106 111 111 111 111 111 111 111 111 111 111 111 106 1 1 27 111 111 111 26 26 26 26 26 8 8 8 9 114 8 9 8 114 114 9 8 8 114 8 91 9 114 8 8 8 9 8 8 29 29 116 116 116 116 30 29
26 26 111 111 111 1 1 3 106 111 111 111 111 111 111 111 111 111 111 111 106 3 1 1 111 111 111 26 26 26 26 26 8 8 8 8 106 114 114 114 114 114 8 8 9 114 114 114 114 114 9 8 8 8 8 8 29 29 29 116 116 116 29 29
26 26 111 111 111 1 1 1 106 111 111 111 111 111 111 111 111 111 111 111 106 27 1 2 111 111 111 26 26 26 26 26 8 8 8 8 8 9 8 9 8 114 8 9 8 114 8 9 9 8 8 8 8 8 8 8 29 29 29 116 116 116 29 29
26 26 111 111 111 111 1 1 1 111 111 111 111 111 111 111 111 111 111 111 1 1 27 111 111 111 111 26 26 26 26 26 8 8 8 8 8 8 8 8 8 106 114 114 114 114 8 8 8 8 8 8 8 8 8 8 29 29 116 116 29 116 30 29
26 26 26 111 111 111 111 2 27 106 111 111 111 111 111 111 111 111 111 106 2 2 111 111 111 111 26 26 26 26 26 26 8 8 8 8 8 8 8 8 8 8 9 114 8 9 8 8 8 8 8 8 8 8 8 8 29 29 116 116 29 116 29 29
26 26 26 111 111 111 111 111 1 1 106 111 111 111 111 111 111 111 106 1 1 111 111 111 111 111 26 26 26 26 26 26 8 8 8 8 8 8 8 8 8 8 8 91 8 8 8 8 8 8 8 8 8 8 8 8 29 29 116 29 30 116 29 29
26 26 26 26 111 111 111 111 111 2 27 1 111 111 111 111 111 27 2 1 111 111 111 111 111 26 26 26 26 29 29 29 29 29 29 29 29 29 29 29 29 29 29 117 29 30 29 29 30 29 29 29 30 29 29 29 29 29 91 29 29 91 29 29
26 26 26 26 26 111 111 111 111 111 111 111 111 111 111 111 111 111 111 111 111 111 111 111 26 26 26 26 26 29 29 29 29 29 29 29 29 29 29 29 29 29 29 117 117 117 117 117 117 117 117 117 117 117 117 117 117 117 117 117 117 117 30 29
26 26 26 26 26 26 111 111 111 111 111 111 111 111 111 111 111 111 111 111 111 111 111 26 26 26 26 26 26 29 29 29 21 21 21 29 29 118 106 118 29 29 29 117 29 29 117 29 29 117 29 29 117 29 29 117 29 29 117 29 29 117 29 29
26 26 26 26 26 26 26 111 111 111 111 111 111 111 111 111 111 111 111 111 111 111 26 26 26 26 26 26 26 29 29 15 121 121 121 29 118 106 118 106 118 29 29 117 29 30 117 29 30 117 29 30 106 29 29 117 29 29 117 30 29 117 29 29
26 26 26 26 26 26 26 26 26 26 26 26 26 26 26 26 26 26 26 26 26 26 26 26 26 26 26 26 26 29 29 21 121 121 121 100 118 118 118 118 106 29 30 117 29 29 106 29 29 106 29 29 117 29 29 117 29 29 117 29 29 117 29 29
26 26 26 26 26 26 26 26 26 26 26 26 26 26 26 26 26 26 26 26 26 26 26 26 26 26 26 26 26 29 29 15 121 121 121 29 118 118 106 118 118 29 29 117 30 29 117 29 29 117 29 29 106 29 29 117 29 30 117 29 29 106 30 29
26 26 26 26 26 26 26 26 26 26 26 26 26 26 26 26 26 26 26 26 26 26 26 26 26 26 26 26 26 29 29 29 21 21 21 29 29 118 106 118 118 29 29 117 29 29 106 29 29 117 30 29 117 30 29 117 29 29 117 29 29 117 29 29
26 26 26 26 26 26 26 26 26 26 26 26 26 26 26 26 26 26 26 26 26 26 26 26 26 26 26 26 26 29 29 29 29 29 29 29 29 29 29 29 95 29 29 117 29 29 117 29 29 117 29 29 106 29 29 117 29 29 117 29 29 106 29 29
26 26 26 26 26 26 26 26 26 26 26 26 26 26 26 26 26 26 26 26 26 26 26 26 26 26 26 26 26 29 29 29 119 119 119 119 119 119 119 29 117 117 117 117 117 117 117 117 117 117 117 117 117 117 117 117 117 117 117 117 117 117 29 29
26 26 26 26 26 26 26 26 26 26 26 26 26 26 26 26 26 26 26 26 26 26 26 26 26 26 26 29 29 29 29 29 119 119 119 119 119 119 119 29 91 29 117 29 29 117 29 29 117 29 29 117 29 29 117 29 29 117 29 29 117 29 29 29
26 26 26 26 26 26 26 26 26 26 26 26 26 26 26 26 26 26 26 26 26 26 26 26 26 26 26 29 29 29 119 119 119 29 29 29 119 29 119 119 119 29 117 29 30 106 29 30 117 30 29 117 30 29 117 29 30 117 30 29 117 29 29 29
26 26 26 26 26 26 26 26 26 26 26 26 26 26 26 26 26 26 26 26 26 26 26 26 26 26 26 29 29 29 119 119 119 29 119 119 119 119 119 119 119 29 117 29 29 117 29 29 117 29 29 106 29 29 117 29 29 117 29 29 106 29 29 29
26 26 26 26 26 26 26 26 26 26 26 26 26 26 26 26 26 26 26 26 26 26 26 26 26 26 26 29 29 29 119 29 119 119 119 29 119 29 29 119 119 29 117 29 29 106 30 29 106 29 29 117 29 29 117 29 29 106 29 29 117 29 29 29
26 26 26 26 26 26 26 26 26 26 26 26 26 26 26 26 26 26 26 26 26 26 26 26 26 26 26 29 29 29 119 29 119 119 119 119 119 119 29 119 119 29 117 29 29 117 29 29 117 29 30 106 29 29 117 29 29 117 29 29 117 30 29 29
26 26 26 26 26 26 26 26 26 26 26 26 26 26 26 26 26 26 26 26 26 26 26 26 26 26 26 29 29 29 119 119 119 29 29 119 119 119 119 119 119 29 117 29 29 117 29 29 117 29 29 117 29 29 117 29 29 106 29 29 106 29 29 29
26 26 26 26 26 26 26 26 26 26 26 26 26 26 26 26 26 26 26 26 26 26 26 26 26 26 26 29 29 29 119 119 119 29 29 119 119 119 29 119 119 29 117 117 117 117 117 117 117 117 117 117 117 117 117 117 117 117 117 117 117 29 29 29
26 26 26 26 26 26 26 26 26 26 26 26 26 26 26 26 26 26 26 26 26 26 26 26 26 26 26 29 29 29 119 119 119 119 119 119 29 119 119 119 119 29 29 29 29 29 29 29 29 29 29 29 29 29 29 29 30 29 30 29 29 29 29 29
26 26 26 26 26 26 26 26 26 26 26 26 26 26 26 26 26 26 26 26 26 26 26 26 26 26 26 29 29 29 119 119 29 29 119 119 29 29 119 29 119 29 29 29 29 29 29 29 29 29 29 29 29 29 29 29 29 29 29 29 29 29 29 29
26 26 26 26 26 26 26 26 26 26 26 26 26 26 26 26 26 26 26 26 26 26 26 26 26 26 26 29 29 29 119 119 119 119 119 119 119 119 119 119 119 29 29 29 29 29 29 29 29 29 29 29 29 29 29 29 29 29 29 29 29 29 29 29
26 26 26 26 26 26 26 26 26 26 26 26 26 26 26 26 26 26 26 26 26 26 26 26 26 26 26 29 29 29 29 29 119 119 29 119 119 119 119 29 29 29 29 29 29 29 29 29 29 29 29 29 29 29 29 29 29 29 29 29 29 29 29 29
26 26 26 26 26 26 26 26 26 26 26 26 26 26 26 26 26 26 26 26 26 26 26 26 26 26 26 29 29 29 29 29 119 119 119 119 119 119 119 29 29 29 29 29 29 29 29 29 29 29 29 29 29 29 29 29 29 29 29 29 29 29 29 29
26 26 26 26 26 26 26 26 26 26 26 26 26 26 26 26 26 26 26 26 26 26 26 26 26 26 26 26 26 26 29 29 29 29 29 29 29 29 29 29 29 26 26 26 26 26 26 26 26 26 26 26 26 26 26 26 26 26 26 26 26 26 26 26
26 26 26 26 26 26 26 26 26 26 26 26 26 26 26 26 26 26 26 26 26 26 26 26 26 26 26 26 26 26 29 29 29 29 29 29 29 29 29 29 29 26 26 26 26 26 26 26 26 26 26 26 26 26 26 26 26 26 26 26 26 26 26 26
