24 24 24 24 24 24 24 24 24 24 24 24 24 24 24 24 24 24 24 24 24 24 24 24 24 24 24 24 24 24 24 24 24 24 24 24 24 24 24 24 24 24 24 24 24 24 24 24 24 24 24 24 24 24 24 24 24 24 24 24 24 24 24 24
24 24 24 24 24 24 24 24 24 24 24 24 24 24 24 24 24 24 24 24 24 24 24 24 24 24 24 24 24 24 24 24 24 24 24 24 24 24 24 24 24 24 24 24 24 24 24 24 24 24 24 24 24 24 24 24 24 24 24 24 24 24 24 24
24 24 24 24 24 24 24 24 24 24 24 24 24 24 24 24 24 24 24 24 24 24 24 24 24 24 24 24 24 24 24 24 24 24 24 24 24 24 24 24 24 24 24 24 24 24 24 24 24 24 24 24 24 24 24 24 24 24 24 24 24 24 24 24
24 24 24 24 24 24 24 24 24 24 24 24 24 24 24 24 24 24 24 24 24 24 24 24 24 24 24 24 24 24 24 24 24 24 24 24 24 24 24 24 24 24 24 24 24 24 24 24 24 24 24 24 24 24 24 24 24 24 24 24 24 24 24 24
24 24 24 24 24 24 24 24 24 24 24 24 24 24 24 24 24 24 24 24 24 24 24 24 24 24 24 24 24 24 24 24 24 24 24 24 24 24 24 24 24 24 24 24 24 24 24 24 24 24 24 24 24 24 24 24 24 24 24 24 24 24 24 24
24 24 24 24 24 24 24 24 24 24 24 24 24 24 24 24 24 24 24 24 24 24 24 24 24 24 24 24 24 24 24 24 24 24 24 24 24 24 24 24 24 24 24 24 24 24 24 24 24 24 24 24 24 24 24 24 24 24 24 24 24 24 24 24
24 24 24 24 24 24 24 24 24 24 24 24 24 24 24 24 24 24 24 24 24 24 24 24 24 24 24 24 24 24 24 24 24 24 24 24 24 24 24 24 24 24 24 24 24 24 24 24 24 24 24 24 24 24 24 24 24 24 24 24 24 24 24 24
24 24 24 24 24 24 24 24 24 24 24 24 24 24 24 24 24 24 24 24 24 24 24 24 24 24 24 24 24 24 24 24 24 24 24 24 24 24 24 24 24 24 24 24 24 24 24 24 24 24 24 24 24 24 24 24 24 24 24 24 24 24 24 24
24 24 24 24 24 24 24 24 24 24 24 24 24 24 24 24 24 24 24 24 24 24 24 24 24 24 24 24 24 24 24 24 24 24 24 24 24 24 24 24 24 24 24 24 24 24 24 24 24 24 24 24 24 24 24 24 24 24 24 24 24 24 24 24
24 24 24 24 24 24 24 24 24 24 24 24 24 24 24 24 24 24 24 24 24 24 24 24 24 24 24 24 24 24 24 24 24 24 24 24 24 24 24 24 24 24 24 24 24 24 24 24 24 24 24 24 24 24 24 24 24 24 24 24 24 24 24 24
24 24 24 24 24 24 24 24 24 24 24 24 24 24 24 24 24 24 24 24 24 24 24 24 24 24 24 24 24 24 24 24 24 24 24 24 24 24 24 24 24 24 24 24 24 24 24 24 24 24 24 24 24 24 24 24 24 24 24 24 24 24 24 24
24 24 24 24 24 24 24 24 24 24 24 24 24 24 24 24 24 24 24 24 24 24 24 24 24 24 24 24 24 24 24 24 24 24 24 24 24 24 24 24 24 24 24 24 24 24 24 24 24 24 24 24 24 24 24 24 24 24 24 24 24 24 24 24
24 24 24 24 24 24 24 24 24 24 24 24 24 24 24 24 24 24 24 24 24 24 24 24 24 24 24 24 24 24 24 24 24 24 24 24 24 24 24 24 24 24 24 24 24 24 24 24 24 24 24 24 24 24 24 24 24 24 24 24 24 24 24 24
24 24 24 24 24 24 24 24 24 24 24 24 24 24 24 24 24 24 24 24 24 24 24 24 24 24 24 24 24 24 24 24 24 24 24 24 24 24 24 24 24 24 24 24 24 24 24 24 24 24 24 24 24 24 24 24 24 24 24 24 24 24 24 24
24 24 24 24 24 24 24 24 24 24 24 24 24 24 24 24 24 24 24 24 24 24 24 24 24 24 24 24 24 24 24 24 24 24 24 24 24 24 24 24 24 24 24 24 24 24 24 24 24 24 24 24 24 24 24 24 24 24 24 24 24 24 24 24
24 24 24 24 24 24 24 24 24 24 24 24 24 24 24 24 24 24 24 24 24 24 24 24 24 24 24 24 24 24 24 24 24 24 24 24 24 24 24 24 24 24 24 24 24 24 24 24 24 24 24 24 24 24 24 24 24 24 24 24 24 24 24 24
24 24 24 24 24 24 24 24 24 24 24 24 24 24 24 24 24 24 24 24 24 24 24 24 24 24 24 24 24 24 24 24 24 24 24 24 24 24 24 24 24 24 24 24 24 24 24 24 24 24 24 24 24 24 24 24 24 24 24 24 24 24 24 24
24 24 24 24 24 24 24 24 24 24 24 24 24 24 24 24 24 24 24 24 24 24 24 24 24 24 24 24 24 24 24 24 24 24 24 24 24 24 24 24 24 24 24 24 24 24 24 24 24 24 24 24 24 24 24 24 24 24 24 24 24 24 24 24
24 24 24 24 24 24 24 24 24 24 24 24 24 24 24 24 24 24 24 24 24 24 24 24 24 24 24 24 24 24 24 24 24 24 24 24 24 24 24 24 24 24 24 24 24 24 24 24 24 24 24 24 24 24 24 24 24 24 24 24 24 24 24 24
24 24 24 24 24 24 24 24 24 21 24 24 24 24 24 24 24 24 24 24 24 24 26 24 24 24 24 24 24 24 24 24 24 24 24 24 26 24 24 24 24 24 24 24 24 24 24 24 24 24 24 24 24 24 24 24 24 24 24 24 24 24 24 24
24 24 24 24 24 24 24 24 21 107 100 116 116 116 116 116 116 24 24 24 24 115 115 115 115 26 24 24 24 24 24 24 24 24 24 114 114 114 114 24 24 24 24 24 24 24 26 24 24 26 24 24 24 24 24 24 24 24 24 24 24 24 24 24
24 24 24 24 24 24 24 24 24 21 24 24 24 24 24 24 116 24 24 24 26 115 115 115 115 26 24 24 26 24 24 24 26 24 24 114 114 114 114 24 24 24 24 24 24 113 113 113 113 113 113 24 24 24 24 24 24 24 24 24 24 24 24 24
24 24 24 24 24 24 24 24 24 24 24 24 24 24 24 24 116 24 24 24 24 115 115 115 115 115 90 109 109 26 24 109 109 90 114 114 114 114 114 24 24 24 24 24 26 113 113 113 113 113 113 26 24 24 24 24 24 24 24 24 24 24 24 24
24 24 24 24 24 24 24 24 24 24 24 24 24 24 24 24 116 24 24 24 26 115 115 115 115 115 24 109 109 109 109 109 109 24 114 114 114 114 114 26 24 24 24 24 24 113 113 113 113 113 113 24 24 24 24 24 24 24 24 24 24 24 24 24
24 24 24 24 24 24 24 24 24 24 24 24 116 116 24 24 116 24 24 24 24 115 115 115 115 115 24 109 109 109 109 109 109 24 114 114 114 114 114 26 24 24 24 24 26 113 113 113 113 113 113 26 24 24 24 24 24 24 24 24 24 24 24 24
24 24 24 24 24 24 24 24 24 24 24 116 116 116 116 24 116 116 24 24 24 115 115 115 115 115 90 109 109 109 109 109 109 90 114 114 114 114 114 24 24 24 24 24 24 113 113 113 113 113 113 24 24 24 24 24 24 24 24 24 24 24 24 24
24 24 24 24 24 24 24 24 24 24 116 116 116 116 116 116 24 24 24 24 26 115 115 115 115 26 24 24 26 109 109 24 24 24 24 114 114 114 114 24 24 24 24 24 24 26 113 113 113 113 26 24 24 24 24 24 24 24 24 24 24 24 24 24
24 24 24 24 24 24 24 24 24 24 24 116 116 116 116 116 116 116 24 24 24 115 115 115 115 24 24 24 24 109 109 24 24 24 24 114 114 114 114 26 24 24 24 24 24 24 113 113 113 113 24 24 24 24 24 24 24 24 24 24 24 24 24 24
24 24 24 24 24 24 24 24 24 24 24 24 116 116 116 116 116 116 24 24 24 24 26 26 26 24 24 24 26 109 109 24 24 24 24 26 1 26 24 24 24 24 24 24 24 24 91 24 24 91 24 24 24 24 24 24 24 24 24 24 24 24 24 24
24 24 24 24 24 24 24 24 24 24 24 24 24 24 24 24 24 26 24 24 26 24 24 24 24 24 24 24 24 109 109 24 24 24 24 24 24 24 24 24 24 24 24 24 24 24 109 109 109 109 24 24 24 24 24 24 24 24 24 24 24 24 24 24
24 24 24 24 24 24 24 24 24 24 24 24 24 24 24 24 116 116 116 116 116 116 24 24 26 26 24 24 109 109 109 109 24 24 24 24 24 26 26 24 26 24 24 24 24 26 109 109 109 109 24 24 24 24 24 24 24 24 24 24 24 24 24 24
24 24 24 24 24 24 24 24 24 24 24 24 24 24 24 26 116 116 116 116 116 116 116 90 109 109 24 109 109 109 109 109 109 24 24 1 109 109 109 109 109 109 24 1 24 24 24 109 109 24 24 24 24 24 24 24 24 24 24 24 24 24 24 24
24 24 24 24 24 24 24 24 24 24 24 24 24 24 24 24 116 116 116 116 116 116 116 24 109 109 109 109 109 109 109 109 109 109 109 109 109 109 1 4 109 109 109 109 109 109 109 109 109 26 24 24 24 26 24 24 24 24 24 24 24 24 24 24
24 24 24 24 24 24 24 24 24 24 24 24 24 24 24 24 116 116 116 116 116 116 116 24 109 109 109 109 109 109 109 109 109 109 109 109 109 109 4 1 109 109 109 109 109 109 109 109 109 26 24 109 109 109 109 26 24 24 24 24 24 24 24 24
24 24 24 24 24 24 24 24 24 24 24 24 24 24 24 26 116 116 116 116 116 116 116 90 109 109 26 109 109 109 109 109 109 24 24 26 109 109 109 109 109 109 2 26 1 2 24 109 109 24 109 109 109 109 109 109 24 26 24 24 24 24 24 24
24 24 24 24 24 24 24 24 24 24 24 24 24 24 24 24 116 116 116 116 116 116 24 24 26 26 24 24 109 109 109 109 24 24 24 24 24 24 24 24 24 24 24 24 24 24 26 109 109 109 109 109 3 1 109 109 109 109 109 24 24 24 24 24
24 24 24 24 24 24 24 24 24 24 24 24 24 24 24 24 26 24 26 24 24 26 24 24 24 24 24 24 26 109 109 24 24 24 24 24 24 24 24 24 24 8 9 8 9 8 24 109 109 109 109 109 2 3 109 109 109 109 109 109 24 24 24 24
24 24 24 24 24 24 24 24 24 24 24 24 24 24 24 24 24 24 24 24 24 24 24 24 24 24 24 24 26 109 109 26 24 24 24 24 24 24 24 24 24 8 112 112 112 8 24 109 109 24 109 109 109 109 109 109 24 109 109 109 24 24 24 24
24 24 24 24 24 24 24 24 24 24 24 24 24 24 24 24 24 24 24 24 24 24 24 24 24 24 24 24 24 109 109 24 24 24 24 24 24 24 24 24 24 9 112 112 112 9 109 109 109 24 26 109 109 109 109 24 24 24 109 109 24 24 24 24
24 24 24 24 24 24 24 24 24 24 24 24 24 24 24 24 24 24 24 24 24 24 24 24 24 24 24 26 109 109 109 109 24 26 24 24 24 24 24 24 24 9 112 112 112 90 109 109 109 26 24 24 24 24 24 24 26 109 109 109 24 24 24 24
24 24 24 24 24 24 24 24 24 24 24 24 24 24 24 24 24 24 24 24 24 24 24 24 26 109 109 109 109 109 109 109 109 109 109 24 24 24 24 24 24 9 112 112 112 8 109 109 109 24 24 24 24 24 24 24 109 109 109 24 24 24 24 24
24 24 24 24 24 24 24 24 24 24 24 24 24 24 24 24 24 24 24 24 24 24 24 109 109 109 109 109 109 109 109 109 109 109 109 109 26 24 24 24 24 8 112 112 112 9 24 26 24 26 24 24 24 24 24 24 109 109 24 26 24 24 24 24
24 24 24 24 24 24 24 24 24 24 24 24 24 24 108 26 24 24 24 24 24 26 109 109 109 109 109 109 109 109 109 109 109 109 109 109 109 24 24 24 24 8 8 9 9 8 24 24 26 24 24 24 24 24 24 24 109 109 26 26 24 24 24 24
16 108 108 108 108 108 108 24 24 24 24 24 24 108 108 108 2 24 24 24 24 109 109 109 109 109 109 109 109 109 109 109 109 109 109 109 109 109 24 24 24 26 24 26 24 24 24 111 111 111 111 24 24 24 24 24 109 109 109 24 24 24 24 24
16 108 108 108 108 108 108 108 24 26 2 26 24 108 108 108 26 24 24 24 109 109 109 109 109 109 109 109 17 18 17 109 109 109 109 109 109 109 109 26 141 141 141 141 24 24 26 111 111 111 111 111 24 24 24 24 24 109 109 109 24 24 24 24
16 108 108 108 108 108 108 108 108 108 108 108 108 108 108 108 108 90 109 109 109 109 109 109 109 109 109 109 18 17 18 109 109 109 109 109 109 109 109 90 141 141 141 141 26 24 24 111 111 111 111 111 24 24 24 24 26 26 109 109 24 24 24 24
16 108 108 108 108 108 108 108 24 26 1 26 24 108 108 108 24 24 24 24 109 109 109 109 109 109 109 109 17 18 17 109 109 109 109 109 109 109 109 26 141 141 141 141 24 24 24 26 24 24 24 24 26 24 24 24 24 24 109 109 24 24 24 24
16 108 108 108 108 108 108 24 24 24 24 24 24 108 108 108 1 24 24 24 24 109 109 109 109 109 109 109 109 109 109 109 109 109 109 109 109 109 24 24 24 26 24 24 24 111 111 111 111 111 111 111 111 26 24 24 24 24 109 109 24 24 24 24
24 24 24 24 24 24 24 24 24 24 24 24 24 24 108 24 24 24 24 24 24 109 109 109 109 109 109 109 109 109 109 109 109 109 109 109 109 24 24 24 24 26 24 24 26 111 111 111 111 111 111 111 111 26 26 26 24 109 109 109 24 24 24 24
24 24 24 24 24 24 24 24 24 24 24 24 24 24 24 24 24 24 24 24 24 24 109 109 109 109 109 109 109 109 109 109 109 109 109 109 24 24 24 24 24 24 24 21 1 111 111 111 111 111 111 111 111 3 109 109 109 109 109 24 24 24 24 24
24 24 24 24 24 24 24 24 24 24 24 24 24 24 24 24 24 24 24 24 24 24 26 109 109 109 109 109 109 109 109 109 109 109 109 24 24 24 24 24 24 24 21 111 100 111 111 111 111 111 111 111 111 90 109 109 109 109 109 26 24 24 24 24
24 24 24 24 24 24 24 24 24 24 24 24 24 24 24 24 24 24 24 24 24 24 24 24 26 26 109 109 109 109 109 109 109 109 24 24 24 24 24 24 24 24 24 21 1 111 111 111 111 111 111 111 111 3 109 109 109 109 24 24 24 24 24 24
24 24 24 24 24 24 24 24 24 24 24 24 24 24 24 24 24 24 24 24 24 24 24 24 24 24 24 26 109 109 109 109 24 26 24 24 24 24 24 24 24 24 24 24 2 111 111 111 111 111 111 111 111 26 26 24 26 24 24 24 24 24 24 24
24 24 24 24 24 24 24 24 24 24 24 24 24 24 24 24 24 24 24 24 24 24 24 24 24 24 24 24 24 109 109 24 24 24 24 24 24 24 24 24 24 24 24 24 26 111 111 111 111 111 111 111 111 24 24 24 24 24 24 24 24 24 24 24
24 24 24 24 24 24 24 24 24 24 24 24 24 24 24 24 24 24 24 24 24 24 24 24 24 24 24 24 109 109 109 109 26 24 24 24 24 24 24 24 24 24 24 24 24 24 24 26 24 24 26 24 24 24 24 24 24 24 24 24 24 24 24 24
24 24 24 24 24 24 24 24 24 24 24 24 24 24 24 24 24 24 24 24 24 24 24 24 24 24 26 109 109 109 109 109 109 24 24 24 24 24 24 24 24 24 24 24 24 24 24 24 24 24 24 24 24 24 24 24 24 24 24 24 24 24 24 24
24 24 24 24 24 24 24 24 24 24 24 24 24 24 24 24 24 24 24 24 24 24 24 24 24 24 24 20 91 17 17 91 20 24 24 24 24 24 24 24 24 24 24 24 24 24 24 24 24 24 24 24 24 24 24 24 24 24 24 24 24 24 24 24
24 24 24 24 24 24 24 24 24 24 24 24 24 24 24 24 24 24 24 24 24 24 24 24 24 24 17 17 110 110 110 110 17 17 24 24 24 24 24 24 24 24 24 24 24 24 24 24 24 24 24 24 24 24 24 24 24 24 24 24 24 24 24 24
24 24 24 24 24 24 24 24 24 24 24 24 24 24 24 24 24 24 24 24 24 24 24 24 24 24 17 110 110 110 110 110 110 17 24 24 24 24 24 24 24 24 24 24 24 24 24 24 24 24 24 24 24 24 24 24 24 24 24 24 24 24 24 24
24 24 24 24 24 24 24 24 24 24 24 24 24 24 24 24 24 24 24 24 24 24 24 24 24 24 17 110 110 110 110 110 110 17 17 17 17 24 24 24 24 24 24 24 24 24 24 24 24 24 24 24 24 24 24 24 24 24 24 24 24 24 24 24
24 24 24 24 24 24 24 24 24 24 24 24 24 24 24 24 24 24 24 24 24 24 24 24 24 24 18 110 110 110 110 110 110 18 110 110 17 24 24 24 24 24 24 24 24 24 24 24 24 24 24 24 24 24 24 24 24 24 24 24 24 24 24 24
24 24 24 24 24 24 24 24 24 24 24 24 24 24 24 24 24 24 24 24 24 24 24 24 24 24 17 110 110 110 110 110 110 17 110 110 17 24 24 24 24 24 24 24 24 24 24 24 24 24 24 24 24 24 24 24 24 24 24 24 24 24 24 24
24 24 24 24 24 24 24 24 24 24 24 24 24 24 24 24 24 24 24 24 24 24 24 24 24 24 17 110 110 110 110 110 110 17 17 17 17 24 24 24 24 24 24 24 24 24 24 24 24 24 24 24 24 24 24 24 24 24 24 24 24 24 24 24
24 24 24 24 24 24 24 24 24 24 24 24 24 24 24 24 24 24 24 24 24 24 24 24 24 24 17 17 17 17 17 17 17 17 24 24 24 24 24 24 24 24 24 24 24 24 24 24 24 24 24 24 24 24 24 24 24 24 24 24 24 24 24 24
