8 9 8 8 8 8 9 8 8 9 8 8 8 8 8 8 9 8 8 8 8 9 8 8 8 8 8 8 8 8 8 8 8 8 8 9 8 8 8 9 9 8 9 8 8 8 8 8 8 9 8 8 8 8 9 9 9 8 8 8 8 8 8 9
8 119 119 119 119 119 119 119 119 119 8 8 8 8 8 119 119 119 119 119 119 119 119 119 119 119 8 8 8 8 8 8 119 119 119 119 119 119 119 119 119 119 119 119 119 119 119 119 119 119 119 119 119 119 119 119 119 119 119 119 119 119 119 8
9 119 8 8 9 8 8 8 8 119 8 9 9 8 8 119 9 9 9 8 8 9 8 8 8 119 8 8 8 8 8 8 119 9 8 9 9 8 8 8 8 9 8 9 8 8 8 9 8 8 8 9 8 8 9 9 8 9 8 8 8 9 119 8
8 119 119 119 119 119 119 8 8 119 119 119 119 119 119 119 8 8 8 8 8 8 8 8 8 119 8 8 8 9 8 8 119 9 8 8 8 8 8 8 8 8 8 8 8 9 8 8 8 9 8 8 8 8 8 9 8 8 8 8 8 9 119 8
8 8 9 8 9 8 119 9 8 8 8 8 8 8 8 8 8 8 8 9 8 8 9 8 8 119 8 8 119 119 119 119 119 8 8 8 8 8 8 8 8 8 119 119 119 119 119 119 119 119 119 119 119 119 119 119 119 119 119 8 8 9 119 8
8 8 8 119 119 119 119 8 8 119 119 119 119 119 119 119 119 119 119 8 8 8 119 119 119 119 8 9 119 8 9 8 9 8 8 8 8 8 8 8 8 9 119 8 8 8 8 8 9 9 9 8 8 8 9 8 8 8 119 8 8 9 119 8
8 8 8 119 8 8 8 9 8 119 9 8 8 8 9 8 8 8 119 9 9 9 119 8 8 8 8 9 119 8 8 8 8 8 8 8 8 9 9 8 8 8 119 8 8 8 8 8 8 8 8 8 8 8 8 8 8 9 119 8 8 9 119 9
8 8 9 119 8 8 8 9 8 119 8 8 8 8 8 9 8 8 91 8 8 8 119 8 8 8 8 8 119 8 8 8 8 8 8 8 114 114 114 9 8 9 119 119 119 119 119 119 119 119 119 119 119 8 8 8 8 119 119 8 8 9 119 8
8 8 9 119 119 119 119 119 119 119 8 8 8 8 115 115 115 115 115 115 9 8 119 8 9 8 9 8 119 9 8 8 8 8 8 8 114 114 114 8 9 8 9 8 9 8 8 8 9 9 8 8 119 8 8 8 8 119 8 8 8 9 119 9
8 8 8 8 8 9 8 8 8 8 8 8 8 9 115 115 115 115 115 115 8 9 119 119 119 119 119 119 119 8 8 8 8 8 8 8 114 114 114 114 114 114 8 8 8 8 8 8 8 8 8 8 119 8 8 8 9 119 8 8 8 8 119 9
8 8 8 8 8 8 8 8 8 8 8 8 8 9 115 115 115 115 115 115 8 8 8 9 9 8 8 9 8 8 8 8 8 109 109 90 114 114 114 114 114 114 8 9 8 8 8 8 8 8 8 9 119 8 8 8 8 119 119 119 119 119 119 8
8 118 118 118 118 118 118 8 8 8 8 8 8 8 115 115 115 115 115 115 9 8 8 8 8 8 8 8 8 8 8 8 8 109 109 8 114 114 114 114 114 114 114 114 8 8 8 8 8 8 8 8 119 9 8 8 8 8 8 9 8 8 8 9
8 118 118 118 118 118 118 8 8 9 9 9 8 8 115 115 115 115 115 115 9 8 8 8 8 8 8 8 8 8 8 8 8 109 109 8 8 8 8 114 114 114 114 114 9 8 8 8 8 119 119 119 119 8 8 8 9 8 8 8 9 8 8 8
8 8 8 8 8 8 8 9 115 115 115 115 115 115 115 115 115 8 9 9 9 8 8 8 8 8 8 8 8 8 8 8 8 109 109 8 8 8 8 114 114 114 114 114 90 119 119 8 8 119 8 8 9 8 119 119 119 119 119 119 119 8 8 8
8 118 118 118 118 118 118 8 115 115 115 115 115 115 115 115 115 8 8 8 8 8 8 8 8 8 8 8 8 8 8 8 8 109 109 8 8 8 8 8 8 9 8 8 8 119 119 8 8 119 119 119 119 119 119 119 119 119 119 119 119 8 8 8
8 118 118 118 118 118 118 9 115 115 8 8 8 9 8 9 8 8 8 8 8 8 8 8 8 8 8 8 8 8 8 8 8 109 109 8 8 8 8 8 8 8 8 8 8 119 119 8 8 8 8 8 8 8 119 119 119 119 119 119 119 8 8 8
8 118 118 118 118 118 118 8 115 115 8 8 8 8 8 8 8 8 8 8 8 8 109 109 109 109 109 109 109 109 109 109 109 109 109 8 8 8 8 8 8 8 8 8 8 119 119 119 119 119 119 119 9 8 119 119 119 119 119 119 119 9 8 8
8 118 118 118 118 118 118 8 115 115 9 8 8 8 8 8 8 8 8 8 8 8 109 109 109 109 109 109 109 109 109 109 109 109 109 8 8 8 8 8 8 8 8 8 8 119 119 119 119 119 119 119 8 8 119 119 119 119 119 119 119 8 8 8
8 118 118 118 118 118 118 8 115 115 9 8 8 8 8 8 8 8 8 8 8 8 109 109 8 8 8 8 8 8 8 8 8 8 8 8 8 8 8 8 8 8 8 8 8 8 8 8 8 8 8 8 8 8 119 119 119 119 119 119 119 9 8 8
8 118 118 118 118 118 106 8 115 115 115 115 115 9 8 8 8 8 8 8 8 8 109 109 8 109 109 8 109 109 8 8 8 8 8 138 138 138 138 138 8 21 8 8 8 8 8 8 9 119 119 8 119 106 119 119 119 119 119 119 119 9 8 8
8 118 118 8 8 91 8 8 115 115 115 115 106 8 8 8 8 8 8 109 109 8 109 109 8 8 109 109 109 8 8 8 8 8 8 138 138 138 138 138 100 138 21 8 8 8 8 8 8 9 9 8 106 119 119 119 119 119 119 119 119 8 8 8
8 118 118 8 116 116 116 8 115 115 115 115 115 8 8 8 8 8 8 8 8 8 8 8 8 9 109 109 109 8 8 9 8 9 8 138 138 138 138 138 8 21 8 8 8 8 8 8 8 8 8 8 119 106 119 119 119 119 119 119 119 8 8 8
8 118 118 8 116 116 116 9 115 115 115 115 106 8 9 8 9 8 8 8 9 109 109 109 109 109 109 109 109 109 109 109 109 109 90 138 138 138 138 138 8 8 8 8 8 8 8 8 8 8 8 8 8 8 8 9 9 8 8 9 9 8 8 8
8 118 118 90 116 116 116 8 115 115 115 115 115 115 115 115 115 115 8 8 8 109 109 109 109 109 109 109 109 109 109 109 109 109 8 138 138 138 138 138 8 109 109 8 8 8 8 8 8 8 8 8 8 8 8 8 8 8 8 8 8 8 8 8
8 118 106 8 116 116 116 8 8 8 8 8 115 115 115 115 115 115 8 8 8 8 109 109 109 106 109 106 109 106 109 109 109 8 8 8 8 8 8 8 8 109 109 8 8 8 8 8 8 8 8 8 8 8 8 8 8 8 8 8 8 8 8 8
8 8 8 8 116 116 116 8 8 8 8 8 115 115 115 115 115 115 9 8 8 109 109 109 8 8 8 8 8 8 8 109 109 109 9 8 8 8 109 109 8 109 109 8 8 8 8 8 8 8 8 8 8 8 8 8 8 8 8 8 8 8 8 8
8 116 116 116 116 116 116 8 8 8 8 8 8 8 9 8 91 8 8 8 9 109 109 109 8 8 8 8 8 8 8 109 109 109 8 9 8 8 109 109 8 109 109 8 8 8 8 113 113 113 113 113 113 8 8 8 8 8 8 8 8 8 8 8
8 116 116 116 116 116 116 9 8 8 8 8 8 8 8 9 109 8 109 109 109 109 109 109 8 8 108 108 108 8 109 109 109 109 109 109 109 8 109 109 8 8 8 8 8 8 8 113 113 113 113 113 113 8 8 8 8 8 8 8 8 8 8 8
8 116 116 8 8 8 8 8 8 8 8 8 8 8 8 109 109 8 109 109 109 109 109 109 8 13 108 108 108 90 109 109 109 109 109 109 109 9 109 109 8 8 8 8 8 8 8 113 113 113 113 113 113 8 8 8 8 8 8 8 8 8 8 8
8 116 116 8 8 8 8 8 8 8 8 8 8 8 8 8 109 8 109 109 109 109 109 109 8 8 108 108 108 8 109 109 109 109 109 109 109 8 109 109 8 8 8 8 106 109 90 113 113 113 113 8 8 8 8 8 8 8 8 8 8 8 8 8
8 116 116 8 8 8 8 8 8 8 8 8 8 8 8 8 91 8 8 8 9 109 109 109 8 8 8 8 8 8 8 109 109 109 9 8 8 8 109 109 8 8 8 8 109 106 8 113 113 113 8 8 8 8 8 8 8 8 8 8 8 8 8 8
8 116 116 8 8 8 8 8 8 8 8 8 8 8 116 116 116 116 8 8 8 109 109 109 8 8 8 8 8 8 8 109 109 109 9 8 8 8 109 109 8 8 8 8 106 109 8 113 113 113 8 8 8 8 8 8 8 8 8 8 8 8 8 8
8 116 116 8 8 8 8 8 8 8 8 8 8 8 116 116 116 116 8 8 8 8 109 109 109 106 109 106 109 106 109 109 109 8 8 8 8 8 109 109 8 8 8 8 109 109 8 8 8 8 8 8 8 8 8 8 8 8 8 8 8 8 8 8
8 116 116 8 8 8 8 8 8 8 8 8 116 116 116 116 116 116 8 8 8 109 109 109 109 109 109 109 109 109 109 109 109 109 8 8 109 109 109 109 109 109 109 109 109 109 8 8 8 8 8 8 8 8 8 8 8 8 8 8 8 8 8 8
8 116 116 8 8 8 8 8 9 8 8 9 116 116 116 116 116 116 8 8 9 109 109 109 109 109 109 109 109 109 109 109 109 109 8 8 109 109 109 109 109 109 109 109 109 109 8 8 8 8 8 8 8 8 8 8 8 8 8 8 8 8 8 8
8 116 116 116 116 116 116 116 116 116 116 116 116 116 116 116 8 8 8 8 8 8 8 9 9 9 109 109 109 9 8 9 9 8 8 8 109 109 8 8 8 8 8 8 8 8 8 8 8 8 8 8 8 8 8 8 8 8 8 8 8 8 8 8
8 116 116 116 116 116 116 116 116 116 116 116 116 116 116 116 8 8 8 8 8 8 8 8 8 8 109 109 109 8 8 8 8 8 8 8 109 109 8 8 8 8 8 8 8 8 8 8 8 8 8 8 8 8 8 8 8 8 8 8 8 8 8 8
8 8 8 8 8 8 8 8 8 8 8 8 8 8 8 8 8 8 8 8 8 8 8 8 8 9 109 109 109 8 8 8 8 8 8 8 109 109 8 8 8 8 8 8 8 8 8 8 8 8 8 8 8 8 8 8 8 8 8 8 8 8 8 8
8 8 8 8 8 8 8 8 8 8 8 8 8 8 8 8 8 8 8 8 8 8 8 8 8 8 8 8 8 8 8 8 8 8 8 8 109 109 8 8 8 8 8 8 8 8 8 8 8 8 8 8 8 8 8 8 8 8 8 8 8 8 8 8
8 8 8 8 8 8 8 8 8 8 8 8 8 8 8 8 8 8 8 8 8 8 8 8 109 109 109 109 109 9 8 8 8 8 8 8 8 91 8 8 8 8 8 8 8 8 8 8 8 8 8 8 8 8 8 8 8 8 8 8 8 8 8 8
8 8 8 8 8 8 8 8 8 8 8 8 8 8 8 8 8 8 8 8 8 8 8 9 109 109 109 109 109 8 8 8 8 8 8 8 112 112 112 112 112 112 8 8 8 8 8 8 8 8 8 8 8 8 8 8 8 8 8 8 8 8 8 8
8 8 8 8 8 8 8 8 8 8 8 8 8 8 8 8 8 8 8 8 8 8 8 8 109 109 9 8 8 8 8 8 8 8 8 8 112 112 112 112 112 112 8 8 8 8 8 8 8 8 8 8 8 8 8 8 8 8 8 8 8 8 8 8
8 8 8 8 8 8 8 8 8 8 8 8 8 8 8 8 8 8 8 8 8 8 8 9 109 109 8 8 8 8 8 8 8 8 8 8 112 112 112 112 112 112 8 8 8 8 8 8 8 8 8 8 8 8 8 8 8 8 8 8 8 8 8 8
8 8 8 8 8 8 8 8 8 8 8 8 8 8 8 8 8 8 8 8 8 8 8 8 109 109 8 8 8 8 8 8 8 8 8 8 8 8 8 112 112 112 112 8 8 8 8 8 8 8 8 8 8 8 8 8 8 8 8 8 8 8 8 8
8 8 8 8 8 8 8 8 8 8 8 8 8 8 8 8 8 8 8 8 8 8 8 8 109 109 9 8 8 8 8 8 8 8 8 8 8 8 8 112 112 112 112 8 8 8 8 8 8 8 8 8 8 8 8 8 8 8 8 8 8 8 8 8
8 8 8 8 8 8 8 8 8 8 8 8 8 8 8 8 8 8 8 8 109 109 109 109 109 109 109 109 8 8 8 8 8 8 8 8 8 8 8 8 8 112 112 8 8 8 8 8 8 8 8 8 8 8 8 8 8 8 8 8 8 8 8 8
8 8 8 8 8 8 8 8 8 8 8 8 8 8 8 8 8 8 8 9 109 109 109 109 109 109 109 109 9 8 8 8 8 8 8 8 8 8 8 8 8 112 112 8 8 8 8 8 8 8 8 8 8 8 8 8 8 8 8 8 8 8 8 8
8 8 8 8 8 8 8 8 8 8 8 8 8 8 8 8 8 8 8 8 109 109 8 8 9 8 8 8 8 8 8 8 8 8 112 112 112 112 112 112 112 112 112 8 8 8 8 8 8 8 8 8 8 8 8 8 8 8 8 8 8 8 8 8
8 8 8 8 8 8 8 8 8 8 8 8 8 9 8 8 9 8 8 9 109 109 9 8 8 8 8 8 8 8 8 8 8 8 112 112 112 112 112 112 112 112 112 8 8 8 8 8 8 8 8 8 8 8 8 8 8 8 8 8 8 8 8 8
8 8 8 8 8 8 8 8 8 8 8 8 110 110 110 110 110 110 110 8 109 109 9 8 8 8 8 8 8 8 8 8 8 8 112 112 112 112 112 112 112 112 112 8 8 8 8 8 8 8 8 8 8 8 8 8 8 8 8 8 8 8 8 8
8 8 8 8 8 8 8 8 8 8 9 9 110 110 110 110 110 110 110 9 109 109 8 8 8 8 8 8 8 8 8 8 8 8 8 8 8 8 8 8 8 8 8 8 8 8 8 8 8 8 8 8 8 8 8 8 8 8 8 8 8 8 8 8
8 8 8 8 8 8 8 8 8 8 8 9 110 110 110 110 110 110 110 8 109 109 9 8 8 8 8 8 8 8 8 8 8 8 8 8 8 8 8 8 8 8 8 8 8 8 8 8 8 8 8 8 8 8 8 8 8 8 8 8 8 8 8 8
8 8 8 8 8 8 8 8 8 8 8 8 110 110 110 8 9 8 91 8 109 109 8 8 8 8 8 8 8 8 8 8 8 8 8 8 8 8 8 8 8 8 8 8 8 8 8 8 8 8 8 8 8 8 8 8 8 8 8 8 8 8 8 8
8 8 8 8 8 8 8 8 8 9 9 8 110 110 110 8 8 8 109 109 109 109 109 109 8 8 8 8 8 8 8 8 8 8 8 8 8 8 8 8 8 8 8 8 8 8 8 8 8 8 8 8 8 8 8 8 8 8 8 8 8 8 8 8
8 8 8 8 8 8 8 8 110 106 110 110 110 110 106 9 8 8 109 109 109 109 109 109 9 8 8 8 8 8 8 8 8 8 9 8 8 8 8 8 8 8 8 8 8 8 8 8 8 8 8 8 8 8 8 8 8 8 8 8 8 8 8 8
8 8 8 8 8 8 8 5 110 110 110 110 110 110 110 8 8 8 9 9 8 9 8 91 8 9 8 8 9 8 8 8 9 140 140 140 8 8 8 8 8 8 8 8 8 8 8 8 8 8 8 8 8 8 8 8 8 8 8 8 8 8 8 8
8 8 8 8 8 8 8 8 110 110 110 110 110 110 110 8 8 8 8 8 9 9 111 111 111 111 111 111 111 111 8 8 140 140 140 140 140 8 140 140 8 8 8 8 8 8 8 8 8 8 8 8 8 8 8 8 8 8 8 8 8 8 8 8
8 8 8 8 8 5 110 110 110 110 110 110 110 110 106 9 8 8 8 8 8 111 111 111 111 111 111 111 111 111 111 90 140 140 140 140 140 8 140 140 8 8 8 8 8 8 8 8 8 8 8 8 8 8 8 8 8 8 8 8 8 8 8 8
8 8 8 8 8 8 8 9 110 110 110 110 110 110 110 8 8 8 8 8 9 111 111 111 111 111 111 111 111 111 111 8 140 140 140 140 140 9 140 140 8 8 8 8 8 8 8 8 8 8 8 8 8 8 8 8 8 8 8 8 8 8 8 8
8 8 8 8 8 8 8 5 110 110 110 110 110 110 110 9 8 8 8 8 8 111 111 111 111 111 111 111 111 111 111 8 140 140 140 140 140 8 140 140 8 8 8 8 8 8 8 8 8 8 8 8 8 8 8 8 8 8 8 8 8 8 8 8
8 8 8 8 8 8 8 8 110 110 110 110 110 110 106 9 8 8 8 8 8 111 111 111 111 111 111 111 111 111 111 90 140 140 140 140 140 9 140 140 8 8 8 8 8 8 8 8 8 8 8 8 8 8 8 8 8 8 8 8 8 8 8 8
8 8 8 8 8 8 8 8 8 5 8 110 8 5 8 8 8 8 8 8 8 8 111 111 111 111 111 111 111 111 8 8 140 140 140 140 140 8 140 140 9 8 8 8 8 8 8 8 8 8 8 8 8 8 8 8 8 8 8 8 8 8 8 8
8 8 8 8 8 8 8 8 8 8 8 110 8 8 8 8 8 8 8 8 8 8 8 8 8 8 8 8 8 8 8 9 8 140 140 140 8 8 140 140 8 8 8 8 8 8 8 8 8 8 8 8 8 8 8 8 8 8 8 8 8 8 8 8
8 8 8 8 8 8 8 8 8 8 8 7 8 8 8 8 8 8 8 8 8 8 8 8 8 8 8 8 8 8 8 8 8 8 8 8 8 8 8 8 8 8 8 8 8 8 8 8 8 8 8 8 8 8 8 8 8 8 8 8 8 8 8 8
