24 24 24 24 24 24 24 24 24 26 24 26 24 24 24 24 24 24 24 24 24 24 24 12 12 12 12 12 12 12 12 12 12 12 12 12 12 12 12 12 12 12 17 17 17 17 17 17 17 17 17 17 17 17 17 17 17 17 17 17 17 17 17 17
24 24 26 24 24 24 24 24 108 108 108 108 108 108 108 108 108 24 24 24 24 24 24 12 12 12 12 12 12 12 12 12 12 111 111 111 111 111 111 111 111 12 17 17 17 17 17 17 17 17 17 17 17 17 20 17 17 17 17 17 17 17 17 17
24 108 108 24 26 24 24 26 106 24 24 24 108 24 24 24 106 26 24 24 24 24 24 12 12 12 12 12 12 12 12 12 12 111 111 111 111 111 111 111 111 12 17 17 17 17 17 17 17 17 17 17 17 118 118 118 118 118 118 118 17 17 17 17
26 108 108 108 108 108 108 24 108 24 108 108 108 108 108 26 108 24 24 24 1 28 26 12 111 111 111 111 12 12 12 12 111 111 111 111 111 111 111 111 111 12 17 17 17 17 17 17 17 17 17 17 17 118 118 118 118 118 118 118 17 17 17 17
24 24 26 24 108 108 108 26 24 26 108 108 108 108 108 24 26 24 26 24 108 108 108 12 111 111 111 111 12 12 12 12 111 111 12 12 12 12 12 12 12 12 17 17 17 17 17 17 17 17 17 17 17 118 118 118 118 118 118 118 17 17 17 17
24 13 108 108 108 108 108 108 108 108 108 108 15 108 108 108 108 108 108 108 108 108 108 90 111 111 111 111 23 111 111 12 12 12 17 17 17 17 17 17 17 17 17 17 17 17 17 17 17 17 17 17 17 17 91 17 17 118 118 118 17 17 17 17
24 24 26 24 108 108 108 24 24 26 108 108 108 108 108 24 26 24 26 2 108 108 108 12 111 111 111 111 12 111 111 111 111 111 18 112 112 112 106 112 112 112 112 17 116 116 116 17 117 117 117 117 117 117 117 117 17 118 118 118 20 17 17 17
24 108 108 108 108 108 108 24 24 24 108 108 108 108 108 24 24 24 24 24 1 28 26 12 111 111 111 111 12 111 111 111 111 111 90 112 112 112 112 112 112 112 112 90 116 116 116 17 117 117 117 117 117 117 117 117 17 118 118 118 17 17 17 17
24 108 108 24 26 24 24 24 24 24 24 108 108 108 24 24 24 24 24 24 24 24 24 12 12 12 12 12 12 111 111 111 111 111 18 112 112 112 112 106 112 112 112 17 116 116 116 17 117 117 117 117 117 106 117 117 17 17 91 17 17 17 17 17
24 24 26 24 24 24 24 24 24 24 24 108 108 108 24 24 24 24 24 24 24 24 24 24 24 24 24 24 12 12 23 91 23 12 17 17 17 17 17 17 17 91 17 17 116 116 116 17 17 91 17 17 17 17 17 17 17 119 119 119 17 17 17 17
24 24 24 24 24 24 24 24 24 24 26 108 108 108 26 24 24 24 24 24 24 24 24 24 24 24 24 24 24 12 113 113 113 12 17 114 114 114 114 17 115 115 115 17 116 116 116 116 116 116 116 17 120 120 120 120 17 119 119 119 17 17 17 17
24 24 24 24 24 24 24 24 24 24 108 108 108 108 1 24 24 24 24 24 24 24 24 24 24 24 24 24 24 10 113 113 113 10 17 114 114 114 114 90 115 115 115 17 116 116 116 116 116 116 116 90 120 120 120 120 17 119 119 119 17 17 17 17
24 24 24 26 108 106 24 26 26 108 108 108 108 108 1 24 24 24 24 24 24 24 24 24 24 24 24 24 24 12 113 113 113 12 17 114 114 114 114 17 115 115 115 17 116 116 116 116 116 116 116 17 120 120 120 120 17 106 119 119 119 119 106 17
24 24 24 108 108 108 108 108 108 108 108 108 108 26 24 24 24 24 24 24 24 24 24 24 24 24 24 24 24 12 113 113 113 12 17 17 114 114 114 17 115 115 115 17 17 17 17 17 17 17 17 17 120 120 120 120 17 119 119 119 119 119 119 20
24 2 26 108 108 108 108 108 108 108 108 108 108 24 24 24 24 24 24 24 24 24 24 24 24 24 24 24 24 11 113 113 113 11 17 17 114 114 114 17 115 115 115 115 115 115 115 17 17 120 120 120 120 120 120 120 17 119 119 119 119 106 119 17
16 108 108 108 108 108 108 108 108 108 108 108 24 24 24 24 24 24 24 24 24 24 24 24 24 24 24 24 24 12 113 113 113 12 17 17 114 114 114 90 115 115 115 115 115 115 115 17 17 120 120 120 120 120 120 120 17 17 17 17 17 17 17 17
24 1 108 108 108 108 108 108 108 108 2 26 24 24 24 24 24 24 24 24 24 24 24 24 24 24 24 24 24 12 12 113 12 12 17 17 114 114 114 17 115 115 115 115 115 115 115 17 17 120 120 120 120 120 120 120 17 121 121 121 121 121 121 17
16 108 108 108 108 108 108 108 108 2 24 24 24 24 24 8 8 9 8 8 8 8 8 8 9 8 8 8 8 8 8 91 8 8 17 17 17 17 17 17 17 17 17 17 17 17 17 17 17 17 91 17 17 17 91 17 17 121 121 121 121 121 121 17
24 2 26 108 108 106 24 26 1 24 24 24 24 24 24 8 9 106 8 8 8 8 124 106 124 106 124 106 8 8 8 124 8 8 8 8 8 8 17 17 17 17 17 17 17 17 17 17 17 123 123 123 17 121 121 121 121 121 121 121 17 17 17 17
24 24 24 24 91 24 24 24 24 24 24 24 24 24 24 8 8 124 9 8 8 8 124 8 8 8 8 9 8 9 124 124 124 8 8 8 8 8 8 8 8 8 8 8 17 17 17 17 17 123 123 123 17 121 121 121 121 121 121 121 17 122 122 17
24 24 24 109 109 106 24 24 24 24 24 24 24 24 24 8 8 106 8 8 8 8 124 9 8 8 8 8 9 124 124 124 124 124 9 8 8 8 8 8 8 8 8 8 17 17 17 17 17 123 123 123 17 121 121 121 121 121 121 121 17 122 122 17
24 24 26 109 109 109 26 24 24 24 24 24 24 24 24 8 8 124 9 8 8 8 124 8 8 8 8 8 124 124 124 124 124 124 124 9 8 8 8 8 5 8 8 8 17 17 17 17 17 123 123 123 17 17 91 17 17 17 91 17 17 122 122 17
24 24 26 109 109 109 24 24 24 24 24 24 24 24 24 8 9 106 8 8 8 124 124 124 8 9 8 124 124 124 124 124 124 124 124 124 8 9 8 124 124 124 9 8 17 17 17 17 17 123 123 123 123 123 123 123 17 122 122 122 122 122 122 17
24 24 24 24 26 24 24 24 24 24 24 24 24 24 24 8 8 124 124 124 124 124 124 124 124 124 124 124 124 124 124 124 124 124 124 124 124 124 124 124 124 124 5 8 17 17 17 17 17 123 123 123 123 123 123 123 17 122 122 122 122 122 122 17
24 24 24 24 24 24 24 24 24 24 24 24 24 24 24 8 8 8 8 9 8 124 124 124 8 9 8 124 124 124 124 124 124 124 124 124 8 9 8 106 124 124 8 8 17 17 17 17 17 123 123 123 123 123 123 123 17 122 122 122 122 122 122 17
24 24 24 24 24 24 24 24 24 24 24 24 24 24 24 8 8 124 124 8 8 9 124 8 8 8 8 9 124 124 124 124 124 124 124 8 8 8 8 8 5 8 8 8 17 17 17 17 17 17 17 17 17 17 17 17 17 17 17 17 17 17 17 17
24 24 24 24 24 24 24 24 24 24 24 24 24 24 24 8 8 124 124 8 8 8 124 8 8 8 8 8 9 124 124 124 124 124 8 8 8 8 8 8 8 8 8 8 17 17 17 17 17 17 17 17 17 17 17 17 17 17 17 17 17 17 17 17
24 24 24 24 24 24 24 24 24 24 24 24 24 24 24 8 8 9 8 8 9 8 124 8 8 8 8 8 8 8 124 124 124 8 8 8 8 8 8 8 24 24 24 24 17 17 17 17 17 17 17 17 17 17 17 17 17 17 17 17 17 17 17 17
24 24 24 24 24 24 24 24 24 24 24 24 24 24 24 8 9 106 124 106 124 106 124 9 8 8 8 8 8 8 8 124 8 8 8 8 8 8 8 8 24 24 24 24 17 17 17 17 17 17 17 17 17 17 17 17 17 17 17 17 17 17 17 17
24 24 24 24 24 24 24 24 24 24 24 24 24 24 24 8 8 8 8 9 8 9 8 8 8 8 8 8 8 8 8 124 9 8 8 8 8 8 8 8 24 24 24 24 17 17 17 17 17 17 17 17 17 17 17 17 17 17 17 17 17 17 17 17
24 24 24 24 24 24 24 24 24 24 24 24 24 24 24 8 8 8 8 8 8 8 8 8 8 8 9 8 9 8 9 124 8 8 8 9 8 8 8 8 24 24 24 24 17 17 17 17 17 17 17 17 17 17 17 17 17 17 17 17 17 17 17 17
24 24 24 24 24 24 24 24 24 24 24 24 24 24 24 8 8 8 8 8 8 8 8 8 8 8 125 125 125 8 124 124 124 8 125 125 125 8 8 8 24 24 24 24 24 24 24 24 24 24 24 24 24 24 24 24 24 24 24 24 24 24 24 24
24 24 24 24 24 24 24 24 24 24 24 24 24 24 24 8 8 8 8 8 8 8 8 8 8 5 125 125 125 90 124 124 124 90 125 125 125 7 8 8 24 24 24 24 24 24 24 24 24 24 24 24 24 24 24 24 24 24 24 24 24 24 24 24
24 24 24 24 24 24 24 24 24 24 24 24 24 24 24 8 8 8 8 8 8 8 8 8 8 8 125 125 125 8 124 124 124 9 125 125 125 9 8 8 24 24 24 24 24 24 24 24 24 24 24 24 24 24 24 24 24 24 24 24 24 24 24 24
24 24 24 24 24 24 24 24 24 24 24 24 24 24 24 8 8 8 8 8 8 8 8 8 8 5 125 125 125 8 9 91 8 8 125 125 125 5 8 8 24 24 24 24 24 24 24 24 24 24 24 24 24 24 24 24 24 24 24 24 24 24 24 24
24 24 24 24 24 24 24 24 24 24 24 24 24 24 24 8 8 8 8 8 8 8 8 8 8 8 125 125 125 125 125 125 125 125 125 125 125 8 8 8 24 24 24 24 24 24 24 24 24 24 24 24 24 24 24 24 24 24 24 24 24 24 24 24
24 24 24 24 24 24 24 24 24 24 24 24 24 24 24 8 8 8 8 8 8 8 8 8 8 7 125 125 125 125 125 125 125 125 125 125 125 5 8 8 24 24 24 24 24 24 24 24 24 24 24 24 24 24 24 24 24 24 24 24 24 24 24 24
24 24 24 24 24 24 24 24 24 24 24 24 24 24 24 8 8 8 8 8 8 8 8 8 8 8 125 125 125 125 125 125 125 125 125 125 125 9 8 8 24 24 24 24 24 24 24 24 24 24 24 24 24 24 24 24 24 24 24 24 24 24 24 24
24 24 24 24 24 24 24 24 24 24 24 24 24 24 24 8 8 8 8 8 8 8 8 8 8 8 8 9 9 8 125 125 125 8 8 8 9 8 8 8 24 24 24 24 24 24 24 24 24 24 24 24 24 24 24 24 24 24 24 24 24 24 24 24
24 24 24 24 24 24 24 24 24 24 24 24 24 24 24 8 8 8 8 8 8 8 8 8 8 8 8 8 8 9 125 125 125 9 8 8 8 8 8 8 24 24 24 24 24 24 24 24 24 24 24 24 24 24 24 24 24 24 24 24 24 24 24 24
24 24 24 24 24 24 24 24 24 24 24 24 24 24 24 8 8 8 8 8 8 8 8 8 8 8 8 8 8 8 125 125 125 9 8 8 8 8 8 8 24 24 24 24 24 24 24 24 24 24 24 24 24 24 24 24 24 24 24 24 24 24 24 24
24 24 24 24 24 24 24 24 24 24 24 24 24 24 24 8 8 8 8 8 8 8 8 8 8 8 8 8 8 8 125 125 125 8 8 8 8 8 8 8 24 24 24 24 24 24 24 24 24 24 24 24 24 24 24 24 24 24 24 24 24 24 24 24
24 24 24 24 24 24 24 24 24 24 24 24 24 24 24 8 8 8 8 8 8 8 8 8 8 8 8 8 8 125 125 125 125 125 9 8 8 8 8 8 8 8 8 8 8 24 24 24 24 24 24 24 24 24 24 24 24 24 24 24 24 24 24 24
24 24 24 24 24 24 24 24 24 24 24 24 24 24 24 8 8 8 8 8 8 8 8 8 8 8 8 8 125 125 125 125 125 125 125 9 8 8 8 8 8 8 8 8 8 24 24 24 24 24 24 24 24 24 24 24 24 24 24 24 24 24 24 24
24 24 24 24 24 24 24 24 24 24 24 24 24 24 24 8 8 8 8 8 8 8 8 8 8 8 8 125 125 125 125 9 125 125 125 125 9 8 8 8 8 8 8 8 8 24 24 24 24 24 24 24 24 24 24 24 24 24 24 24 24 24 24 24
24 24 24 24 24 24 24 24 24 24 24 24 24 24 24 8 8 8 8 8 8 8 8 8 8 8 125 125 125 125 8 8 8 125 125 125 125 8 8 8 8 8 8 8 8 24 24 24 24 24 24 24 24 24 24 24 24 24 24 24 24 24 24 24
24 24 24 24 24 24 24 24 24 24 24 24 24 24 24 8 8 8 8 8 8 8 8 8 8 125 125 125 125 8 8 8 8 9 125 125 125 125 9 8 8 8 8 8 8 8 8 8 8 8 8 8 8 24 24 24 24 24 24 24 24 24 24 24
24 24 24 24 24 24 24 24 24 24 24 8 8 8 8 8 8 8 8 8 8 8 8 8 125 125 125 125 8 8 8 8 8 8 8 125 125 125 125 8 8 8 8 8 8 8 8 8 8 8 8 8 8 24 24 24 24 24 24 24 24 24 24 24
24 24 24 24 24 24 24 24 24 24 24 8 8 8 5 9 5 8 8 8 106 8 8 125 125 125 125 8 8 8 8 8 8 8 8 9 125 125 125 125 9 8 106 8 8 8 5 9 5 8 8 8 8 24 24 24 24 24 24 24 24 24 24 24
24 24 24 24 24 24 24 24 24 24 24 8 8 127 127 127 127 106 8 8 125 8 125 125 125 125 8 8 8 8 8 8 8 8 8 8 8 125 125 125 125 8 125 8 8 128 128 128 128 128 8 8 8 24 24 24 24 24 24 24 24 24 24 24
24 24 24 24 24 24 24 24 24 24 24 8 7 127 127 127 127 127 9 125 125 125 125 125 125 8 8 8 8 8 8 8 8 8 8 8 8 8 125 125 125 125 125 125 9 128 128 128 128 128 5 8 8 24 24 24 24 24 24 24 24 24 24 24
24 24 24 24 24 24 24 24 24 24 24 8 9 127 127 15 127 127 90 125 125 125 125 125 8 8 8 8 8 8 8 8 8 8 8 8 8 8 9 125 125 125 125 125 90 128 128 15 128 128 8 8 8 24 24 24 24 24 24 24 24 24 24 24
24 24 24 24 24 24 24 24 24 24 24 8 5 127 127 127 127 127 8 125 125 125 125 8 8 8 8 8 8 125 125 125 125 125 8 8 8 8 8 8 125 125 125 125 8 128 128 128 128 128 5 8 8 24 24 24 24 24 24 24 24 24 24 24
24 24 24 24 24 24 24 24 24 24 24 8 8 127 127 127 127 106 9 8 125 8 8 8 8 8 8 8 8 125 125 125 125 125 8 8 8 8 8 8 8 9 125 9 8 128 128 128 128 128 8 8 8 24 24 24 24 24 24 24 24 24 24 24
24 24 24 24 24 24 24 24 24 24 24 8 8 9 5 8 5 8 8 9 125 8 8 9 8 8 9 9 8 8 8 8 8 9 8 8 8 8 8 8 8 8 125 8 8 8 5 8 5 8 9 8 8 24 24 24 24 24 24 24 24 24 24 24
24 24 24 24 24 24 24 24 24 24 24 8 8 8 8 8 8 8 8 8 125 125 125 125 125 125 125 125 125 125 125 125 125 125 125 125 125 125 125 125 125 125 125 9 8 8 8 8 8 8 8 8 8 24 24 24 24 24 24 24 24 24 24 24
24 24 24 24 24 24 24 24 24 24 24 8 8 8 8 8 8 8 8 8 8 9 9 8 8 9 8 8 8 8 125 125 125 8 8 9 8 8 9 9 9 8 8 8 8 8 8 8 8 8 8 8 8 24 24 24 24 24 24 24 24 24 24 24
24 24 24 24 24 24 24 24 24 24 24 24 24 24 24 24 24 24 24 24 24 24 8 8 8 8 8 8 8 9 125 125 125 9 8 8 24 24 24 24 24 24 24 24 24 24 24 24 24 24 24 24 24 24 24 24 24 24 24 24 24 24 24 24
24 24 24 24 24 24 24 24 24 24 24 24 24 24 24 24 24 24 24 24 24 24 8 8 8 8 8 8 8 12 12 93 12 12 8 8 24 24 24 24 24 24 24 24 24 24 24 24 24 24 24 24 24 24 24 24 24 24 24 24 24 24 24 24
24 24 24 24 24 24 24 24 24 24 24 24 24 24 24 24 24 24 24 24 24 24 8 8 8 12 12 12 12 12 126 126 126 12 8 8 24 24 24 24 24 24 24 24 24 24 24 24 24 24 24 24 24 24 24 24 24 24 24 24 24 24 24 24
24 24 24 24 24 24 24 24 24 24 24 24 24 24 24 24 24 24 24 24 24 24 8 8 21 23 126 126 126 126 126 126 126 12 8 8 24 24 24 24 24 24 24 24 24 24 24 24 24 24 24 24 24 24 24 24 24 24 24 24 24 24 24 24
24 24 24 24 24 24 24 24 24 24 24 24 24 24 24 24 24 24 24 24 24 24 8 21 126 100 126 126 126 126 126 126 126 12 8 8 24 24 24 24 24 24 24 24 24 24 24 24 24 24 24 24 24 24 24 24 24 24 24 24 24 24 24 24
24 24 24 24 24 24 24 24 24 24 24 24 24 24 24 24 24 24 24 24 24 24 8 8 21 23 126 126 126 126 126 126 126 12 8 8 24 24 24 24 24 24 24 24 24 24 24 24 24 24 24 24 24 24 24 24 24 24 24 24 24 24 24 24
24 24 24 24 24 24 24 24 24 24 24 24 24 24 24 24 24 24 24 24 24 24 8 8 8 12 12 12 12 12 12 11 12 12 8 8 24 24 24 24 24 24 24 24 24 24 24 24 24 24 24 24 24 24 24 24 24 24 24 24 24 24 24 24
