24 24 24 24 24 24 24 24 24 24 24 24 24 24 24 24 24 24 24 24 24 24 24 24 24 24 24 24 24 24 24 24 24 24 24 24 24 24 24 24 24 24 24 24 24 24 24 24 24 24 24 24 24 24 24 24 24 24 24 24 24 24 24 24
24 24 24 24 24 24 24 24 24 24 24 24 24 24 24 24 24 24 24 24 24 24 24 24 24 24 24 24 24 24 24 24 24 24 24 24 24 24 24 24 24 24 24 24 24 24 24 24 24 24 24 24 24 24 24 24 24 24 24 24 24 24 24 24
24 24 24 24 24 24 24 24 24 24 24 24 24 24 24 24 24 24 24 24 24 24 24 24 24 24 24 24 24 24 24 24 24 24 24 24 24 24 24 24 24 24 24 24 24 24 24 24 24 24 24 24 24 24 24 24 24 24 24 24 24 24 24 24
24 118 118 118 118 118 118 118 118 118 118 118 118 24 24 24 24 24 24 24 24 24 24 24 24 24 24 24 24 24 24 24 24 24 24 24 24 24 24 24 24 24 24 24 24 24 24 24 24 24 24 24 24 24 24 24 24 24 24 24 24 24 24 24
24 118 118 118 118 118 118 118 118 118 118 118 118 24 24 24 24 24 24 118 118 118 118 118 24 24 24 24 24 24 24 24 24 24 24 24 24 24 24 24 24 24 24 24 24 24 24 24 24 24 24 24 24 24 24 24 24 24 24 24 24 24 24 24
24 118 118 118 118 118 118 118 118 118 118 118 118 118 118 118 118 118 24 118 118 118 118 118 24 24 24 24 24 24 24 24 24 24 24 24 24 24 24 24 24 24 24 24 24 24 24 24 24 24 24 24 24 24 24 24 24 24 24 24 24 24 24 24
24 118 118 118 118 118 118 118 118 118 118 118 118 118 118 118 118 118 24 118 118 118 118 118 24 24 24 24 24 24 24 24 24 24 24 24 24 24 24 24 24 24 24 24 24 24 24 24 24 24 24 24 24 24 24 24 24 24 24 24 24 24 24 24
24 118 118 118 118 118 118 118 118 118 118 118 118 24 24 24 118 118 26 118 118 118 118 118 24 24 24 24 24 24 24 24 24 24 24 24 24 24 24 24 24 24 24 24 24 24 24 24 24 24 24 24 24 24 24 24 24 24 24 24 24 24 24 24
24 118 118 118 118 118 118 118 118 118 118 118 118 24 24 24 24 24 24 118 118 118 118 118 118 118 118 118 118 118 118 118 118 24 24 24 24 24 24 24 24 24 24 24 24 24 24 24 24 24 24 24 24 24 24 24 24 24 24 24 24 24 24 24
24 118 118 118 118 118 118 118 118 118 118 118 118 24 24 26 24 24 24 24 24 24 24 24 24 118 24 118 24 24 24 118 118 24 24 24 24 24 24 24 24 24 24 24 24 24 24 24 24 24 24 24 24 24 24 24 24 24 24 24 24 24 24 24
24 118 118 118 118 118 118 118 118 118 118 118 118 24 24 118 118 118 24 119 119 119 119 24 24 118 24 118 24 24 24 118 118 24 24 24 24 24 24 24 24 24 24 24 24 24 24 24 24 24 24 24 24 24 24 24 24 24 24 24 24 24 24 24
24 118 118 118 118 118 118 118 118 118 118 118 118 24 24 118 118 118 90 119 119 119 119 24 26 118 24 118 24 24 24 118 118 24 24 24 24 24 24 24 24 24 24 24 24 24 24 24 24 24 24 24 24 24 24 24 24 24 24 24 24 24 24 24
24 118 118 118 118 118 118 118 118 118 118 118 118 24 24 118 118 118 24 119 119 119 119 24 118 118 118 118 118 24 24 24 118 24 24 24 24 24 24 24 24 24 24 24 24 24 24 24 24 24 24 24 24 24 24 24 24 24 24 24 24 24 24 24
24 118 118 118 24 24 24 24 24 24 24 24 24 24 24 118 118 118 24 119 119 119 119 24 118 118 118 118 118 118 118 118 118 24 24 24 24 24 24 24 24 24 24 24 24 24 24 24 24 24 24 24 24 24 24 24 24 24 24 24 24 24 24 24
24 118 118 118 24 24 118 118 118 24 24 24 24 24 24 118 118 118 24 119 119 119 119 26 118 118 118 118 118 24 24 24 118 24 24 24 124 124 124 124 124 24 24 24 24 24 24 24 24 24 24 24 24 24 24 24 24 24 24 24 24 24 24 24
24 118 118 118 24 24 118 118 118 118 118 118 118 24 24 118 118 118 24 26 24 24 24 24 118 118 118 118 118 118 118 118 118 24 24 24 124 124 124 124 124 24 24 24 26 24 24 26 24 24 24 24 24 24 24 24 24 24 24 24 24 24 24 24
24 24 24 24 24 24 24 24 118 118 118 118 118 24 24 118 118 118 118 118 118 118 118 118 118 118 118 118 118 24 24 24 118 24 24 24 124 124 124 124 124 24 123 123 123 123 123 123 24 24 24 24 24 24 24 24 24 24 24 24 24 24 24 24
24 24 24 24 24 24 24 24 118 118 118 118 118 24 24 118 118 118 118 118 118 118 118 118 118 118 118 118 118 118 118 118 118 90 124 24 124 124 124 124 124 90 123 123 123 123 123 123 26 24 24 24 24 24 24 24 24 24 24 24 24 24 24 24
24 24 24 118 118 24 118 118 118 118 118 118 118 24 24 118 118 118 118 118 118 118 118 118 118 118 118 118 118 24 24 24 24 124 124 26 124 124 124 124 124 24 123 123 123 123 123 123 24 24 24 24 24 24 24 24 24 24 24 24 24 24 24 24
24 24 118 118 118 24 118 118 118 118 118 118 118 24 24 24 24 24 24 118 118 118 24 118 24 118 24 118 26 24 24 24 24 24 24 24 24 24 24 26 24 24 24 24 24 123 123 123 26 24 26 24 24 24 24 24 24 24 24 24 24 24 24 24
24 24 118 118 118 24 118 118 118 118 118 118 118 24 24 117 117 117 24 118 118 118 24 118 24 118 24 118 24 24 24 26 24 121 121 121 121 121 121 121 121 121 121 121 24 123 123 123 123 123 123 123 24 24 24 24 24 24 24 24 24 24 24 24
24 24 118 118 118 24 24 24 24 24 24 24 24 24 24 117 117 117 24 118 118 118 24 118 24 118 24 118 24 24 24 120 24 121 121 121 121 121 121 121 121 121 121 121 26 123 123 123 123 123 123 123 24 24 24 24 24 24 24 24 24 24 24 24
24 24 118 118 118 24 24 24 24 24 24 24 24 24 24 117 117 117 24 118 118 118 24 118 118 118 118 118 118 90 120 120 24 121 121 121 121 121 121 121 121 121 121 121 24 123 123 123 123 123 123 123 24 24 24 24 24 24 24 24 24 24 24 24
24 24 118 118 118 118 118 118 118 118 118 118 118 24 26 24 91 24 26 24 91 24 24 24 24 24 24 24 24 24 24 24 24 24 24 24 24 121 121 121 24 24 91 24 24 24 91 24 24 123 123 123 24 24 24 24 24 24 24 24 24 24 24 24
24 24 118 118 118 118 118 118 118 118 118 118 118 24 24 116 116 116 116 116 116 116 24 24 24 24 24 120 120 120 120 120 120 120 120 120 24 121 121 106 24 122 122 122 122 122 122 122 24 123 123 123 26 24 24 24 24 24 24 24 24 24 24 24
24 24 118 118 118 118 118 118 118 118 118 118 118 24 24 116 116 116 116 116 116 116 26 24 24 24 24 120 120 120 120 120 120 120 120 120 24 121 106 121 24 122 122 122 122 122 122 122 24 123 123 123 24 24 24 24 24 24 24 24 24 24 24 24
24 24 118 118 118 118 118 118 118 118 118 118 118 24 26 116 116 116 116 116 116 116 24 24 24 21 24 120 120 120 120 120 120 120 120 120 24 121 121 121 24 122 122 122 122 122 122 122 24 123 123 123 24 24 24 24 24 24 24 24 24 24 24 24
24 24 118 118 118 118 118 118 118 118 118 118 118 24 24 24 116 116 116 116 116 24 24 24 21 120 100 120 120 120 120 120 120 120 120 120 24 106 121 106 24 24 122 122 122 122 122 24 24 123 123 123 24 24 24 24 24 24 24 24 24 24 24 24
24 24 118 118 118 118 118 118 118 118 118 118 118 24 24 24 24 116 116 116 24 24 24 24 24 21 24 120 120 120 120 120 120 120 120 120 24 121 121 121 24 24 24 122 122 122 24 24 26 123 123 123 24 24 24 24 24 24 24 24 24 24 24 24
24 24 118 118 118 118 118 118 118 118 118 118 118 24 118 118 24 116 116 116 26 24 24 24 24 24 24 120 120 120 120 120 120 120 120 120 24 24 24 24 24 24 24 122 122 122 24 24 123 123 123 123 123 24 24 24 24 24 24 24 24 24 24 24
24 24 24 24 24 24 24 24 24 24 24 24 24 24 118 118 24 116 116 116 24 24 24 24 24 24 24 120 120 120 120 120 120 120 120 120 24 24 24 24 24 24 24 122 122 122 24 123 123 123 123 123 123 123 24 24 24 24 24 24 24 24 24 24
24 24 24 24 24 24 24 24 24 24 24 24 24 118 118 118 24 24 91 24 24 24 24 24 24 24 24 24 24 24 24 95 24 24 24 24 24 24 24 24 24 24 24 24 91 24 24 123 123 123 123 123 123 123 26 24 24 24 24 24 24 24 24 24
24 118 118 118 118 118 118 118 118 118 118 118 118 118 118 118 26 114 114 114 24 24 24 24 24 24 24 24 24 24 113 113 113 24 24 24 24 24 24 24 24 24 24 115 115 115 24 123 123 123 123 123 123 123 24 106 24 106 24 106 24 106 24 24
24 118 118 118 118 118 118 118 118 118 118 118 118 118 118 118 24 114 114 114 26 24 24 24 24 24 24 24 24 24 113 113 113 24 24 24 24 24 24 24 24 24 24 115 115 115 24 24 91 24 24 24 91 24 24 125 24 125 24 125 24 125 24 24
24 118 118 118 118 118 118 118 118 118 118 118 118 118 118 118 24 114 114 114 24 24 24 26 24 24 24 24 24 113 113 113 113 113 24 24 24 24 24 24 24 24 24 115 115 115 24 125 125 125 125 125 125 125 125 125 125 125 125 125 125 125 125 24
24 118 118 118 118 118 118 118 118 118 118 118 118 118 118 118 24 114 114 114 114 114 114 114 114 114 24 113 113 113 113 113 113 113 113 113 24 115 115 115 115 115 115 115 115 115 24 125 125 125 125 125 125 125 125 125 125 125 125 125 125 125 125 24
24 118 118 118 118 118 118 118 118 118 118 118 118 118 118 118 24 114 114 114 114 114 114 114 114 114 92 113 113 113 113 113 113 113 113 113 92 115 115 115 115 115 115 115 115 115 24 125 125 125 125 125 125 125 125 125 125 125 125 125 125 125 125 24
24 118 118 118 118 118 118 118 118 118 118 118 118 118 118 118 26 114 114 114 114 114 114 114 114 114 24 113 113 113 113 113 113 113 113 113 24 115 115 115 115 115 115 115 115 115 24 24 24 24 24 24 26 24 24 125 24 125 24 125 24 125 24 24
24 118 118 118 118 118 118 118 118 118 24 26 24 24 24 24 24 24 24 24 24 26 24 24 24 24 24 24 24 24 24 91 24 24 24 24 24 24 24 24 24 26 26 24 24 24 26 24 24 26 24 24 24 24 24 106 24 106 24 106 24 106 24 24
24 24 24 24 24 24 24 24 24 24 24 24 108 108 108 108 108 108 108 108 108 24 24 24 24 24 24 24 24 26 109 109 109 26 24 24 24 24 24 24 24 26 108 108 108 108 108 108 108 108 108 24 24 24 24 24 24 24 24 24 24 24 24 24
24 24 118 118 118 118 118 118 24 24 16 108 108 108 108 108 108 108 108 108 108 24 24 24 24 24 24 24 24 24 106 109 106 24 24 24 24 24 24 24 24 26 108 108 108 108 108 108 108 108 108 108 16 24 24 24 24 24 24 24 24 24 24 24
24 24 118 118 118 118 118 118 24 24 24 24 108 108 108 108 108 108 108 108 108 26 24 26 24 26 24 24 24 109 109 109 109 109 24 26 26 24 24 26 24 26 108 108 108 108 108 108 108 108 108 24 24 24 24 24 24 24 24 24 24 24 24 24
24 24 118 118 118 118 118 24 24 24 16 108 108 108 108 1 3 2 108 108 108 108 108 108 24 109 109 109 109 109 109 109 109 109 109 109 109 109 24 108 108 108 108 108 108 1 3 2 108 108 108 108 16 24 24 24 24 24 24 24 24 24 24 24
24 24 24 24 24 24 24 24 24 24 24 24 108 108 108 4 1 4 108 108 108 108 108 108 90 109 109 109 109 109 109 109 109 109 109 109 109 109 90 108 108 108 108 108 108 4 1 4 108 108 108 24 24 24 24 24 24 24 24 24 24 24 24 24
24 118 118 24 24 140 140 140 24 24 16 108 108 108 108 2 3 1 108 108 108 108 108 108 24 109 109 109 109 109 109 109 109 109 109 109 109 109 24 108 108 108 108 108 108 2 3 1 108 108 108 108 16 24 24 24 24 24 24 24 24 24 24 24
24 118 118 24 24 140 140 140 24 24 24 24 108 108 108 108 108 108 108 108 108 24 24 26 24 24 26 24 24 109 109 109 109 109 24 26 24 24 24 24 24 24 108 108 108 108 108 108 108 108 108 24 24 24 24 24 24 24 24 24 24 24 24 24
24 118 24 118 90 140 140 140 24 24 16 108 108 108 108 108 108 108 108 108 108 26 24 24 12 12 12 24 24 26 109 109 109 26 24 24 12 12 12 24 24 26 108 108 108 108 108 108 108 108 108 108 16 24 24 24 24 24 24 24 24 24 24 24
24 118 24 118 24 140 140 140 24 24 24 24 108 108 108 108 108 108 108 108 108 24 24 24 12 111 12 24 24 24 106 109 106 24 24 24 12 137 12 24 26 24 108 108 108 108 108 108 108 108 108 24 24 24 24 24 24 24 24 24 24 24 24 24
24 118 24 118 24 24 24 24 24 24 24 24 24 26 24 108 108 108 24 24 26 24 111 111 12 91 12 111 111 24 24 91 24 24 112 112 12 91 12 112 112 24 24 24 26 108 108 108 24 24 24 24 24 24 24 24 24 24 24 24 24 24 24 24
24 118 24 118 24 24 24 24 24 24 24 24 24 24 26 108 108 108 24 24 24 26 111 111 111 111 111 111 111 24 110 110 110 24 112 112 112 112 112 112 112 24 24 24 26 108 108 108 26 24 24 24 24 24 24 24 24 24 24 24 24 24 24 24
24 118 24 118 118 118 118 118 118 24 24 24 24 24 24 108 108 108 24 24 24 24 111 111 111 111 111 111 111 24 110 110 110 26 112 112 112 112 112 112 112 24 24 24 24 108 108 108 24 24 24 24 24 24 24 24 24 24 24 24 24 24 24 24
24 118 24 24 24 24 24 24 118 24 24 24 24 24 24 108 108 108 24 24 24 26 111 111 111 111 111 111 111 24 110 110 110 24 112 112 112 112 112 112 112 26 24 24 26 108 108 108 24 24 24 24 24 24 24 24 24 24 24 24 24 24 24 24
24 118 118 118 118 118 118 118 118 24 24 24 24 24 26 108 108 108 24 24 24 26 111 111 111 111 111 111 111 24 110 110 110 24 112 112 112 112 112 112 112 24 24 24 24 108 108 108 26 24 24 24 24 24 24 24 24 24 24 24 24 24 24 24
24 24 24 24 24 24 24 24 24 24 24 24 24 24 26 108 108 108 24 24 24 24 111 111 111 111 111 111 111 90 110 110 110 90 112 112 112 112 112 112 112 24 24 24 24 108 108 108 24 24 24 24 24 24 24 24 24 24 24 24 24 24 24 24
24 24 24 24 24 24 24 24 24 24 24 24 24 24 24 108 108 108 24 24 24 24 111 111 111 111 111 111 111 24 110 110 110 24 112 112 112 112 112 112 112 24 24 24 24 108 108 108 26 24 24 24 24 24 24 24 24 24 24 24 24 24 24 24
24 24 24 24 24 24 24 24 24 24 24 24 24 24 24 108 108 108 26 24 24 24 24 24 26 26 24 26 24 24 24 24 24 24 24 26 24 24 26 24 24 24 24 24 24 108 108 108 24 24 24 24 24 24 24 24 24 24 24 24 24 24 24 24
24 24 24 24 24 24 24 24 24 24 24 24 24 24 26 108 108 108 24 24 24 24 26 24 24 24 24 111 111 111 24 24 24 24 24 24 24 24 24 24 24 24 24 24 26 108 108 108 26 24 24 24 24 24 24 24 24 24 24 24 24 24 24 24
24 24 24 24 24 24 24 24 24 24 24 24 24 24 24 108 108 108 24 24 24 108 108 108 108 24 24 111 111 111 24 24 24 24 24 24 24 24 108 108 108 108 24 24 24 108 108 108 24 24 24 24 24 24 24 24 24 24 24 24 24 24 24 24
24 24 24 24 24 24 24 24 24 24 24 24 24 24 24 108 108 108 24 24 24 108 108 108 106 24 24 24 24 24 2 6 2 24 24 24 24 24 106 108 108 108 24 24 24 108 108 108 24 24 24 24 24 24 24 24 24 24 24 24 24 24 24 24
24 24 24 24 24 24 24 24 24 24 24 24 24 24 26 108 108 108 24 26 24 108 108 108 24 26 24 26 26 26 108 108 108 26 26 24 24 24 24 108 108 108 24 26 24 108 108 108 24 24 24 24 24 24 24 24 24 24 24 24 24 24 24 24
24 24 24 24 24 24 24 24 24 24 24 24 24 24 24 108 108 108 108 108 108 108 108 108 108 108 108 108 108 108 108 108 108 108 108 108 108 108 108 108 108 108 108 108 108 108 108 108 24 24 24 24 24 24 24 24 24 24 24 24 24 24 24 24
24 24 24 24 24 24 24 24 24 24 24 24 24 24 24 108 108 108 108 108 108 108 108 108 108 108 108 108 108 108 108 108 108 108 108 108 108 108 108 108 108 108 108 108 108 108 108 108 26 24 24 24 24 24 24 24 24 24 24 24 24 24 24 24
24 24 24 24 24 24 24 24 24 24 24 24 24 24 26 108 108 108 108 108 108 108 108 108 108 108 108 108 108 108 108 108 108 108 108 108 108 108 108 108 108 108 108 108 108 108 108 108 24 24 24 24 24 24 24 24 24 24 24 24 24 24 24 24
24 24 24 24 24 24 24 24 24 24 24 24 24 24 24 24 26 24 24 24 24 24 24 26 24 24 24 24 24 26 26 13 24 24 24 24 24 24 26 24 24 26 26 24 26 24 24 24 24 24 24 24 24 24 24 24 24 24 24 24 24 24 24 24
