24 24 24 24 24 24 24 24 24 24 24 24 24 24 24 24 24 26 24 24 24 24 26 24 24 24 24 24 24 24 24 24 24 24 24 24 24 24 24 24 24 24 24 24 24 24 24 24 24 24 24 24 24 24 24 24 24 24 24 24 24 24 24 24
24 24 24 24 24 24 24 24 24 24 24 24 24 141 90 119 119 119 119 119 119 119 119 24 24 24 24 24 24 24 24 24 24 24 120 120 120 24 121 121 121 24 121 121 121 24 24 24 1 2 1 2 1 1 2 1 1 1 1 2 24 24 24 24
24 24 24 24 24 24 24 26 24 24 117 117 26 24 26 119 119 119 119 119 119 119 119 26 24 24 24 24 24 24 24 24 24 24 120 120 120 90 121 121 121 121 121 121 121 24 24 21 1 115 115 115 115 115 115 115 115 115 115 115 16 24 24 24
24 24 24 24 24 117 117 117 117 117 117 117 117 117 24 119 119 119 119 119 119 119 119 24 24 24 24 24 24 24 24 24 24 24 106 120 120 24 121 121 121 121 121 121 121 24 21 115 100 115 115 115 115 115 115 115 115 115 115 1 24 24 24 24
24 24 24 24 24 117 117 117 117 117 117 117 117 117 90 119 119 119 15 15 119 119 119 24 24 24 24 24 24 24 24 24 24 24 120 120 120 24 24 121 121 121 121 121 24 24 24 21 1 115 115 115 115 115 115 115 115 115 115 115 16 24 24 24
24 24 24 24 24 117 117 117 117 117 117 117 117 117 24 119 119 119 119 119 119 119 119 26 24 24 24 24 24 24 24 24 24 24 120 120 120 26 121 121 121 121 121 121 121 24 24 24 1 2 115 115 1 2 1 115 115 115 1 2 24 24 24 24
24 24 24 24 26 117 117 117 26 24 117 117 26 24 24 119 119 119 119 119 119 119 119 24 24 24 24 24 24 24 24 24 24 24 120 120 120 24 121 121 121 121 121 121 121 26 24 24 24 1 115 115 2 24 12 12 93 12 12 24 24 24 24 24
24 24 24 24 24 117 117 117 24 24 24 24 24 119 90 119 119 119 119 119 119 119 119 24 24 24 26 24 24 24 26 26 24 24 120 120 120 26 121 121 121 26 121 121 121 24 24 24 24 1 115 115 2 24 12 114 114 114 12 24 24 24 24 24
24 24 24 24 24 117 117 117 24 24 24 24 24 24 24 24 24 24 24 24 26 119 119 119 24 120 120 120 120 120 120 120 120 120 120 120 120 24 24 91 24 24 24 91 24 24 24 24 24 2 115 115 2 24 12 106 114 114 12 24 24 24 24 24
24 24 24 24 24 117 117 117 24 24 24 24 24 24 24 24 24 24 24 24 26 119 119 119 90 120 120 120 120 120 120 120 120 120 120 120 120 24 24 121 24 24 24 121 24 24 24 24 24 1 115 115 1 24 12 114 114 114 12 24 24 24 24 24
24 24 24 24 26 117 117 117 26 24 24 24 24 24 24 24 24 24 24 24 24 119 119 119 24 120 120 120 120 120 120 120 120 120 120 120 120 26 24 24 24 24 24 24 24 24 24 24 24 2 1 2 1 24 12 114 106 114 12 24 24 24 24 24
24 24 24 24 26 117 117 117 24 24 24 24 24 24 24 121 121 121 121 24 24 24 91 24 24 24 26 24 24 24 24 26 24 24 24 24 24 24 26 24 24 24 24 24 24 24 24 24 24 24 24 24 24 24 12 114 114 114 12 24 24 24 24 24
24 24 24 24 24 117 117 117 24 24 24 24 24 24 121 121 121 121 121 121 24 121 121 121 24 24 24 24 24 24 24 24 24 24 24 24 24 110 110 110 24 24 24 24 24 24 24 24 24 24 24 24 24 24 12 106 114 114 12 24 24 24 24 24
24 24 24 24 24 117 117 117 24 24 24 24 24 24 121 121 121 121 121 121 26 121 121 121 26 24 24 24 24 24 24 24 24 24 24 24 24 110 110 110 24 12 12 12 12 12 12 12 12 12 12 12 12 12 12 114 114 114 12 24 24 24 24 24
24 24 24 24 24 117 117 117 24 24 24 24 24 24 121 121 121 121 121 121 24 121 121 121 24 109 109 109 24 24 24 24 24 24 26 26 24 110 110 110 110 10 114 114 114 114 114 114 114 114 114 114 114 114 114 114 114 114 12 24 24 24 24 24
24 24 24 24 24 117 117 117 24 24 24 24 24 24 24 121 121 121 121 121 24 121 121 121 26 109 24 109 26 24 24 110 110 110 110 110 110 110 110 110 110 94 114 114 114 114 114 114 114 114 114 114 114 114 114 114 114 114 11 24 24 24 24 24
24 24 24 24 26 117 117 117 24 24 24 24 24 24 24 24 26 24 121 121 24 121 121 121 24 109 24 109 24 141 26 110 106 24 110 26 24 110 110 110 110 10 114 114 114 114 114 114 114 114 114 114 114 114 114 114 114 114 12 24 24 24 24 24
24 24 24 24 24 117 117 117 24 24 24 24 24 24 24 24 24 24 24 24 24 24 24 24 24 91 24 91 24 91 24 24 24 24 110 24 24 110 110 110 24 12 12 12 12 12 12 12 12 12 12 12 12 12 12 12 11 12 12 24 24 24 24 24
24 24 24 24 24 117 117 117 24 24 24 24 24 24 26 24 24 24 24 24 24 24 24 26 108 108 108 108 108 108 108 26 24 24 110 24 24 110 110 110 26 24 24 24 24 24 24 24 24 24 24 24 24 24 24 24 24 24 24 24 24 24 24 24
24 24 24 24 26 117 117 117 26 24 24 24 24 108 108 108 108 108 108 108 24 24 24 24 108 108 108 108 108 108 108 90 110 110 110 26 24 26 24 24 24 24 24 24 24 24 24 24 24 24 24 24 26 24 24 24 24 24 24 24 24 24 24 24
24 24 24 24 24 117 117 117 24 24 24 24 24 108 108 108 108 108 108 108 26 24 24 26 108 108 108 108 108 108 108 24 24 24 24 24 24 24 24 24 24 24 24 24 24 24 24 24 24 24 26 108 108 108 24 24 24 24 24 24 24 24 24 24
24 24 24 24 24 24 91 24 24 24 24 24 26 108 108 108 108 108 108 108 24 24 24 24 108 108 108 108 108 108 108 90 111 111 111 24 24 24 24 24 24 24 24 24 24 24 24 24 24 24 24 108 108 108 26 24 24 24 24 24 24 24 24 24
24 24 24 24 24 108 108 108 24 24 24 24 24 108 108 108 108 108 108 108 24 24 24 24 108 108 108 108 108 108 108 26 24 24 111 24 24 24 24 24 24 24 24 24 24 24 24 24 24 26 26 108 108 108 24 26 24 24 24 24 24 24 24 24
24 24 24 24 24 108 108 108 24 24 24 24 24 108 108 108 108 108 108 108 108 108 108 108 108 108 108 108 108 108 108 90 108 24 111 24 24 24 24 24 24 24 24 24 24 24 24 24 108 108 108 108 108 108 108 108 108 24 24 24 24 24 24 24
24 24 24 24 26 108 108 108 24 26 24 26 24 24 24 24 24 24 24 108 108 108 108 108 108 108 108 108 108 108 108 24 24 24 111 24 24 24 24 24 24 24 24 24 24 24 24 24 108 108 108 108 108 108 108 108 108 24 24 24 24 24 24 24
24 24 24 24 24 108 108 108 108 108 108 108 26 24 24 24 24 24 24 108 108 108 108 108 108 108 24 24 24 24 24 26 24 24 111 24 24 24 24 24 24 24 24 24 24 26 24 26 108 108 108 108 108 108 108 108 108 24 26 24 24 24 24 24
24 24 24 24 24 108 108 108 108 108 108 108 24 24 24 24 24 24 24 108 108 108 108 108 108 108 24 111 111 111 24 24 24 24 111 24 24 24 24 24 24 24 24 24 24 108 108 108 108 108 108 24 24 24 108 108 108 108 108 108 24 24 24 24
24 24 24 24 24 24 24 26 24 26 24 24 24 24 24 26 26 24 24 108 108 108 108 108 108 108 26 111 111 111 111 111 111 111 111 24 24 24 24 24 24 24 24 24 24 108 108 108 108 108 108 24 24 24 108 108 108 108 108 108 24 24 24 24
24 24 24 24 24 24 24 24 24 24 24 108 108 90 108 108 108 108 108 108 108 108 108 108 108 108 24 111 111 111 24 24 24 24 24 24 24 24 24 24 24 24 24 24 26 108 108 108 108 108 108 24 24 26 108 108 108 108 108 108 26 24 24 24
24 24 24 24 24 24 24 24 24 24 24 24 24 24 24 108 108 108 108 108 108 108 108 108 108 108 24 24 24 24 24 24 24 24 24 24 24 24 24 24 24 24 108 108 108 108 108 108 24 24 24 24 24 24 24 24 24 108 108 108 24 24 24 24
24 24 24 24 24 24 24 24 24 24 24 24 24 24 108 108 108 108 108 108 108 24 24 24 24 26 24 24 24 24 24 24 26 24 24 24 24 26 24 24 26 24 108 108 108 108 108 108 24 24 24 108 108 108 108 108 26 108 108 108 108 108 108 24
24 24 24 24 24 24 24 24 24 24 24 24 24 13 108 108 108 108 108 108 108 108 108 108 108 108 108 108 108 108 108 108 108 108 108 108 108 108 108 108 108 108 108 108 108 108 108 108 26 24 108 108 108 108 108 108 24 108 108 108 108 108 108 26
24 24 24 24 24 24 24 24 24 24 24 24 24 24 108 108 108 108 108 108 108 24 24 24 26 24 24 24 24 26 26 24 24 26 24 24 24 26 24 24 24 24 108 108 108 108 108 108 24 24 108 108 108 108 108 108 24 108 108 108 108 108 108 24
24 24 24 24 24 24 24 24 24 24 24 24 24 24 24 108 108 108 108 108 108 108 108 108 108 108 24 24 24 24 24 24 24 24 24 24 24 24 24 24 24 24 108 108 108 108 108 108 24 24 24 24 24 24 26 24 24 108 108 108 26 24 24 24
24 24 24 24 24 24 24 24 24 24 24 24 108 90 108 108 108 108 108 108 108 108 108 108 108 108 26 24 24 24 24 24 24 24 24 24 24 24 24 24 24 24 24 24 24 108 108 108 108 108 108 26 24 24 108 108 108 108 108 108 24 24 24 24
24 24 24 24 24 24 24 24 24 24 24 26 24 24 24 24 24 24 24 108 108 108 108 108 108 108 24 24 24 24 24 24 24 24 24 24 24 24 24 24 24 24 24 24 26 108 108 108 108 108 108 24 24 24 108 108 108 108 108 108 26 24 24 24
24 24 24 24 24 108 108 108 108 108 108 108 108 108 108 108 24 24 24 108 108 108 108 108 108 108 24 24 24 24 24 24 24 24 24 24 24 24 24 24 24 24 24 24 24 108 108 108 108 108 108 24 24 24 108 108 108 108 108 108 24 24 24 24
24 24 24 24 24 108 108 108 108 108 108 108 108 108 108 108 24 24 24 108 108 108 108 108 108 108 24 26 24 26 24 24 24 24 24 24 24 24 24 24 24 24 24 24 24 24 24 24 108 108 108 108 108 108 108 108 108 24 24 24 24 24 24 24
24 24 24 24 24 108 108 108 24 24 24 26 24 24 24 24 24 24 24 108 108 108 108 108 108 108 108 108 108 108 108 24 24 24 24 24 24 24 24 24 24 24 24 24 24 24 24 26 108 108 108 108 108 108 108 108 108 26 24 24 24 24 24 24
24 24 24 24 24 108 108 108 24 118 118 118 118 24 24 108 108 108 108 108 108 108 108 108 108 108 108 108 108 108 108 90 108 17 24 24 24 24 24 24 24 24 24 24 24 24 24 24 108 108 108 108 108 108 108 108 108 26 24 24 24 24 24 24
24 24 24 24 24 108 108 108 24 118 118 118 118 24 26 108 108 108 108 108 24 26 24 24 108 108 108 108 108 108 108 24 24 24 24 24 24 24 24 24 24 24 24 24 24 24 24 24 24 24 24 108 108 108 24 24 26 24 24 24 24 24 24 24
24 24 24 24 24 24 91 24 24 24 24 24 24 24 24 108 108 108 108 108 24 24 24 24 108 108 108 108 108 108 108 90 114 114 114 24 26 24 24 24 24 24 24 24 24 24 24 24 24 24 24 108 108 108 26 24 24 24 24 24 24 24 24 24
24 24 24 24 26 118 118 118 118 118 24 24 24 24 24 108 108 108 108 108 26 24 24 24 108 108 108 108 108 108 108 24 24 114 114 114 114 114 114 114 24 24 24 24 24 24 24 24 24 24 26 108 108 108 24 24 24 24 24 24 24 24 24 24
24 24 24 24 118 118 118 118 118 118 118 24 24 24 26 108 108 108 108 108 24 24 24 24 108 108 108 108 108 108 108 90 114 114 114 24 24 24 24 114 24 24 24 24 24 24 24 24 24 24 24 24 26 24 24 24 24 24 24 24 24 24 24 24
24 24 24 24 24 118 118 17 118 118 24 24 24 24 24 24 24 26 24 24 24 24 24 26 108 108 108 108 108 108 108 24 24 24 26 24 24 24 26 114 26 24 24 24 24 24 24 24 24 24 24 24 24 24 24 24 24 24 24 24 24 24 24 24
24 24 24 24 118 118 118 118 118 118 118 24 24 24 24 24 24 24 24 24 24 24 24 24 24 91 24 91 24 91 24 26 24 24 24 24 24 24 26 114 24 24 24 24 24 24 24 24 24 24 24 24 24 24 24 24 24 24 24 24 24 24 24 24
24 24 24 24 24 118 118 118 118 118 26 24 24 24 24 24 24 24 24 26 24 24 24 24 24 113 24 112 24 113 24 24 24 24 24 24 24 24 24 114 24 24 24 24 24 24 24 24 24 24 24 24 24 24 24 24 24 24 24 24 24 24 24 24
24 24 24 24 24 24 118 24 118 24 24 24 24 24 24 24 113 113 24 24 26 24 113 113 24 113 24 24 24 113 24 24 24 24 24 24 24 24 114 114 114 24 24 24 24 24 24 24 24 24 24 24 24 24 24 24 24 24 24 24 24 24 24 24
24 24 24 24 24 24 24 24 24 24 24 24 24 24 24 24 113 113 113 113 113 113 113 113 26 113 113 113 113 113 24 24 24 24 24 24 114 114 114 114 114 114 114 24 24 24 24 24 24 24 24 24 24 24 24 24 24 24 24 24 24 24 24 24
24 24 24 24 24 24 24 24 24 24 24 24 24 24 24 24 113 113 113 113 113 113 113 113 24 24 24 113 24 24 24 24 24 24 24 24 24 24 114 114 114 24 24 24 24 24 24 24 24 24 24 24 24 24 24 24 24 24 24 24 24 24 24 24
24 24 24 24 24 24 24 24 24 24 24 24 24 24 24 24 113 113 113 113 113 113 113 113 24 24 24 113 24 2 2 1 2 2 1 2 1 1 2 91 2 1 2 2 1 2 1 2 1 1 24 24 24 24 24 24 24 24 24 24 24 24 24 24
24 24 24 24 24 24 24 24 24 24 24 24 24 24 24 26 113 113 113 113 113 113 113 113 26 24 24 113 26 2 116 116 116 1 116 116 116 116 116 116 116 116 116 116 116 1 116 116 116 2 24 24 24 24 24 24 24 24 24 24 24 24 24 24
24 24 24 24 24 24 24 24 24 24 24 24 24 24 24 24 113 113 113 113 113 113 113 113 24 24 24 113 24 1 116 116 116 2 116 116 116 116 116 116 116 116 116 116 116 2 116 116 116 2 24 24 24 24 24 24 24 24 24 24 24 24 24 24
24 24 24 24 24 24 24 24 24 24 24 24 24 24 24 24 113 113 113 113 113 113 113 113 24 24 24 113 24 2 116 116 116 90 116 116 116 116 116 116 116 116 116 116 116 90 116 116 116 2 24 24 24 24 24 24 24 24 24 24 24 24 24 24
24 24 24 24 24 24 24 24 24 24 24 24 24 24 24 24 113 113 113 113 113 113 113 113 24 24 24 113 24 2 2 1 2 1 116 116 116 116 116 116 116 116 116 116 116 1 1 1 2 1 2 2 2 2 24 24 24 24 24 24 24 24 24 24
24 24 24 24 24 24 24 24 24 24 24 24 24 24 24 24 26 24 26 24 24 24 24 24 24 24 24 113 24 2 116 116 116 1 116 116 116 116 116 116 116 116 116 116 116 1 116 116 116 1 116 116 116 1 24 24 24 24 24 24 24 24 24 24
24 24 24 24 24 24 24 24 24 24 24 24 24 24 24 24 24 143 24 24 106 113 113 24 24 24 24 113 24 1 116 116 116 90 116 116 116 116 116 116 116 116 116 116 116 90 116 116 116 2 116 116 116 1 24 24 24 24 24 24 24 24 24 24
24 24 24 24 24 24 24 24 24 24 24 24 24 24 24 24 143 143 143 24 24 24 113 113 24 24 24 113 24 2 116 116 116 2 116 116 116 116 116 116 116 116 116 116 116 2 116 116 116 2 116 116 2 1 24 24 24 24 24 24 24 24 24 24
24 24 24 24 24 24 24 24 24 24 24 24 24 24 24 143 143 143 143 143 24 24 113 113 113 24 24 113 26 1 2 1 2 1 116 116 116 116 116 116 116 116 116 116 116 1 2 1 2 1 2 2 1 2 24 24 24 24 24 24 24 24 24 24
24 24 24 24 24 24 24 24 24 24 24 24 24 24 143 143 143 143 143 143 143 90 113 113 113 113 113 113 24 1 116 116 116 90 116 116 116 116 116 116 116 116 116 116 116 90 116 116 116 1 24 24 24 24 24 24 24 24 24 24 24 24 24 24
24 24 24 24 24 24 24 24 24 24 24 24 24 24 24 143 143 143 143 143 24 24 113 113 113 26 24 24 24 1 116 116 116 2 116 116 116 116 116 116 116 116 116 116 116 2 116 116 116 2 24 24 24 24 24 24 24 24 24 24 24 24 24 24
24 24 24 24 24 24 24 24 24 24 24 24 24 24 24 24 143 143 143 24 24 24 113 113 24 24 24 24 24 2 116 116 116 1 116 116 116 116 116 116 116 116 116 116 116 1 116 116 116 2 24 24 24 24 24 24 24 24 24 24 24 24 24 24
24 24 24 24 24 24 24 24 24 24 24 24 24 24 24 24 24 143 24 24 106 113 113 24 24 24 24 24 24 1 2 1 2 2 1 1 116 1 2 116 2 1 116 1 1 2 2 1 2 1 24 24 24 24 24 24 24 24 24 24 24 24 24 24
24 24 24 24 24 24 24 24 24 24 24 24 24 24 24 24 24 24 24 24 24 24 24 24 24 24 24 24 24 24 24 24 24 24 24 2 2 2 2 2 2 2 2 2 2 2 2 2 2 2 24 24 24 24 24 24 24 24 24 24 24 24 24 24
