17 17 17 17 17 17 17 17 17 17 17 17 17 17 17 17 17 17 17 17 17 17 20 17 17 17 17 17 17 24 24 24 24 26 26 24 24 26 26 26 24 24 26 24 24 24 24 24 24 24 26 26 26 26 24 24 24 24 26 24 24 24 24 24
17 112 112 112 17 17 17 17 17 17 17 17 17 17 17 17 17 17 17 17 17 106 132 106 17 17 17 17 17 24 108 108 108 108 108 108 108 108 108 108 108 108 108 108 108 108 108 108 108 108 108 108 108 108 108 108 108 108 108 108 108 108 26 24
17 112 112 112 18 132 132 132 132 132 132 132 132 132 132 132 132 132 132 132 132 132 132 132 132 132 17 17 17 24 108 108 108 108 108 108 108 108 108 108 108 108 108 108 108 108 108 108 108 108 108 108 108 108 108 108 108 108 108 108 108 108 13 24
20 112 112 112 90 132 132 132 132 132 132 132 132 132 132 132 132 132 132 132 132 132 132 132 132 132 132 17 17 24 108 108 108 108 108 108 108 108 108 108 108 108 108 108 108 108 108 108 108 108 108 108 108 108 108 108 108 108 108 108 108 108 24 24
17 112 112 112 18 132 132 132 132 132 132 132 132 132 132 132 132 132 132 132 132 132 132 132 132 132 17 17 17 24 108 108 108 24 24 24 26 24 24 91 24 24 24 24 24 26 24 91 24 24 24 24 24 24 24 91 24 26 24 24 24 24 26 24
17 112 112 112 17 17 17 17 17 17 17 17 17 17 17 17 17 17 17 17 17 106 132 106 17 17 17 17 17 24 108 108 108 24 125 125 125 125 125 125 24 24 24 24 24 24 126 126 126 24 24 24 24 24 127 127 127 24 24 24 24 24 24 24
17 112 112 112 17 132 132 132 132 132 132 17 17 17 17 17 17 17 17 17 17 17 20 17 17 17 17 17 17 24 108 108 108 90 125 125 125 125 125 125 24 24 24 24 24 24 126 126 126 24 24 24 24 24 127 127 127 24 24 24 24 24 24 24
17 112 112 112 17 132 132 132 132 132 132 17 17 17 17 17 17 17 17 17 17 17 17 17 17 17 17 17 17 24 108 108 108 24 125 125 125 125 125 125 24 24 24 24 106 126 126 126 126 126 106 24 24 26 127 127 127 26 24 24 24 24 24 24
17 112 112 112 17 132 132 132 132 132 17 17 17 17 17 17 17 17 17 17 17 17 17 17 17 17 17 17 17 24 108 108 108 24 125 125 125 125 125 125 24 24 24 24 24 24 126 126 126 24 24 24 24 24 127 127 127 24 24 24 24 24 24 24
17 112 112 112 17 132 132 132 132 17 17 17 17 17 17 17 17 17 17 17 17 17 17 17 17 17 17 17 17 26 108 108 108 26 125 125 125 125 125 125 24 24 24 24 24 24 126 126 126 24 24 24 24 24 127 127 127 24 24 24 24 24 24 24
17 112 112 112 17 17 17 17 17 17 17 17 17 17 17 17 17 17 17 17 17 17 17 17 17 17 17 17 17 26 108 108 108 3 125 125 125 125 125 125 26 24 24 24 24 24 26 3 26 24 24 24 24 24 24 91 24 26 24 24 24 24 24 24
17 112 112 112 90 131 131 131 131 131 131 17 17 17 17 17 17 17 17 17 17 17 17 17 17 17 17 17 17 24 108 108 108 26 125 125 125 125 125 125 24 24 24 24 24 24 24 24 24 24 24 24 133 133 133 133 133 133 133 24 24 24 24 24
17 112 112 112 17 131 131 131 131 131 131 17 17 17 17 17 17 17 17 17 17 17 17 17 17 17 17 17 17 24 108 108 108 24 125 125 125 125 125 125 24 24 24 24 24 24 24 24 24 24 26 133 133 133 133 133 133 133 133 133 24 24 24 24
17 112 112 112 17 131 131 15 15 131 131 17 17 17 17 17 17 17 17 17 17 17 17 17 17 17 17 17 17 24 108 108 108 24 125 125 125 125 125 125 24 24 24 24 24 24 24 24 24 24 133 133 133 133 133 133 133 133 133 133 133 24 24 24
17 112 112 112 17 131 131 15 15 106 131 17 17 17 17 17 17 17 17 17 17 17 17 17 17 17 17 17 17 26 108 108 108 90 125 125 125 125 125 125 26 24 24 24 24 24 24 24 24 133 133 133 133 133 133 133 133 133 133 133 133 133 26 24
17 112 112 112 17 131 131 131 106 131 131 17 17 17 17 17 17 17 17 17 17 17 17 17 17 17 17 17 17 24 108 108 108 24 24 125 24 24 125 24 24 24 24 24 24 24 24 24 133 133 133 133 133 133 133 133 133 133 133 133 133 133 133 24
17 112 112 112 17 131 131 131 131 131 131 17 17 17 17 17 17 17 17 17 17 17 17 17 17 17 17 17 17 24 108 108 108 24 24 125 24 24 125 24 24 24 24 24 24 24 24 24 26 24 26 24 24 26 24 133 24 26 24 24 24 26 24 24
17 112 112 112 17 17 17 17 17 17 17 17 17 17 17 17 17 17 17 20 17 17 17 20 17 17 17 17 17 26 108 108 108 24 24 24 24 24 24 24 24 24 24 24 24 24 24 24 24 24 24 24 24 19 133 133 133 19 24 24 24 24 24 24
17 112 112 112 17 130 130 130 130 130 130 17 17 17 17 17 17 128 128 128 128 106 128 128 128 128 17 17 17 24 108 108 108 24 24 24 24 24 24 24 24 24 24 24 24 24 24 24 24 24 24 24 24 19 19 19 19 19 24 24 24 24 24 24
17 112 112 112 90 130 130 130 130 130 130 17 17 17 17 17 128 106 128 128 128 15 128 128 128 106 128 17 17 24 108 108 108 24 24 26 24 24 26 24 24 26 24 24 24 24 24 24 24 24 24 24 24 24 24 24 24 24 24 24 24 24 24 24
17 112 112 112 17 130 130 130 130 130 130 17 17 17 17 128 128 15 128 128 128 128 128 128 128 15 128 128 17 26 108 108 108 24 124 124 124 124 124 124 124 124 124 24 24 24 24 24 24 24 24 24 24 24 24 24 24 24 24 24 24 24 24 24
17 112 112 112 17 17 17 17 130 130 130 17 17 17 20 128 128 128 128 128 128 128 128 128 128 128 128 128 20 24 108 108 108 90 124 124 124 124 124 124 124 124 124 24 24 24 24 24 24 24 24 24 24 24 24 24 24 24 24 24 24 24 24 24
17 112 112 112 17 130 130 17 130 130 130 17 17 17 17 128 128 128 128 128 128 128 128 128 128 128 128 128 17 24 108 108 108 24 124 124 124 124 124 124 124 124 124 24 24 24 24 24 24 24 24 24 24 24 24 24 24 24 24 24 24 24 24 24
17 112 112 112 20 130 130 90 130 130 130 18 17 17 17 128 15 128 128 128 128 15 128 128 128 128 15 128 17 24 108 108 108 90 124 124 124 124 124 124 124 124 124 24 24 24 24 24 24 24 24 24 24 24 24 8 8 8 8 8 8 8 8 24
17 112 112 112 17 106 130 17 130 130 130 17 17 17 17 128 128 128 128 128 128 128 128 128 128 128 128 128 17 26 108 108 108 24 124 124 124 124 124 124 124 124 124 24 24 24 24 24 24 24 24 24 24 24 24 8 110 110 110 110 8 110 8 24
17 112 112 112 17 17 17 17 130 130 130 17 17 17 20 128 128 128 128 128 128 128 128 128 128 128 128 128 20 24 108 108 108 24 24 26 24 24 26 24 24 26 24 24 24 24 24 24 24 24 24 24 24 24 24 8 110 110 110 110 110 110 8 24
17 112 112 112 17 130 130 130 130 130 130 17 17 17 17 128 128 15 128 128 128 128 128 128 128 15 128 128 17 24 108 108 108 26 24 24 24 24 24 24 24 24 24 24 24 24 24 24 24 24 24 24 24 24 24 8 110 110 110 110 110 8 8 8
17 112 112 112 90 130 130 130 130 130 130 17 17 17 17 17 128 128 128 128 128 15 128 128 128 128 128 17 17 26 108 108 108 26 24 24 24 24 24 24 24 24 24 24 24 24 24 24 24 24 24 24 24 24 24 8 8 8 8 8 8 106 9 8
17 112 112 112 17 130 130 130 130 130 130 17 17 129 17 17 17 128 128 128 128 128 128 128 128 128 17 17 17 24 24 91 24 24 24 24 24 24 24 24 24 24 24 24 24 24 24 24 24 24 24 24 24 24 24 24 24 24 24 24 9 110 8 8
17 112 112 112 17 17 17 17 17 17 17 17 17 91 17 17 17 17 17 17 17 91 17 17 17 17 17 17 17 3 109 109 109 3 8 8 8 8 8 9 9 9 9 9 8 8 8 9 9 8 8 8 9 8 8 8 8 9 8 8 8 106 9 8
17 112 112 112 112 112 112 112 112 112 112 112 112 112 112 112 112 112 112 112 112 112 112 112 112 112 112 112 18 109 109 109 109 109 8 110 110 110 110 110 110 110 110 110 110 110 110 110 110 110 110 110 110 110 110 110 110 110 110 110 110 110 110 9
17 112 112 112 112 112 112 112 112 112 112 112 112 112 112 112 112 112 112 112 112 112 112 112 112 112 112 112 90 109 109 109 109 109 90 110 110 110 110 110 110 110 110 110 110 110 110 110 110 110 110 110 110 110 110 110 110 110 110 110 110 110 110 8
17 112 112 112 112 112 112 112 112 112 112 112 112 112 112 112 112 112 112 112 112 112 112 112 112 112 112 112 18 109 109 109 109 109 9 110 110 110 110 110 110 110 110 110 110 110 110 110 110 110 110 110 110 110 110 110 110 110 110 110 110 110 110 8
17 17 17 17 17 17 17 17 17 17 17 17 17 17 17 17 17 17 17 17 17 17 17 17 17 17 17 17 17 3 109 109 109 3 8 8 9 8 8 9 8 91 8 8 9 9 9 9 8 91 8 8 9 8 9 9 8 91 8 8 110 110 110 8
12 12 12 12 12 12 12 12 12 12 12 12 12 12 12 12 12 12 12 12 12 12 12 12 12 12 12 12 12 12 10 95 10 12 8 8 8 8 8 8 120 120 120 120 120 120 120 120 120 120 120 9 8 8 8 8 121 121 121 8 110 110 110 8
12 12 12 12 12 12 12 12 12 12 12 12 12 12 12 12 12 12 12 12 12 12 12 12 12 12 12 12 12 12 111 111 111 12 8 8 8 9 120 120 120 120 120 120 120 120 120 120 120 120 120 120 120 8 8 5 121 121 121 9 110 110 110 8
12 12 12 12 12 12 12 12 12 12 12 12 12 12 12 12 12 12 12 12 12 12 12 12 12 12 12 12 12 12 111 111 111 12 8 8 8 8 120 120 120 120 120 120 120 120 120 120 120 120 120 120 120 9 8 8 121 121 121 9 110 110 110 9
12 12 12 12 12 12 12 12 12 12 12 12 12 12 12 12 12 12 12 12 12 12 12 12 12 12 12 12 12 11 111 111 111 11 8 8 8 8 9 8 120 120 120 120 120 120 120 120 120 120 120 8 8 8 8 5 121 121 121 9 110 110 110 9
12 12 12 12 12 12 12 12 12 12 12 12 12 12 12 12 12 12 12 12 12 12 12 12 12 12 12 12 12 12 111 111 111 12 8 8 8 8 8 8 120 120 120 120 120 120 120 120 120 120 120 9 8 8 8 8 121 121 121 8 110 110 110 8
12 12 12 12 12 12 12 12 12 12 12 12 12 12 12 12 12 12 12 12 12 12 12 12 12 12 12 12 12 12 111 111 111 12 8 8 8 8 8 9 120 120 120 120 120 120 120 120 120 120 120 8 8 8 8 7 121 121 121 90 110 110 110 8
12 12 12 12 12 12 12 12 12 12 12 12 12 12 12 12 12 12 12 12 12 12 12 12 12 12 119 119 119 12 111 111 111 12 8 8 8 8 8 8 120 120 120 120 120 120 120 120 120 120 120 9 8 8 8 8 8 5 8 8 110 110 110 8
12 12 12 12 12 12 12 12 12 12 12 12 12 12 12 12 12 12 12 12 12 12 12 12 12 12 119 119 119 90 111 111 111 12 8 8 8 8 8 9 120 120 120 120 120 120 120 120 120 120 120 8 8 8 8 8 8 8 8 9 110 110 110 9
12 12 12 12 12 12 12 12 12 12 12 12 12 12 12 12 12 12 12 12 12 12 12 12 12 12 119 119 119 12 111 111 111 12 8 8 8 8 8 8 8 8 8 9 8 8 8 9 9 9 8 8 8 8 8 8 8 8 8 9 110 110 110 9
12 12 12 12 12 12 12 12 12 12 12 12 12 12 12 12 12 12 12 12 12 12 12 12 12 12 12 12 12 12 111 111 111 12 8 8 8 8 8 8 8 8 8 8 8 8 8 8 8 8 8 8 8 8 8 8 8 8 8 8 110 110 110 8
12 12 12 12 12 12 12 12 12 12 12 12 12 12 12 12 12 12 12 12 12 12 12 12 12 12 12 12 12 12 111 111 111 12 8 8 8 8 8 8 8 8 8 8 8 8 122 8 122 9 122 8 122 8 122 9 122 8 122 9 110 110 110 8
12 12 12 12 12 12 12 12 12 12 12 12 12 12 12 12 12 12 12 12 12 12 12 12 12 12 12 12 12 23 111 111 111 23 8 8 8 8 8 8 8 8 8 8 8 122 122 122 122 122 122 122 122 122 122 122 122 122 122 8 110 110 110 8
12 12 12 12 12 12 12 12 12 12 12 12 12 12 12 12 12 12 12 12 12 12 12 12 12 12 12 12 12 12 111 111 111 12 8 8 8 8 8 8 8 8 8 8 8 8 122 122 122 122 122 122 122 122 122 122 122 122 122 8 110 110 110 8
12 12 12 12 12 12 12 12 12 12 12 12 12 12 12 12 12 12 12 12 12 12 12 12 118 118 12 118 118 12 111 111 111 12 8 8 8 8 8 8 8 8 122 122 8 122 122 122 122 122 122 122 122 122 122 122 122 122 122 90 110 110 110 8
12 12 12 12 12 12 12 12 12 12 12 12 12 12 12 12 12 114 114 114 12 12 12 12 118 118 118 118 118 12 111 111 111 12 8 8 8 8 8 8 8 9 122 122 8 8 122 122 122 122 122 122 122 122 122 122 122 122 122 8 110 110 110 9
12 12 12 12 12 12 12 12 12 12 12 12 12 12 12 12 114 114 114 114 12 12 12 12 12 118 118 118 118 90 111 111 111 12 8 8 8 8 8 8 8 9 122 122 8 122 122 122 122 122 122 122 122 122 122 122 122 122 122 9 110 110 110 8
12 12 12 12 12 12 12 12 12 12 114 114 114 114 114 114 114 114 114 114 11 21 12 12 118 118 118 118 118 12 111 111 111 12 8 8 8 8 8 8 8 9 122 122 8 8 122 8 122 9 122 9 122 9 122 8 122 8 122 8 110 110 110 8
12 12 12 12 12 12 12 12 12 23 114 114 114 114 114 114 114 114 114 114 100 114 21 12 118 118 12 118 118 12 111 111 111 12 8 8 8 8 8 8 8 9 122 122 9 8 8 8 8 8 8 8 8 8 8 8 8 8 8 8 110 110 110 8
12 12 12 12 23 12 12 12 12 12 114 114 114 114 114 114 114 114 114 114 11 21 12 12 12 12 12 12 12 12 111 111 111 12 8 8 8 8 8 8 8 8 122 122 8 8 8 8 9 5 8 8 8 8 8 8 8 8 8 9 110 110 110 8
12 12 12 116 116 116 12 12 12 12 10 93 10 12 12 12 114 114 114 114 12 12 12 12 12 117 12 117 12 11 111 111 111 11 8 8 8 8 8 8 9 122 122 122 8 8 8 8 123 123 123 8 8 8 8 8 9 123 123 8 110 110 110 9
12 12 116 116 116 116 116 12 12 12 113 113 113 12 12 12 12 114 114 114 12 12 12 12 117 117 117 117 117 12 111 111 111 12 8 8 8 8 8 9 122 122 122 122 8 8 9 123 123 123 123 123 9 8 8 8 123 123 123 90 110 110 110 9
12 116 116 116 116 116 116 116 12 113 113 113 113 113 12 12 12 12 12 12 12 12 12 12 117 117 117 117 117 12 111 111 111 12 8 8 8 8 122 122 122 122 122 122 9 8 8 123 123 123 123 123 123 123 123 123 123 123 123 8 110 110 110 9
12 12 116 116 116 116 116 12 23 113 113 113 113 113 23 115 115 12 115 115 115 12 12 12 117 117 117 117 117 12 111 111 111 12 8 8 8 122 122 122 122 122 122 122 8 8 9 123 123 123 123 123 8 8 9 9 123 123 123 90 110 110 110 8
12 12 116 116 116 116 116 12 12 113 113 113 113 113 12 115 115 10 115 115 115 10 12 12 117 117 117 117 117 90 111 111 111 12 8 9 8 122 122 122 122 122 122 8 8 8 8 8 123 123 123 8 8 8 9 8 9 123 123 9 110 110 110 8
12 12 12 116 116 116 12 12 12 12 113 113 113 12 12 12 12 12 115 115 115 12 12 12 117 117 117 117 117 12 111 111 111 12 8 9 122 122 122 122 122 122 122 8 8 8 8 8 8 5 9 8 9 142 142 8 8 9 8 8 110 110 110 9
12 12 12 12 91 12 12 12 12 12 12 91 12 12 12 12 12 12 12 91 12 12 12 12 12 12 12 91 12 12 111 111 111 12 9 122 122 122 122 122 122 122 122 9 8 8 8 8 8 8 8 5 142 142 142 142 142 142 142 90 110 110 110 8
12 111 111 111 111 111 111 111 111 111 111 111 111 111 111 111 111 111 111 111 111 111 111 111 111 111 111 111 111 111 111 111 111 12 8 122 122 122 122 122 122 122 8 8 8 8 8 8 8 8 8 8 142 142 142 142 142 142 142 9 110 110 110 8
12 111 111 111 111 111 111 111 111 111 111 111 111 111 111 111 111 111 111 111 111 111 111 111 111 111 111 111 111 111 111 111 111 12 8 122 122 122 122 122 122 122 8 8 8 8 8 8 8 8 8 5 142 142 142 142 142 142 142 90 110 110 110 9
12 111 111 111 111 111 111 111 111 111 111 111 111 111 111 111 111 111 111 111 111 111 111 111 111 111 111 111 111 111 111 111 111 12 8 8 122 122 122 122 122 8 8 8 8 8 8 8 8 8 8 8 9 142 142 8 8 9 8 8 9 110 8 9
12 12 12 10 12 12 12 12 12 12 12 23 12 12 12 12 12 12 12 10 12 12 12 12 12 12 12 23 12 12 12 12 12 12 8 8 8 8 8 8 8 8 8 8 8 8 8 8 8 8 8 8 8 8 9 8 8 8 8 8 8 8 8 8
