8 8 8 8 8 8 8 8 8 8 8 8 8 8 8 9 8 8 8 8 8 8 8 8 8 8 8 19 19 19 19 19 19 19 19 19 19 19 19 19 19 19 19 19 19 19 19 19 19 19 19 19 19 19 19 19 19 19 19 19 19 19 19 19
8 8 8 8 8 8 8 8 8 8 8 8 8 8 141 141 141 9 8 8 8 8 8 8 8 8 8 19 19 19 19 19 19 19 19 19 19 19 19 19 19 19 19 19 19 19 19 19 19 19 19 19 19 19 19 19 19 19 19 19 19 19 19 19
8 8 8 8 8 8 8 8 8 8 8 8 8 9 141 141 141 8 8 8 8 8 8 8 8 8 8 19 19 19 19 19 19 19 19 19 19 19 19 19 19 19 19 19 19 19 19 19 19 19 19 19 19 19 19 19 19 19 19 19 19 19 19 19
8 8 8 8 8 8 8 8 8 8 8 8 8 8 141 141 141 8 8 8 8 8 8 8 8 8 8 19 19 19 19 19 19 19 1 1 1 1 1 1 1 1 1 19 19 19 19 19 19 19 19 19 19 19 19 19 19 19 19 19 19 19 19 19
8 8 8 8 8 8 8 8 8 8 8 8 8 9 141 141 141 9 8 8 8 8 8 8 8 8 8 19 19 19 19 19 19 19 1 1 1 1 1 1 1 1 1 19 19 19 19 19 19 19 19 19 19 19 19 19 19 19 19 19 19 19 19 19
8 8 8 8 8 8 8 8 8 8 8 8 8 8 141 141 141 8 8 8 8 8 8 8 8 8 8 19 19 19 19 19 19 19 1 1 1 1 1 1 1 1 1 19 19 19 19 19 19 19 19 19 19 19 19 19 19 19 19 19 19 19 19 19
8 8 8 8 8 8 8 8 8 8 8 8 8 8 141 141 141 9 8 8 8 8 8 8 8 8 8 19 19 19 19 19 19 19 1 1 1 1 1 1 1 1 1 19 19 19 19 19 19 19 19 19 19 19 19 19 19 19 19 19 19 19 19 19
8 8 8 8 8 8 8 8 8 8 8 8 8 12 12 101 12 12 8 8 8 8 8 8 8 8 8 19 19 19 19 19 19 19 1 1 1 1 1 1 1 1 1 19 19 19 19 19 19 19 19 19 19 19 19 19 19 19 19 19 19 19 19 19
8 8 8 8 8 8 8 8 8 8 8 8 21 12 142 142 142 12 8 8 8 8 8 8 8 8 8 19 19 19 19 19 19 19 1 1 1 1 6 1 1 1 1 19 19 19 19 19 19 19 19 19 19 19 19 19 19 19 19 19 19 19 19 19
8 8 8 8 8 8 8 8 8 8 8 21 142 100 142 142 142 12 8 8 8 8 8 8 8 8 8 19 19 19 19 19 19 19 1 1 1 119 119 119 1 1 1 19 19 19 19 19 19 19 19 19 19 19 19 19 19 19 19 19 19 19 19 19
8 8 8 8 8 8 8 8 8 8 8 8 21 12 142 142 142 12 8 8 8 8 8 8 8 8 8 19 19 19 19 19 19 19 1 1 2 119 119 119 2 1 1 19 19 19 19 19 19 19 19 19 19 19 19 19 19 19 19 19 19 19 19 19
8 8 8 8 8 8 8 8 8 8 8 8 8 12 12 91 12 12 8 8 8 8 8 8 8 8 8 19 19 1 1 1 1 1 1 1 1 119 119 119 1 1 1 1 1 1 1 1 19 19 19 19 19 19 19 19 19 19 19 19 19 19 19 19
8 8 8 8 8 8 8 8 8 8 8 8 9 12 143 143 143 12 8 8 8 8 8 8 8 8 8 19 19 1 1 1 1 1 1 2 1 1 91 1 1 1 1 1 1 1 1 1 19 19 19 19 19 19 19 19 19 19 19 19 19 19 19 19
8 8 8 8 8 8 8 8 8 8 8 8 8 12 143 143 143 12 8 8 8 8 8 8 8 8 8 19 19 1 1 1 1 1 2 1 119 119 119 119 119 1 2 1 1 1 1 1 19 19 19 19 19 19 19 19 19 19 19 19 19 19 19 19
8 8 8 8 8 8 8 8 8 8 8 8 8 12 143 143 143 12 8 8 8 8 8 8 8 8 8 19 19 1 1 1 1 1 119 119 119 119 119 119 119 119 119 1 1 1 1 1 19 19 19 19 19 19 19 19 19 19 19 19 19 19 19 19
8 8 8 8 8 8 8 8 8 8 8 8 8 12 143 143 143 12 8 8 8 8 8 8 8 8 8 19 19 1 1 1 1 119 119 119 119 119 119 119 119 119 119 119 1 1 1 1 19 19 19 19 19 19 19 19 19 19 19 19 19 19 19 19
8 8 8 8 8 8 8 8 8 8 8 8 9 12 143 143 143 12 9 8 8 8 8 8 8 8 8 19 19 1 1 2 119 119 119 119 119 119 119 119 119 119 119 119 119 2 1 1 19 19 19 19 19 19 19 19 19 19 19 19 19 19 19 19
8 8 8 8 8 8 8 8 8 8 8 8 8 12 143 143 143 12 8 8 8 8 8 8 8 8 8 19 19 1 1 1 119 119 119 119 119 119 119 119 119 119 119 119 119 1 2 1 19 19 19 19 19 19 19 19 19 19 19 19 19 19 19 19
8 8 8 8 8 8 8 8 8 8 8 8 8 12 12 93 12 12 8 8 8 8 8 8 8 8 1 1 1 1 2 119 119 119 119 119 119 119 119 119 119 119 119 119 119 119 1 1 1 1 2 1 19 19 19 19 19 19 19 19 19 19 19 19
8 8 8 8 8 8 8 8 8 9 8 8 9 8 112 112 112 8 9 8 8 8 8 8 8 8 1 119 119 119 1 119 119 119 119 119 119 119 106 119 119 119 119 119 119 119 2 119 119 119 1 1 19 19 19 19 19 19 19 19 19 19 19 19
8 8 8 8 8 8 8 9 112 112 112 8 112 112 112 112 112 112 112 9 112 112 112 8 8 8 6 119 119 119 90 119 119 119 119 119 119 119 119 119 119 119 119 119 119 119 90 119 119 119 6 1 19 19 19 19 19 19 19 19 19 19 19 19
8 8 8 8 8 8 8 8 112 112 112 112 112 112 112 112 112 112 112 112 112 112 112 8 8 8 1 119 119 119 1 119 119 119 119 119 119 119 119 119 119 119 119 119 119 119 1 119 119 119 1 1 19 19 19 19 19 19 19 19 19 19 19 19
8 8 8 8 8 8 8 8 106 112 112 112 112 112 112 112 112 112 112 112 112 112 106 9 8 8 1 1 1 2 2 119 119 119 119 119 119 119 119 119 119 119 119 119 119 119 2 1 2 1 1 1 19 19 19 19 19 19 19 19 19 19 19 19
8 8 8 8 8 8 8 8 8 112 106 8 112 112 112 112 112 112 112 8 106 112 8 8 8 8 8 19 19 1 1 2 119 119 119 119 119 119 119 119 119 119 119 119 119 1 1 1 19 19 19 19 19 121 121 121 121 121 19 19 19 19 19 19
8 8 8 8 8 8 8 9 112 112 112 112 112 112 112 112 112 112 112 112 112 112 112 9 8 8 8 19 19 1 1 1 119 119 119 119 119 119 119 119 119 119 119 119 119 1 1 1 19 19 19 19 121 121 121 121 121 121 121 19 19 19 19 19
8 8 8 8 9 8 8 9 112 112 112 112 112 112 112 112 112 112 112 112 112 112 112 8 8 8 8 19 19 1 1 1 2 119 119 119 119 119 119 119 119 119 119 119 2 1 1 1 19 19 19 19 121 121 121 121 121 121 121 19 19 19 19 19
8 8 8 111 111 111 9 8 112 112 106 8 112 112 112 112 112 112 112 8 106 112 112 9 8 8 8 19 19 1 1 1 1 1 119 119 119 119 119 119 119 119 119 1 1 1 1 1 19 19 19 19 121 121 121 121 121 121 121 19 19 19 19 19
8 8 9 111 111 111 8 8 8 9 8 9 9 9 8 91 8 9 9 9 8 8 9 8 8 9 8 19 19 1 1 1 1 1 1 1 119 119 119 119 119 2 1 1 1 1 1 1 19 19 19 19 19 121 121 121 121 121 19 19 19 19 19 19
8 8 8 111 111 111 90 111 111 111 111 111 111 8 110 110 110 110 110 110 110 110 110 110 110 110 9 19 19 1 1 1 1 1 1 1 1 1 119 2 1 1 1 1 1 1 1 1 19 19 19 19 19 19 19 121 19 19 19 19 19 19 19 19
8 8 8 8 8 9 8 8 8 9 8 111 111 90 110 110 110 110 110 110 110 110 110 110 110 110 8 19 19 19 19 19 19 19 19 19 19 119 119 119 19 19 19 19 19 19 19 19 19 19 19 19 19 19 19 91 19 19 19 19 19 19 19 19
8 8 8 111 111 111 90 111 111 111 111 111 111 8 110 110 110 110 110 110 110 110 110 110 110 110 8 19 19 19 19 19 19 19 19 19 25 119 119 119 19 25 19 19 19 19 19 19 19 19 19 19 19 19 19 120 120 120 120 120 120 19 19 19
8 8 9 111 111 111 8 8 8 9 8 9 8 8 8 91 8 8 9 9 8 8 8 110 110 110 9 19 19 19 19 19 19 19 19 19 19 119 119 119 119 119 119 119 119 119 119 19 19 19 19 19 19 19 19 19 19 19 19 19 120 19 19 19
8 8 8 111 111 111 9 8 8 8 8 8 8 8 8 110 8 8 8 8 8 9 8 110 110 110 8 19 19 19 19 19 19 19 19 19 19 19 19 19 25 19 19 19 19 19 119 19 19 19 19 19 19 19 19 19 19 19 19 19 120 19 19 19
8 8 8 8 9 8 8 8 8 8 8 8 8 8 8 8 8 8 8 8 8 8 8 8 91 8 8 19 19 19 19 19 19 19 19 19 19 19 19 19 19 19 19 19 19 19 119 19 19 19 19 19 19 19 19 19 19 19 19 19 120 19 19 19
19 19 19 19 19 19 19 19 19 19 19 19 19 19 19 19 19 19 19 19 19 19 19 109 109 109 19 19 118 118 118 118 118 19 19 19 19 19 19 19 19 19 19 19 19 19 119 25 19 19 117 117 117 117 117 117 19 19 19 19 120 19 19 19
19 19 19 19 19 19 19 19 19 19 19 19 19 19 19 19 19 19 19 19 19 19 25 109 109 109 19 19 118 118 118 118 118 19 19 19 19 19 19 19 19 19 19 19 19 25 119 19 25 117 117 19 19 19 19 117 19 19 19 19 120 19 19 19
19 19 19 19 19 19 19 19 19 19 19 19 19 19 19 19 19 19 19 19 19 19 19 109 109 109 25 19 118 118 118 118 118 19 19 118 118 19 19 19 19 19 19 19 19 19 119 119 90 117 117 19 19 19 19 117 117 117 90 120 120 19 19 19
19 19 19 19 19 19 19 19 19 19 19 19 19 19 19 19 19 19 19 19 19 19 19 109 109 109 19 19 118 118 118 118 118 19 118 118 118 118 19 19 19 19 19 19 19 19 19 19 25 117 117 19 19 25 19 117 19 19 19 19 19 19 19 19
19 19 19 19 19 19 19 19 19 19 19 19 19 19 19 19 19 19 19 19 19 19 25 109 109 109 19 19 19 19 19 118 118 19 118 118 118 118 118 19 19 19 19 19 19 19 19 19 19 19 117 117 117 117 19 117 19 19 19 19 19 19 19 19
19 19 19 19 19 19 19 19 19 19 19 19 19 19 19 19 19 19 19 19 19 19 19 109 109 109 19 19 19 19 19 118 118 19 118 118 118 118 118 90 117 117 117 117 117 19 19 19 19 19 19 19 19 117 19 117 19 19 19 19 19 19 19 19
19 19 19 19 19 19 19 19 19 19 19 19 19 19 19 19 19 19 19 19 19 19 19 19 91 19 19 19 19 19 19 19 19 19 118 118 118 118 118 19 19 19 19 117 117 19 19 19 19 25 25 19 19 117 19 117 19 19 19 19 19 19 19 19
19 19 19 19 19 19 19 19 19 19 19 19 19 19 19 19 19 19 19 19 19 19 19 108 108 108 19 19 19 19 19 19 19 19 118 118 118 118 19 19 19 19 19 117 117 117 117 117 117 117 117 117 117 117 19 117 19 19 19 19 19 19 19 19
19 19 19 19 19 19 19 19 19 19 19 19 19 19 19 19 19 19 19 19 19 19 19 106 108 108 19 19 19 19 19 19 19 19 19 118 118 19 19 19 19 19 19 19 19 19 117 117 117 117 117 19 19 19 19 117 19 19 19 19 19 19 19 19
19 19 19 19 19 19 19 19 19 19 19 19 19 19 19 19 19 19 19 19 19 19 19 108 108 108 19 19 19 19 19 19 19 19 19 19 19 19 19 19 19 19 19 19 19 19 19 19 117 19 19 19 19 19 19 117 117 117 19 19 19 19 19 19
19 19 19 19 19 19 19 19 19 19 19 19 19 19 19 19 19 108 108 108 108 108 108 108 108 108 19 19 19 19 19 19 19 106 113 113 19 19 19 19 19 19 19 19 19 19 19 19 117 25 19 116 116 19 19 19 19 117 19 19 19 19 19 19
19 19 19 19 19 19 19 19 19 19 19 19 19 19 19 19 19 108 108 108 108 108 108 108 108 108 19 19 19 19 113 113 113 113 113 113 19 19 116 116 116 116 116 116 19 19 19 19 91 19 19 116 106 116 116 19 19 117 19 19 19 19 19 19
19 19 19 19 19 19 19 19 19 19 19 19 19 19 19 19 19 108 108 108 108 108 108 108 108 108 19 19 19 19 106 19 19 106 113 113 19 19 19 19 19 19 19 116 19 19 19 25 116 25 19 116 116 19 116 19 19 117 117 117 117 117 19 19
19 19 19 19 19 19 19 19 19 19 19 19 19 19 19 19 19 108 108 108 19 19 19 108 108 108 19 19 19 19 113 19 19 19 19 19 19 19 19 19 19 19 19 116 19 19 25 19 116 19 25 19 19 19 116 19 19 117 19 19 19 117 117 19
19 19 19 19 19 19 19 19 19 19 19 19 19 19 19 19 19 108 108 108 19 19 19 108 108 108 19 19 19 19 113 19 113 113 113 19 25 19 19 19 19 19 19 116 19 19 116 116 116 116 116 19 19 19 116 19 19 117 19 19 19 19 117 19
19 19 19 19 19 19 19 19 19 19 19 19 19 19 19 19 19 108 108 108 19 19 19 106 108 108 19 19 19 19 113 113 113 113 113 113 113 113 113 113 19 19 19 116 19 19 116 116 116 116 116 19 19 19 116 19 19 117 117 19 19 19 117 19
19 19 19 19 19 19 19 19 19 19 19 19 19 19 19 19 19 108 108 108 19 19 19 19 91 19 19 19 19 19 19 19 113 113 113 19 25 113 113 113 19 19 19 116 116 116 116 116 116 116 116 116 116 116 116 19 19 19 117 117 117 117 117 19
19 19 19 19 19 19 19 19 19 19 19 19 19 19 19 19 19 108 108 108 19 19 113 113 113 113 113 19 19 19 19 19 19 113 19 19 19 113 113 113 19 19 19 19 19 19 116 116 116 116 116 19 19 19 116 19 19 19 19 19 117 19 19 19
19 19 19 19 19 19 19 19 19 19 19 19 19 19 19 19 108 108 108 108 19 19 113 113 113 113 113 19 19 19 19 19 19 113 25 19 19 113 113 113 19 19 19 19 19 19 116 116 116 116 116 19 19 19 116 19 19 19 19 19 91 19 19 19
19 19 19 19 108 108 108 108 19 19 19 19 19 19 19 108 108 108 108 108 19 19 113 113 113 113 113 113 113 113 113 113 113 113 19 19 19 113 113 113 19 19 19 19 19 19 19 19 116 19 19 19 19 19 116 19 19 19 19 19 116 19 19 19
19 108 108 108 108 108 108 108 19 19 19 19 19 19 108 108 108 108 108 108 19 19 113 113 113 113 113 19 19 19 19 19 19 19 19 19 19 113 113 113 19 19 19 19 19 19 19 19 116 25 19 19 19 19 116 19 19 19 116 116 116 116 116 19
19 108 19 19 108 108 108 108 19 19 19 19 19 108 108 108 108 108 108 19 19 19 113 113 113 113 113 19 19 19 19 19 19 19 19 19 113 113 113 113 113 19 19 25 19 19 19 19 91 25 19 19 19 19 116 19 19 19 116 12 10 12 106 19
19 108 19 19 19 19 19 19 19 19 19 19 108 108 108 108 108 108 19 19 19 19 19 113 113 113 19 19 19 19 19 19 19 19 19 19 113 113 113 113 113 113 113 113 113 113 19 115 115 115 19 19 19 19 116 116 116 116 116 23 12 23 106 19
19 108 19 19 19 19 19 19 19 19 19 108 108 108 108 108 108 19 19 19 19 19 19 113 113 113 19 19 19 19 19 19 19 19 19 25 113 113 113 113 113 113 113 113 113 113 90 115 115 115 19 19 19 19 19 19 19 19 116 12 10 12 116 19
19 108 108 108 108 108 19 19 19 19 108 108 108 108 108 108 19 19 19 19 19 19 19 113 113 113 19 19 19 19 19 19 19 19 19 19 113 113 113 113 113 113 113 113 113 113 19 115 115 115 19 19 19 19 19 19 19 19 116 116 116 116 116 19
19 108 108 108 108 108 108 108 108 108 108 108 108 108 108 19 19 19 19 19 19 19 19 113 113 113 19 19 19 19 19 19 19 19 19 19 113 113 113 113 113 19 19 25 19 19 19 19 91 19 19 19 19 19 19 19 19 19 19 19 116 19 19 19
13 108 108 108 108 108 108 108 108 108 108 108 108 108 19 19 19 114 114 114 19 113 113 113 113 113 19 19 19 19 19 19 19 19 19 19 19 19 19 19 19 19 19 137 137 137 19 19 137 19 19 137 137 137 19 116 116 116 19 19 116 19 19 19
19 108 108 108 108 108 108 108 108 108 108 108 19 19 19 19 19 114 114 114 90 113 113 113 113 113 113 106 113 113 113 113 19 19 19 19 19 19 19 19 19 19 19 137 137 137 19 19 137 19 19 137 137 137 19 116 116 116 116 116 116 19 19 19
19 108 108 108 108 108 19 19 19 19 19 19 19 19 19 19 19 114 114 114 19 113 113 113 113 113 19 19 19 19 19 19 19 19 19 19 19 19 19 19 19 19 19 137 137 137 137 137 137 137 137 137 137 137 19 116 116 116 19 19 19 19 19 19
19 19 19 19 19 19 19 19 19 19 19 19 19 19 19 19 19 19 19 19 19 19 19 19 19 19 19 19 19 19 19 19 19 19 19 19 19 19 19 19 19 19 19 19 19 19 19 19 19 19 19 19 19 25 19 19 19 19 19 19 19 19 19 19
