24 24 24 24 24 24 24 24 24 24 24 24 24 24 24 24 24 24 24 24 24 24 24 24 24 24 24 24 24 24 24 24 24 24 24 24 24 24 24 24 24 1 1 1 2 6 1 1 1 1 13 1 1 1 1 1 1 1 1 1 1 1 1 1
24 24 24 24 24 24 24 24 24 24 24 24 24 24 24 24 24 24 24 24 24 24 24 24 24 24 24 24 24 24 24 24 24 24 24 24 24 24 24 24 24 1 1 1 111 111 111 1 1 1 108 1 1 1 109 1 1 1 1 1 1 1 1 1
24 24 24 24 24 24 24 24 24 24 24 24 24 24 24 24 24 24 24 24 24 24 24 24 24 24 24 24 24 24 24 24 24 24 24 24 24 24 24 24 24 1 1 111 111 111 111 111 1 1 108 1 1 1 109 109 109 109 109 109 109 109 109 1
24 24 24 24 24 24 24 24 24 24 24 24 24 24 24 24 24 24 24 24 24 24 24 24 24 24 24 24 24 24 24 24 24 24 24 24 24 24 24 24 24 1 1 106 111 111 111 106 1 1 108 2 1 1 6 1 1 1 2 1 1 1 109 1
24 24 24 24 24 24 24 24 24 24 24 24 24 24 24 24 24 24 24 24 24 24 24 24 24 24 24 24 24 24 24 24 24 24 24 24 24 24 24 24 24 1 1 2 111 111 111 1 1 1 108 1 1 1 109 1 1 1 1 1 1 1 109 1
24 24 24 24 24 24 24 24 24 24 24 24 24 24 24 24 24 24 24 24 24 24 24 24 24 24 24 24 24 24 24 24 24 24 24 24 24 24 24 24 24 1 1 1 111 111 111 1 1 2 108 1 1 109 109 109 3 21 1 1 1 1 109 1
24 24 24 24 24 24 24 24 24 24 24 24 24 24 24 24 24 24 24 24 24 24 24 24 24 24 24 24 24 24 24 24 24 24 24 24 24 24 24 24 24 1 1 111 111 111 111 111 90 108 108 108 94 109 109 109 100 143 21 1 1 1 109 1
24 24 24 24 24 24 24 24 24 24 24 24 24 24 24 24 24 24 24 24 24 24 24 24 24 24 24 24 24 24 24 24 24 24 24 24 24 24 24 24 24 1 1 111 111 111 111 111 1 1 108 1 1 109 109 109 3 21 1 1 1 1 109 1
24 24 24 24 24 24 24 24 24 24 24 24 24 24 24 24 24 24 24 24 24 24 24 24 24 24 24 24 24 24 24 24 24 24 24 24 24 24 24 24 24 1 1 1 111 111 111 1 1 1 91 1 1 1 109 1 1 1 1 1 1 2 109 1
24 24 24 24 24 24 24 24 24 24 24 24 24 24 24 24 24 24 24 24 24 24 24 24 24 24 24 24 24 24 24 24 24 24 24 24 24 24 24 24 24 1 1 1 1 6 1 2 110 110 110 110 110 1 6 1 1 1 1 1 1 1 109 1
24 24 24 24 24 24 24 24 24 24 24 24 24 24 24 24 24 24 24 24 24 24 24 24 24 24 24 24 24 24 24 24 24 24 24 24 24 24 24 24 24 1 1 1 1 1 1 1 110 110 110 110 110 1 1 1 1 1 1 4 1 1 91 1
24 24 24 24 24 24 24 24 24 24 24 24 24 24 24 24 24 24 24 24 24 24 24 24 24 24 24 24 24 24 24 24 24 24 24 24 24 24 24 24 24 1 1 1 1 1 1 110 110 110 110 110 110 110 2 1 112 112 112 112 112 112 112 1
24 24 24 24 24 24 24 24 24 24 24 24 24 24 24 24 24 24 24 24 24 24 24 24 24 24 24 24 24 24 24 24 24 24 24 24 24 24 24 24 24 1 1 1 1 1 1 110 110 2 1 1 110 110 1 2 112 112 112 112 112 112 112 1
24 24 24 24 24 24 24 24 24 24 24 24 24 24 24 24 24 24 24 24 24 24 24 24 24 24 24 24 24 24 24 24 24 24 24 24 24 24 24 24 24 1 1 1 1 1 1 1 1 1 1 1 1 1 1 3 112 112 112 112 112 112 112 3
24 24 24 24 24 24 24 24 24 24 24 24 24 24 24 24 24 24 24 24 24 24 24 24 24 24 24 24 24 24 24 24 24 24 24 24 24 24 24 24 24 1 1 1 1 1 1 1 1 1 1 1 1 1 1 1 112 112 112 112 112 112 112 1
24 24 24 24 24 24 24 24 24 24 24 24 24 24 24 24 24 24 24 24 24 24 24 24 24 24 24 24 24 24 24 24 24 24 24 24 24 24 24 24 24 1 1 1 1 1 1 1 1 1 1 1 1 1 1 1 112 112 112 112 112 112 112 1
24 24 24 24 24 24 24 24 24 24 24 24 24 24 24 24 24 24 24 24 24 24 24 24 24 24 24 24 24 24 24 24 24 24 24 24 24 24 24 24 24 1 1 1 1 1 1 1 1 1 1 1 1 1 1 1 1 1 112 112 112 1 1 1
24 24 24 24 24 24 24 24 24 24 24 24 24 24 24 24 24 24 24 24 24 24 24 24 24 24 24 24 24 24 24 24 24 24 24 24 24 24 24 24 24 24 24 24 24 24 24 24 24 24 24 24 24 24 24 24 24 24 24 91 24 24 24 24
24 24 24 24 24 24 24 24 24 24 24 24 24 24 24 24 24 24 24 24 24 24 24 24 24 24 24 24 24 24 24 24 24 24 24 24 24 24 24 24 24 24 24 26 113 113 113 24 26 24 24 24 24 24 24 24 24 24 113 113 113 26 24 24
24 24 24 24 24 24 24 24 24 24 24 24 24 24 24 24 24 24 24 24 24 24 24 24 24 24 24 24 24 24 24 24 24 24 24 24 24 24 24 24 24 24 26 113 113 113 113 113 113 113 113 113 24 26 24 26 24 113 113 113 113 113 26 24
24 24 24 24 24 24 24 24 24 24 24 24 24 24 24 24 24 24 24 24 24 24 24 24 24 24 24 24 24 24 24 24 24 24 24 24 24 24 24 24 24 24 4 113 113 113 113 113 113 113 113 113 113 113 113 113 113 113 113 113 113 113 4 24
24 24 24 24 24 24 24 24 24 24 24 24 24 24 24 24 24 24 24 24 24 24 24 24 24 24 24 24 24 24 24 24 24 24 24 24 24 24 24 24 24 24 26 113 113 113 113 113 113 113 113 113 24 26 24 26 24 113 113 113 113 113 26 24
24 24 24 24 24 24 24 24 24 24 24 24 24 24 24 24 24 24 24 24 24 24 24 24 24 24 24 24 24 24 24 24 24 24 24 24 24 24 24 24 24 24 24 24 113 113 113 24 26 24 24 24 24 24 24 24 24 26 113 113 113 24 24 24
24 24 24 24 24 24 24 24 24 24 24 24 24 24 24 24 24 24 24 24 24 24 24 24 24 24 24 24 24 24 24 24 24 24 24 24 24 24 116 116 116 24 24 24 24 24 24 24 24 24 24 24 24 24 24 24 24 24 24 113 24 24 24 24
24 24 24 24 24 24 24 24 24 24 24 24 24 24 24 24 24 24 24 24 24 24 24 24 24 24 24 24 24 24 24 24 24 24 24 24 24 24 116 116 116 24 24 24 24 24 24 24 24 24 24 24 24 24 24 24 24 24 24 113 26 24 24 24
24 24 24 24 24 24 24 24 24 24 24 24 24 24 24 24 24 24 24 24 24 24 24 24 24 24 24 24 24 24 24 24 24 24 24 24 24 24 116 116 116 24 24 116 116 116 116 116 24 24 24 24 24 24 24 24 24 24 24 91 24 24 24 24
24 24 24 24 24 24 24 24 24 24 24 24 24 24 24 24 24 24 24 24 24 24 24 24 24 24 24 24 24 24 24 24 24 24 24 24 24 24 24 116 116 24 116 116 116 116 116 116 116 24 24 24 24 24 24 24 24 24 26 114 24 24 24 24
24 24 24 24 24 24 24 24 24 24 24 24 24 24 24 24 24 24 24 24 24 24 24 24 24 24 24 24 24 24 24 24 24 24 24 24 24 24 24 24 24 24 116 116 116 116 116 116 116 24 24 24 24 24 24 24 24 24 24 114 24 24 24 24
24 24 24 24 24 24 24 24 24 24 24 24 24 24 24 24 24 24 24 24 24 24 24 24 24 24 24 24 24 24 24 24 24 24 24 24 24 24 24 24 24 24 24 116 116 116 116 116 24 24 24 24 24 24 24 24 24 24 114 114 114 26 24 24
24 24 24 24 24 24 24 24 24 24 24 24 24 24 24 24 24 24 24 24 24 24 24 24 24 24 24 24 24 24 24 24 24 24 24 24 24 24 24 117 24 24 24 116 116 116 116 116 24 24 24 6 24 24 24 24 24 114 114 114 114 114 24 24
24 24 24 24 24 24 24 24 24 24 24 24 24 24 24 24 24 24 24 24 24 24 24 24 24 24 24 24 24 24 24 24 24 24 24 24 24 24 117 117 24 24 24 24 91 4 91 24 26 24 26 115 26 24 24 26 114 114 114 114 114 114 114 26
24 24 24 24 24 24 24 24 24 24 24 24 24 24 24 24 24 24 24 24 24 24 24 24 24 24 24 24 24 24 24 24 24 24 24 24 24 117 117 117 24 114 114 114 114 114 114 114 114 114 24 115 24 24 24 4 114 114 114 114 114 114 114 4
24 24 24 24 24 24 24 24 24 24 24 24 24 24 24 24 24 24 24 24 24 24 24 24 24 24 24 24 24 24 24 24 24 24 24 24 117 117 117 117 90 114 114 114 114 114 114 114 114 114 90 115 24 24 24 26 114 114 114 114 114 114 114 26
24 24 24 24 24 24 24 24 24 24 24 24 24 24 24 24 24 24 24 24 24 24 24 24 24 24 24 24 24 24 24 24 24 24 24 24 24 117 117 117 24 114 114 114 114 114 114 114 114 114 24 115 24 24 24 24 24 114 114 114 114 114 24 24
24 24 24 24 24 24 24 24 24 24 24 24 24 24 24 24 24 24 24 24 24 24 24 24 24 24 24 24 24 24 24 24 24 24 24 24 24 24 117 117 24 24 26 24 114 114 114 24 24 24 26 115 26 24 24 24 24 24 114 114 114 26 24 24
24 24 24 24 24 24 24 24 24 24 24 24 24 24 24 24 24 24 24 24 24 24 24 24 24 24 24 24 24 24 24 24 24 24 24 24 24 24 24 117 24 24 24 24 114 114 114 26 24 24 24 6 24 24 24 24 24 24 114 114 114 26 24 24
24 24 24 24 24 24 24 24 24 24 24 24 24 24 24 24 24 24 24 24 24 24 24 24 24 24 24 24 24 24 24 24 24 24 24 24 24 24 24 24 24 24 24 24 114 114 114 24 24 24 24 24 24 24 24 24 24 24 114 114 114 24 24 24
24 24 24 24 24 24 24 24 24 24 24 24 24 24 24 24 24 24 24 24 24 24 24 24 24 24 24 24 24 24 24 24 24 24 24 24 24 24 24 24 24 24 24 24 114 114 114 26 24 24 24 24 24 24 24 26 114 114 114 114 114 114 114 26
24 24 24 24 24 24 24 24 24 24 24 24 24 24 24 24 24 24 24 24 24 24 24 24 24 24 24 24 24 24 24 24 24 24 24 24 24 24 24 24 24 24 24 24 114 114 114 24 24 24 24 24 24 24 24 24 24 26 114 114 114 24 24 24
24 24 24 24 24 24 24 24 24 24 24 24 24 24 24 24 24 24 24 24 24 24 24 24 24 24 24 24 24 24 24 24 24 24 24 24 24 24 24 24 24 24 24 24 114 114 114 24 24 24 26 26 24 26 24 24 24 24 114 114 114 24 24 24
24 24 24 24 24 24 24 24 24 24 24 24 24 24 24 24 24 24 24 24 24 24 24 24 24 24 24 24 24 24 24 24 24 24 24 24 24 24 24 24 24 24 24 24 114 114 114 114 114 114 114 114 114 114 114 114 114 114 114 114 114 24 24 24
24 24 24 24 24 24 24 24 24 24 24 24 24 24 24 24 24 24 24 24 24 24 24 24 24 24 24 24 24 24 24 24 24 24 24 24 24 24 24 24 24 24 24 24 114 114 114 114 114 114 114 114 114 114 114 114 114 114 114 114 114 26 24 24
24 24 24 24 24 24 24 24 24 24 24 24 24 24 24 24 24 24 24 24 24 24 24 24 24 24 24 24 24 24 24 24 24 24 24 24 24 24 24 24 24 24 24 26 114 114 114 114 114 114 114 114 114 114 114 114 114 114 114 114 114 26 24 24
24 24 24 24 24 24 24 24 24 24 24 24 24 24 24 24 24 24 24 24 24 24 24 24 24 24 24 24 24 24 24 24 24 24 24 24 24 24 24 24 24 24 24 24 114 114 114 24 24 24 26 24 26 24 24 24 24 24 24 24 24 24 24 24
24 24 24 24 24 24 24 24 24 24 24 24 24 24 24 24 24 24 24 24 24 24 24 24 24 24 24 24 24 24 24 24 24 24 24 24 24 24 24 24 24 24 24 24 114 114 114 26 24 24 24 24 123 123 123 123 123 123 123 123 123 24 24 24
24 24 24 24 24 24 24 24 24 24 24 24 24 24 24 24 24 24 24 24 24 24 24 24 24 24 24 24 24 24 24 24 24 24 24 24 24 24 24 24 24 24 24 24 114 114 114 24 24 24 24 24 123 123 123 123 123 123 123 123 123 24 24 24
24 24 24 19 25 25 19 19 24 24 24 24 24 24 24 24 24 24 24 24 24 24 24 24 24 24 24 24 24 24 24 24 24 24 24 24 24 24 24 24 24 24 24 26 114 114 114 24 24 24 24 24 123 123 123 123 123 123 123 123 123 24 24 24
24 19 19 19 121 121 121 19 19 19 24 24 24 24 24 24 24 24 24 24 24 24 24 24 24 24 24 24 24 24 24 24 24 24 24 24 24 24 24 24 24 24 24 24 114 114 114 26 24 24 24 24 123 123 123 123 123 123 123 123 123 24 24 24
19 19 121 121 121 121 121 121 121 19 19 24 24 24 24 24 24 24 24 24 24 24 24 24 24 24 24 24 24 24 24 24 24 24 24 24 24 24 24 24 24 24 24 24 114 114 114 26 24 24 24 24 123 123 123 123 123 123 123 123 123 24 24 24
25 121 121 121 121 121 121 121 121 121 25 19 25 19 19 19 19 19 19 19 25 19 19 19 19 19 19 24 24 24 24 24 24 24 24 24 24 24 24 24 24 24 24 24 24 91 24 24 24 24 24 24 24 24 24 24 91 24 24 24 24 24 24 24
19 121 121 121 121 121 121 121 121 121 90 120 120 120 120 120 120 120 120 120 120 120 120 120 120 120 19 119 119 24 26 24 26 24 24 24 24 24 24 24 24 24 24 24 118 118 118 24 24 24 24 24 24 24 26 122 122 122 26 24 24 24 24 24
25 121 121 121 121 121 121 121 121 121 25 120 120 120 120 120 120 120 120 120 120 120 120 120 120 120 90 119 119 119 119 119 119 119 119 24 24 24 24 24 24 24 24 24 118 118 118 24 24 24 24 24 24 24 24 122 122 122 26 24 24 24 24 24
25 121 121 121 121 121 121 121 121 121 90 120 120 120 120 120 120 120 120 120 120 120 120 120 120 120 19 119 119 24 26 24 26 24 119 24 24 24 24 24 24 24 24 24 118 118 118 24 24 24 24 24 24 24 26 122 122 122 26 24 24 24 24 24
19 121 121 121 121 121 121 121 121 121 19 25 19 19 25 19 25 19 19 19 19 19 19 25 19 19 19 24 24 24 24 24 24 24 119 24 24 24 24 24 24 24 24 24 118 118 118 26 24 24 24 24 24 24 24 122 122 122 24 24 24 24 24 24
19 19 121 121 121 121 121 121 121 19 19 24 24 24 24 24 24 24 24 24 24 24 24 24 24 24 24 24 24 24 24 24 24 24 119 24 24 24 24 24 24 24 24 26 118 118 118 24 24 24 24 24 24 24 24 122 122 122 26 24 24 24 24 24
24 19 25 19 121 121 121 19 25 19 24 24 24 24 24 24 24 24 24 24 24 24 24 24 24 24 24 24 24 24 24 24 24 24 119 24 24 24 24 24 24 24 24 24 118 118 118 24 24 24 24 24 24 122 122 122 122 122 122 122 24 24 24 24
24 24 24 19 19 25 25 19 24 24 24 24 24 24 24 24 24 24 24 24 24 24 24 24 24 24 24 24 24 24 24 24 24 24 119 24 24 24 24 24 24 24 118 118 118 118 118 118 118 24 24 24 24 24 122 122 122 122 122 24 24 24 24 24
24 24 24 24 24 24 24 24 24 24 24 24 24 24 24 24 24 24 24 24 24 24 24 24 24 24 24 24 24 24 24 24 24 24 119 24 24 24 24 26 118 118 118 118 118 118 118 118 118 118 118 24 26 24 24 122 122 122 24 24 24 24 24 24
24 24 24 24 24 24 24 24 24 24 24 24 24 24 24 24 24 24 24 24 24 24 24 24 24 24 24 24 24 24 24 24 24 24 119 24 24 24 118 118 118 118 118 118 118 118 118 118 118 118 118 118 118 24 24 24 122 24 24 24 24 24 24 24
24 24 24 24 24 24 24 24 24 24 24 24 24 24 24 24 24 24 24 24 24 24 24 24 24 24 24 24 24 24 24 24 24 24 91 24 118 118 118 118 118 118 118 118 118 118 118 118 118 118 118 118 118 118 118 24 91 24 24 24 24 24 24 24
24 24 24 24 24 24 24 24 24 24 24 24 24 24 24 24 24 24 24 24 24 24 24 24 24 24 24 24 24 24 24 24 24 24 118 118 118 118 118 118 118 118 118 118 118 118 118 118 118 118 118 118 118 118 118 118 118 26 24 24 24 24 24 24
24 24 24 24 24 24 24 24 24 24 24 24 24 24 24 24 24 24 24 24 24 24 24 24 24 24 24 24 24 24 24 24 24 24 24 24 24 24 24 24 24 26 24 24 24 26 24 24 24 26 24 24 24 26 24 24 24 24 24 24 24 24 24 24
24 24 24 24 24 24 24 24 24 24 24 24 24 24 24 24 24 24 24 24 24 24 24 24 24 24 24 24 24 24 24 24 24 24 24 24 24 24 24 24 24 24 24 24 24 24 24 24 24 24 24 24 24 24 24 24 24 24 24 24 24 24 24 24
24 24 24 24 24 24 24 24 24 24 24 24 24 24 24 24 24 24 24 24 24 24 24 24 24 24 24 24 24 24 24 24 24 24 24 24 24 24 24 24 24 24 24 24 24 24 24 24 24 24 24 24 24 24 24 24 24 24 24 24 24 24 24 24
