1 1 1 1 1 1 1 1 1 1 1 1 1 1 1 1 1 1 1 1 1 1 1 1 1 1 1 1 1 1 1 1 1 1 1 1 1 1 1 1 1 1 2 1 4 1 1 2 1 1 2 1 1 1 1 1 1 1 1 1 1 1 1 1
1 108 108 1 108 108 1 108 108 1 108 108 1 108 108 1 108 108 1 108 108 1 108 108 1 108 108 1 108 108 1 108 108 1 108 108 1 108 108 1 1 1 128 128 128 128 128 1 128 128 128 1 1 1 1 1 26 2 2 1 1 1 1 1
1 108 108 1 108 108 1 108 108 1 108 108 1 108 108 1 108 108 1 108 108 1 108 108 1 108 108 1 108 108 1 108 108 1 108 108 90 108 106 1 1 2 128 128 128 128 128 2 128 128 128 2 1 1 1 1 139 139 139 139 2 1 1 1
1 1 1 1 1 1 1 1 1 1 1 1 1 1 1 1 1 1 1 1 1 1 1 1 1 1 1 1 1 1 1 1 91 1 1 1 1 1 1 1 1 2 128 128 128 128 128 1 128 128 128 1 1 2 1 139 139 139 139 139 139 1 1 1
1 108 108 1 108 108 1 108 108 1 108 108 1 108 108 1 108 108 1 108 108 1 108 108 1 108 108 1 108 108 1 108 108 1 108 108 1 1 1 1 1 1 1 2 91 1 2 1 1 91 1 1 1 2 139 139 139 139 139 139 139 139 2 1
1 108 108 1 108 108 1 108 108 1 108 108 1 108 108 1 108 108 1 108 108 1 108 108 1 108 108 1 108 108 1 108 108 1 108 108 1 1 1 1 1 1 128 128 128 128 128 128 128 128 128 92 139 139 139 139 139 139 139 139 139 139 139 1
1 1 1 1 91 1 1 1 1 1 1 1 1 1 1 1 1 1 1 1 1 1 1 1 1 1 1 1 1 1 1 1 1 1 91 1 1 1 1 1 1 3 128 128 128 128 128 128 128 128 128 28 139 139 139 139 139 139 139 139 139 139 139 26
1 108 108 1 108 108 1 108 108 1 108 108 1 108 108 1 108 108 1 108 108 1 108 108 1 108 108 1 108 108 1 108 108 1 108 108 1 1 1 1 1 1 128 128 128 128 128 128 128 128 128 92 139 139 139 139 139 139 139 139 139 139 139 2
1 108 108 1 108 108 1 108 108 1 108 108 1 108 108 1 108 108 1 108 108 1 108 108 1 108 108 1 108 108 1 108 108 1 108 108 1 1 1 1 1 2 128 128 128 1 1 1 2 1 2 1 2 1 139 139 139 139 139 139 139 139 1 1
1 1 1 1 1 1 1 1 1 1 1 1 1 1 1 1 1 1 1 1 1 1 1 1 1 1 1 1 1 1 1 1 1 1 1 1 1 1 1 1 1 1 128 128 128 2 129 129 129 129 129 1 1 1 2 139 139 139 139 139 139 2 1 1
1 108 108 1 108 108 1 108 108 1 108 108 1 108 108 1 108 108 1 26 24 26 1 1 1 1 1 6 1 2 1 126 1 126 2 126 1 1 1 1 1 2 128 128 128 2 129 129 129 129 129 129 1 1 1 1 139 139 139 139 1 1 1 1
1 108 108 1 108 108 1 108 108 1 108 108 1 108 108 1 108 108 1 124 124 124 124 124 2 125 125 125 125 125 2 126 2 126 1 126 2 1 1 1 1 1 128 128 128 1 129 129 129 129 129 1 1 1 1 1 1 1 2 26 1 1 1 1
1 1 1 1 1 1 1 1 1 1 1 1 1 1 1 1 1 1 1 124 124 124 124 124 90 125 125 125 125 125 90 126 126 126 126 126 126 126 1 1 1 1 91 2 91 1 91 1 1 3 1 2 1 1 1 1 1 1 1 1 1 1 1 1
1 108 108 1 108 108 1 108 108 1 108 108 1 108 108 1 108 108 1 124 124 124 124 124 1 125 125 125 125 125 2 126 126 126 126 126 1 1 2 1 1 127 127 127 127 127 127 127 2 129 129 129 1 1 1 1 1 1 1 1 1 1 1 1
1 108 108 1 108 108 1 108 108 1 108 108 1 108 108 1 108 108 1 124 124 124 124 124 1 1 1 125 1 1 1 126 126 126 126 126 126 126 2 1 1 127 127 127 127 127 127 127 1 129 129 129 1 1 1 1 1 1 1 1 1 1 1 1
1 1 1 1 1 1 1 1 1 1 1 1 1 1 1 1 1 1 1 124 124 124 1 2 1 1 1 91 1 1 1 1 2 126 126 126 2 1 1 1 1 127 127 127 127 127 127 127 1 1 2 2 1 1 1 1 1 1 1 1 1 1 1 1
1 108 108 1 108 108 1 108 108 1 108 108 1 108 108 1 108 108 1 26 24 26 1 1 1 1 1 108 2 1 1 1 1 1 91 1 1 2 2 2 1 2 1 91 1 91 1 1 1 1 1 1 1 1 1 1 1 1 1 1 1 1 1 1
1 108 108 1 108 108 1 108 108 1 108 108 1 108 108 1 108 108 1 1 1 2 2 1 1 1 108 108 108 108 108 108 108 108 108 108 108 108 108 108 108 108 108 108 108 108 108 108 1 12 12 12 10 12 12 12 12 12 12 10 12 12 12 12
1 1 1 1 1 1 1 1 1 1 1 1 1 1 1 1 1 1 2 123 123 123 123 123 1 2 108 108 108 108 108 108 108 108 108 108 108 108 108 108 108 108 108 108 108 108 108 108 2 12 109 109 109 109 109 109 109 109 109 109 109 109 109 12
1 108 108 1 108 108 1 108 108 1 108 108 1 108 108 1 108 108 1 123 123 123 123 123 2 1 108 108 108 108 108 108 108 108 108 108 108 108 108 108 108 108 108 108 108 108 108 108 1 12 109 109 109 109 109 109 109 109 109 109 109 109 109 12
1 108 108 1 108 108 1 108 108 1 108 108 1 108 108 1 108 108 1 123 123 123 123 123 1 1 1 1 2 1 2 1 2 2 1 108 108 108 1 1 1 2 1 2 1 1 2 1 1 11 109 109 109 109 109 109 109 109 109 109 109 109 109 11
1 1 1 1 1 1 1 1 1 1 1 1 1 1 1 1 1 1 1 123 123 123 123 123 2 123 123 123 1 1 1 1 1 1 2 108 108 108 2 1 1 1 1 1 1 1 1 1 1 12 109 109 109 109 109 109 109 109 109 109 109 109 109 12
1 108 108 1 108 108 1 108 108 1 108 108 1 108 108 1 108 108 1 123 123 123 123 123 90 123 123 123 1 1 1 1 1 1 1 108 108 108 1 1 1 1 1 1 1 1 1 1 1 12 109 109 109 109 109 109 109 109 109 109 109 109 109 12
1 108 108 1 108 108 1 108 108 1 108 108 1 108 108 90 108 108 1 123 123 123 123 123 1 123 123 123 2 1 1 1 1 1 2 108 108 108 2 1 1 1 1 1 1 1 1 1 1 12 109 109 109 109 109 12 12 12 12 10 12 12 12 12
1 1 1 1 1 1 1 91 1 1 1 1 1 1 1 1 1 1 2 123 123 123 123 123 1 3 91 3 1 1 1 1 1 1 2 108 108 108 1 1 1 1 1 1 1 1 1 1 1 12 109 109 109 109 109 12 110 110 110 110 110 110 110 12
1 108 108 1 108 108 1 108 108 1 108 108 1 108 108 1 108 108 1 123 123 123 123 123 2 108 108 108 1 1 1 1 1 1 1 108 108 108 2 1 1 1 1 1 1 1 1 1 1 12 109 109 109 109 109 12 110 110 110 110 110 110 110 12
1 108 108 1 108 108 1 106 108 1 108 108 1 108 108 1 108 108 1 123 123 123 123 123 2 108 108 108 2 1 1 1 1 1 1 108 108 108 1 1 1 1 1 1 1 1 1 1 1 12 109 109 109 109 109 12 110 110 110 110 110 110 110 12
1 1 1 1 1 1 1 1 1 1 1 1 1 1 1 1 1 1 1 1 1 2 1 1 1 108 108 108 1 1 1 1 1 108 108 108 108 108 108 108 1 1 1 1 1 1 1 1 1 12 109 109 109 109 109 12 110 12 110 110 110 12 110 12
1 108 108 1 108 108 1 108 108 1 108 108 1 108 108 1 108 108 1 108 108 1 108 108 1 108 108 108 1 2 2 1 1 108 108 108 108 108 108 108 1 2 1 2 1 12 12 12 12 12 109 109 109 109 109 12 110 12 110 110 110 12 110 12
1 108 108 1 108 108 1 108 108 1 108 108 1 108 108 1 108 108 1 108 108 1 108 108 1 108 108 108 108 108 108 108 108 108 108 1 3 1 108 108 108 108 108 108 108 23 109 109 109 109 109 109 109 109 109 12 12 12 91 12 91 12 12 12
1 1 1 1 1 1 1 1 1 1 1 1 1 1 1 1 1 1 1 1 1 1 1 1 1 108 108 108 108 108 108 108 108 108 108 6 1 13 108 108 108 108 108 108 108 90 109 109 109 109 109 109 109 109 109 12 12 12 111 111 111 12 12 12
1 108 108 1 108 108 1 108 108 1 108 108 1 108 108 1 108 108 1 108 108 1 108 108 1 108 108 108 108 108 108 108 108 108 108 1 3 1 108 108 108 108 108 108 108 23 109 109 109 109 109 109 109 109 109 12 12 111 111 111 111 111 12 12
1 108 108 1 108 108 1 108 108 1 108 108 1 108 108 1 108 108 1 108 108 1 108 108 1 2 2 1 2 1 2 1 1 108 108 108 108 108 108 108 1 2 1 2 1 12 12 12 12 12 109 109 109 109 109 23 111 111 111 111 111 111 111 12
1 1 1 1 1 1 1 1 1 1 1 1 1 1 1 1 1 1 1 1 1 1 1 1 1 1 1 1 1 1 1 1 1 108 108 108 108 108 108 108 1 1 1 1 1 1 12 112 112 12 109 109 109 109 109 94 111 111 111 111 111 111 111 10
1 108 108 1 108 108 1 108 108 1 108 108 1 108 108 1 108 108 1 108 108 1 108 108 1 108 108 1 1 1 1 1 1 1 1 108 108 108 2 1 1 1 1 1 1 1 12 112 112 90 109 109 109 109 109 23 111 111 111 111 111 111 111 12
1 108 108 1 108 108 1 108 108 1 108 108 1 108 108 1 108 108 1 108 108 1 108 108 1 108 108 1 1 1 1 1 1 1 2 108 108 108 1 1 1 1 1 12 12 12 12 112 112 12 109 109 109 109 109 12 12 111 111 111 111 111 12 12
1 1 1 1 1 1 1 1 1 1 1 1 1 1 1 1 1 1 1 1 1 1 1 1 1 1 1 1 1 1 1 1 1 1 1 108 108 108 1 1 1 1 1 12 112 112 112 112 112 12 109 109 109 109 109 12 12 12 111 111 111 12 12 12
1 108 108 1 108 108 1 108 108 1 108 108 1 108 108 1 108 108 1 108 108 1 108 108 1 108 108 1 1 1 1 1 1 1 2 108 108 108 1 1 1 1 1 12 112 112 112 112 112 12 109 109 109 109 109 12 12 12 12 11 12 12 12 12
1 108 108 1 108 108 1 108 108 1 108 108 1 108 108 1 108 108 1 108 108 1 108 108 1 108 108 1 1 1 1 1 1 1 1 108 108 108 1 1 12 12 12 12 12 12 12 12 12 12 109 109 109 109 109 109 109 109 109 109 109 109 109 12
1 1 1 1 1 1 1 1 1 1 1 1 1 1 1 1 1 1 1 1 1 1 1 1 1 1 1 1 1 1 1 1 1 1 1 108 108 108 2 1 12 114 114 114 114 114 114 114 114 12 109 109 109 109 109 109 109 109 109 109 109 109 109 12
1 108 108 1 108 108 1 108 108 1 108 108 90 108 108 1 108 108 1 108 108 1 108 108 1 108 108 1 1 1 1 1 1 1 1 108 108 108 2 1 12 114 114 114 114 114 114 114 114 12 109 109 109 109 109 109 109 109 109 109 109 109 109 23
1 108 108 1 108 108 1 108 108 1 108 108 1 108 108 1 108 108 1 108 108 1 108 108 1 108 108 1 1 1 1 1 1 1 2 108 108 108 1 1 12 114 114 114 114 114 114 12 12 12 109 109 109 109 109 109 109 109 109 109 109 109 109 12
1 1 1 1 1 1 1 1 1 1 1 1 1 1 1 1 1 1 1 1 1 1 1 1 1 1 1 1 1 1 1 1 1 1 2 108 108 108 1 1 12 114 114 114 114 114 114 12 109 109 109 109 109 109 109 109 109 109 109 109 109 109 109 12
1 108 108 1 108 108 1 108 108 1 108 108 1 108 108 1 108 108 1 108 108 1 108 108 1 108 108 1 1 1 1 1 1 1 1 108 108 108 2 1 12 114 114 114 12 12 12 12 91 12 12 12 12 12 12 12 12 12 12 12 12 12 12 12
1 108 108 1 108 108 1 108 108 1 108 108 1 108 108 1 108 108 1 108 108 1 108 108 1 108 108 1 1 1 1 1 1 1 1 108 108 108 1 1 12 114 114 114 114 114 12 114 114 114 12 12 12 12 12 115 12 115 12 115 12 12 12 12
1 1 1 1 1 91 1 1 1 1 1 1 1 1 1 1 1 1 1 1 1 1 1 1 1 1 1 1 1 1 1 1 1 1 1 108 108 108 1 1 12 12 114 114 114 114 12 114 114 114 12 12 12 12 115 115 115 115 115 115 115 12 12 12
1 108 108 1 108 108 1 108 108 1 108 108 1 108 108 1 108 108 1 108 108 1 108 108 1 108 108 1 1 1 1 1 1 1 108 108 108 108 108 1 1 12 12 12 12 12 12 114 114 114 12 12 12 12 12 115 12 115 12 115 12 12 12 12
1 108 108 1 108 108 1 108 108 1 108 108 1 108 108 1 108 108 1 108 108 1 108 108 1 108 108 1 1 1 108 108 1 108 108 108 108 108 108 108 1 1 1 12 114 114 12 114 114 114 12 120 12 120 12 12 12 91 12 12 12 12 12 12
1 1 1 1 1 1 1 1 1 1 1 1 1 1 1 1 1 1 1 1 1 1 1 1 1 1 1 1 1 1 108 108 1 2 108 108 108 108 108 1 1 1 1 12 114 114 12 114 114 114 12 120 120 120 120 12 114 114 114 12 121 121 121 12
1 108 108 1 108 108 1 108 108 1 108 108 1 108 108 1 108 108 1 108 108 1 108 108 1 108 108 1 1 2 108 108 108 1 1 108 108 108 1 1 12 12 12 12 12 12 12 114 114 114 12 120 120 120 120 90 114 114 114 90 121 121 12 12
1 108 108 1 108 108 1 108 108 1 108 108 1 108 108 1 108 108 1 108 108 1 108 108 1 108 108 1 1 2 108 108 108 108 2 108 108 108 2 1 12 117 117 117 117 117 90 114 114 114 12 120 120 120 120 12 114 114 114 12 121 121 121 12
1 1 1 1 1 1 1 1 1 1 1 1 1 1 1 1 1 1 1 1 1 1 1 1 1 1 1 1 1 1 1 1 1 1 1 108 108 108 1 1 12 117 117 117 117 117 12 114 114 114 12 120 120 12 91 12 114 114 114 12 121 121 12 12
1 108 108 1 108 108 1 108 108 1 108 108 1 108 108 1 108 108 1 108 108 1 108 108 1 108 108 1 1 1 108 108 1 108 1 108 108 108 1 1 12 117 117 117 117 117 12 114 114 114 12 120 12 12 119 12 114 114 114 12 121 121 121 12
1 108 108 1 108 108 1 108 108 1 108 108 1 108 108 1 108 108 1 108 108 1 108 108 1 108 108 1 1 2 108 108 1 108 2 108 108 108 2 1 12 12 12 12 117 117 12 114 114 114 12 12 12 12 119 12 114 114 114 90 121 121 12 12
1 1 1 1 1 1 1 1 1 1 1 1 1 1 1 1 1 1 1 1 1 1 1 1 1 1 1 1 28 2 108 108 1 1 1 108 108 108 1 1 1 1 1 12 117 117 12 114 114 114 12 119 119 119 119 12 114 114 114 12 121 121 121 12
1 108 108 1 108 108 1 108 108 1 108 108 1 108 108 1 108 108 1 108 108 1 108 108 1 108 108 1 108 108 108 108 1 1 1 108 108 108 1 12 12 12 12 12 12 12 12 114 114 114 12 119 119 119 119 90 114 114 114 12 12 12 12 12
1 108 108 1 108 108 1 108 108 1 108 108 1 108 108 1 108 108 1 108 108 1 108 108 1 108 108 1 108 108 108 108 1 1 1 108 108 108 1 12 118 118 118 118 118 118 12 114 114 114 12 119 119 119 119 12 114 114 114 12 122 122 122 12
1 1 1 1 1 1 1 1 1 1 1 1 1 1 1 1 1 1 1 1 1 1 1 1 1 1 1 1 28 1 1 2 1 1 2 108 108 108 2 12 118 118 118 118 118 118 12 114 114 114 12 119 119 119 119 90 114 114 114 90 122 12 12 12
1 108 108 1 108 108 1 108 108 1 108 108 1 108 108 1 108 108 1 108 108 1 108 108 1 108 108 1 1 1 2 113 113 113 2 108 108 108 2 12 118 118 118 118 118 118 12 114 114 114 12 119 119 119 119 12 114 114 114 12 122 90 122 12
1 108 108 1 108 108 1 108 108 1 108 108 1 108 108 1 108 108 1 1 108 1 108 108 1 108 108 1 1 21 1 113 113 113 1 108 108 108 2 11 118 118 118 118 118 118 90 114 114 114 12 12 12 12 12 12 114 114 114 12 12 12 12 12
1 1 1 1 1 1 1 1 1 1 1 1 1 1 1 1 1 1 1 1 1 1 1 1 1 1 1 1 21 140 100 113 113 113 92 108 108 108 1 12 118 118 118 118 118 118 12 114 114 114 114 114 114 114 114 114 114 114 114 114 114 114 114 12
1 108 108 1 108 108 1 108 108 1 108 108 1 108 108 1 108 108 1 108 108 1 108 108 1 108 108 1 1 21 1 113 113 113 1 108 108 108 2 12 118 118 118 118 118 118 12 114 114 114 114 114 114 114 114 114 114 114 114 114 114 114 114 11
1 108 108 1 108 108 1 108 108 1 108 108 1 108 108 1 108 108 1 108 108 1 108 108 1 108 108 1 1 1 2 113 113 113 1 1 6 1 1 12 118 118 118 118 118 118 12 114 114 114 114 114 114 114 114 114 114 114 114 114 114 114 114 12
1 1 1 1 1 1 1 1 1 1 1 1 1 1 1 1 1 1 1 1 1 1 1 1 1 1 1 1 1 1 1 2 1 2 1 1 1 1 1 12 12 12 12 12 12 12 12 12 12 12 12 12 12 12 12 12 12 12 12 12 12 12 12 12
