0 0 0 0 0 0 0 0 0 0 0 0 0 0 0 0 0 0 0 0 0 0 0 0 0 0 0 0 0 0 0 0 0 0 0 0 0 0 0 0 0 0 0 0 0 0 0 0 0 0 0 0 0 0 0 0 0 0 0 0 0 0 0 0
0 0 0 0 0 0 98 0 0 0 0 0 98 0 0 0 0 0 98 0 0 0 0 0 0 0 0 0 0 0 98 0 0 98 0 0 0 0 0 0 0 0 62 25 0 25 62 0 0 129 44 0 0 0 0 0 0 0 0 0 0 0 0 0
0 0 0 98 0 0 0 0 0 0 0 0 0 0 0 98 0 0 0 0 0 98 0 0 98 0 0 0 0 0 98 0 0 0 0 0 0 0 214 0 0 0 127 48 37 48 0 0 162 37 0 0 0 0 0 0 47 0 0 47 0 0 0 0
0 0 98 0 0 0 0 0 98 0 0 98 0 0 0 0 0 0 0 0 0 0 0 98 0 98 0 0 98 0 0 0 0 0 0 0 0 0 0 0 0 0 55 163 0 199 55 0 199 0 199 0 0 0 0 0 95 240 258 94 0 0 0 0
0 0 0 0 0 56 0 0 0 0 0 0 0 0 0 0 0 0 98 0 0 0 0 0 0 0 0 0 0 0 0 0 0 0 0 56 0 0 0 0 0 0 0 0 0 0 0 0 0 0 0 0 0 0 0 0 0 0 23 0 0 0 0 0
0 0 0 0 0 0 0 0 0 0 0 0 0 0 0 98 0 0 0 0 0 98 0 0 0 0 0 98 0 0 0 63 56 0 0 0 0 0 0 0 0 0 31 0 0 0 0 0 0 0 0 0 0 0 96 0 0 60 59 0 0 93 46 0
0 98 0 0 0 0 0 98 0 0 98 0 0 0 98 0 0 0 0 0 0 0 0 0 0 0 0 0 0 0 0 0 0 0 0 0 0 0 0 0 0 0 0 0 0 0 0 0 0 37 0 0 0 0 223 0 60 59 60 60 0 239 0 0
0 0 0 0 0 0 0 0 0 0 0 0 0 0 0 0 0 0 98 0 0 0 0 0 98 0 0 0 0 0 98 0 0 0 0 0 0 0 0 0 0 0 0 0 0 0 181 145 109 0 0 0 0 0 97 0 0 59 60 0 0 92 0 0
0 0 0 98 0 0 0 0 0 0 0 0 0 0 0 0 0 0 0 0 0 98 0 0 0 0 0 98 0 0 0 0 0 98 0 0 0 0 0 0 0 0 0 0 0 0 0 0 0 0 0 0 0 0 0 0 23 0 0 0 0 47 0 0
0 0 0 0 0 0 0 0 98 0 0 0 0 98 0 0 98 0 0 0 0 0 0 0 0 0 0 0 0 0 0 0 0 0 0 0 0 0 0 0 0 0 0 0 0 0 0 0 49 128 62 0 0 0 0 0 90 220 256 91 47 0 0 0
0 0 0 0 0 0 0 0 0 0 0 0 98 0 0 0 0 0 0 0 0 0 0 0 0 0 0 0 0 0 0 69 0 69 0 69 0 0 0 0 0 0 0 37 0 0 0 0 37 164 25 39 0 0 0 0 46 0 0 47 0 0 0 0
0 0 0 98 0 0 0 0 0 98 0 0 0 0 0 0 0 0 0 60 47 60 255 59 0 34 0 0 0 34 0 49 0 49 0 49 0 0 0 0 0 0 0 0 0 0 0 49 49 200 62 0 0 0 0 0 0 0 0 0 0 0 0 0
0 0 98 0 0 0 0 98 0 0 0 0 0 0 0 0 0 98 0 216 0 0 23 0 0 0 0 37 0 0 0 0 0 183 0 147 49 69 0 0 0 0 0 0 0 0 0 0 0 98 0 0 0 0 0 0 0 0 0 0 0 0 0 0
0 0 0 0 0 0 0 0 0 0 0 0 98 0 0 0 0 0 0 59 234 37 0 0 0 0 0 0 0 0 0 0 0 37 0 0 0 0 0 0 0 34 0 0 0 0 0 34 0 0 48 48 0 0 0 0 0 0 0 0 0 0 0 0
0 0 0 0 0 0 98 0 0 98 0 0 0 0 0 98 0 0 0 23 0 0 0 0 0 0 0 0 0 0 0 108 0 0 0 0 49 69 0 0 0 0 0 37 0 37 0 0 0 0 48 48 0 0 0 0 0 0 0 0 0 0 0 0
0 98 0 0 0 98 0 0 98 0 0 0 0 0 0 0 0 0 0 60 47 253 0 0 0 0 0 0 0 0 0 0 0 49 0 49 0 0 0 0 0 0 0 0 0 0 0 0 0 0 0 0 0 0 0 0 0 0 0 0 0 0 0 0
0 0 0 0 0 0 0 0 0 0 0 0 98 0 0 0 0 0 0 0 0 0 0 0 0 0 0 0 0 0 0 0 0 0 0 0 0 0 0 0 0 0 0 0 0 0 0 0 0 0 0 0 0 0 0 0 0 0 0 0 0 0 0 0
0 0 0 98 0 0 0 0 0 98 0 0 0 0 0 98 0 0 0 0 0 0 0 0 0 0 0 0 0 0 0 0 0 0 0 0 0 0 0 0 0 0 0 0 0 0 0 0 0 0 0 0 0 0 0 0 0 0 0 0 0 0 0 0
0 0 0 0 0 0 0 0 98 0 0 0 0 0 0 0 0 98 0 48 49 0 49 49 0 0 0 37 0 0 0 0 0 0 0 0 37 0 0 0 0 0 0 0 37 0 0 0 0 0 96 0 0 0 0 0 150 0 0 0 0 0 94 0
0 0 0 98 0 0 0 0 0 0 0 0 98 0 0 0 0 0 0 48 40 0 40 254 0 0 0 0 0 0 0 0 0 0 0 0 0 0 0 0 0 0 0 0 0 0 0 0 0 0 0 0 0 0 0 0 0 0 0 0 0 0 0 0
0 0 0 0 0 0 98 0 0 0 0 0 0 0 0 98 0 0 0 0 126 49 165 255 0 0 0 0 0 0 0 0 0 0 0 0 0 0 0 0 0 0 0 0 0 0 0 0 0 0 115 0 37 0 0 0 0 0 0 37 0 0 0 0
0 98 0 0 0 0 0 0 0 0 98 0 0 0 0 0 0 0 0 216 0 0 0 0 0 147 183 0 0 0 0 0 0 0 0 0 0 0 0 0 0 0 0 0 0 0 0 0 0 0 0 0 0 0 0 0 0 0 0 0 0 0 0 0
0 0 0 0 0 0 98 0 0 0 0 0 0 56 0 0 0 0 0 0 40 37 40 0 0 0 37 110 0 0 0 0 0 0 0 0 0 0 0 0 0 0 0 0 0 0 0 0 0 0 0 0 0 0 90 0 0 0 148 0 0 0 92 0
0 0 0 98 0 0 0 0 0 0 0 0 0 0 0 0 0 0 0 49 216 0 0 0 0 0 0 0 0 0 0 0 0 0 0 0 0 0 0 0 0 0 0 0 0 0 0 0 0 0 0 0 0 0 0 0 0 0 0 0 0 0 0 0
0 0 0 0 0 0 0 0 0 0 0 98 0 0 0 0 0 98 0 49 0 49 0 200 0 0 0 0 0 0 0 0 0 0 0 0 0 0 0 0 0 0 0 0 0 0 0 0 0 0 0 0 0 0 185 0 48 48 0 129 0 48 48 0
0 0 0 98 0 0 0 0 0 0 0 0 0 0 0 0 0 0 0 49 40 0 41 0 0 0 0 0 0 0 0 0 0 0 0 0 0 0 0 0 0 0 0 0 0 0 0 0 0 0 0 0 0 0 0 0 126 0 0 43 0 0 128 0
0 0 0 0 0 0 0 214 0 0 0 0 98 0 0 0 0 0 0 0 49 235 0 49 0 0 0 0 0 0 0 0 0 0 0 0 0 0 0 0 0 0 0 0 0 0 0 0 0 0 0 0 0 0 0 0 0 0 0 37 0 0 0 0
0 0 98 0 98 0 0 0 0 0 0 0 0 98 0 0 98 0 0 0 0 0 0 0 0 0 0 0 0 0 0 0 0 31 0 0 37 0 0 31 0 0 0 0 0 0 0 0 0 0 0 0 0 0 0 0 199 0 0 0 0 0 199 0
0 0 0 0 0 0 0 0 0 98 0 0 0 0 0 0 0 0 0 0 0 98 0 0 0 0 0 0 0 0 0 0 0 0 0 0 0 0 0 0 0 0 0 0 0 0 0 0 0 0 0 0 0 0 0 0 163 0 0 0 0 0 163 0
0 0 0 0 0 0 98 0 0 0 0 52 0 0 0 0 0 0 98 0 0 0 0 0 0 0 0 0 0 0 0 0 0 0 0 0 0 0 0 0 0 0 0 0 0 0 0 0 0 0 0 0 0 0 0 0 0 0 0 0 0 0 0 0
0 98 0 0 0 98 0 0 0 0 0 0 0 0 98 0 0 0 0 0 0 0 98 0 0 0 37 0 0 0 0 0 0 0 0 0 0 0 20 0 0 0 0 37 0 0 0 37 0 0 0 0 37 0 0 0 0 0 144 0 0 0 0 0
0 0 0 0 0 0 0 0 0 98 0 0 0 0 0 0 0 0 98 0 0 0 0 0 0 0 0 0 0 0 0 0 0 0 0 0 0 0 0 0 0 0 0 0 0 0 0 0 0 0 0 0 0 0 0 0 0 180 0 0 0 0 0 0
0 0 0 0 0 0 0 0 0 0 0 52 0 0 0 0 0 0 0 0 0 0 0 0 0 0 0 0 0 0 0 0 0 0 0 0 0 0 0 0 0 0 0 0 0 0 0 0 0 0 0 0 0 0 0 0 0 0 0 0 0 0 0 0
0 0 98 0 98 0 0 0 98 0 0 0 0 98 0 0 98 0 0 0 98 0 0 98 0 0 0 0 0 0 0 0 0 31 0 0 37 0 0 31 0 0 0 0 0 0 0 0 0 0 0 0 0 0 0 0 0 0 0 37 0 0 0 0
0 0 0 0 0 0 0 0 0 0 0 0 0 0 0 0 0 0 0 0 0 0 0 0 0 0 0 0 0 0 0 0 0 0 0 0 0 0 0 0 0 0 0 0 0 0 0 180 0 0 0 0 0 0 0 0 109 0 0 0 0 0 49 0
0 0 0 0 0 0 0 0 0 0 0 0 98 0 0 0 0 0 0 0 0 0 0 0 98 0 0 0 0 0 0 0 0 0 0 0 0 0 0 0 0 0 0 0 0 0 0 0 0 0 0 0 0 0 149 0 0 180 0 0 0 49 0 0
0 98 0 0 0 98 0 98 0 0 0 98 0 0 0 0 0 98 0 98 0 0 0 0 0 0 98 0 0 0 0 0 0 0 0 0 0 0 0 0 0 0 0 0 49 49 49 49 49 0 0 0 0 0 0 0 0 0 144 0 49 0 0 0
0 0 0 0 0 0 0 0 0 0 0 0 98 0 0 0 0 0 0 0 0 0 0 0 0 0 0 0 0 0 0 0 0 0 0 0 0 0 0 0 0 0 0 0 49 49 49 49 49 0 0 0 0 0 0 0 0 0 0 0 0 0 0 0
0 0 0 0 52 0 0 0 0 0 0 0 0 0 0 98 0 0 0 0 0 98 0 0 0 0 0 0 0 0 0 0 0 0 0 0 0 0 0 0 0 0 0 0 0 0 0 0 0 0 151 0 0 0 92 0 0 0 0 0 0 0 94 0
0 0 98 0 0 0 0 0 98 0 0 0 0 0 0 0 0 0 0 0 0 0 0 98 0 98 0 0 0 0 0 0 0 0 0 0 0 0 0 0 0 55 53 54 53 54 54 52 54 0 0 0 0 0 0 0 0 0 58 58 49 0 49 0
0 0 0 98 0 0 0 0 0 0 56 0 0 0 0 0 0 0 98 0 0 0 0 0 0 0 0 0 0 0 0 0 0 0 0 0 0 0 0 0 0 0 55 0 55 55 55 54 54 0 0 0 37 0 0 0 0 58 58 58 37 49 113 0
0 0 0 0 0 0 98 0 0 0 0 0 0 0 0 98 0 0 0 0 0 98 0 0 0 0 0 0 0 0 0 0 0 0 0 0 0 0 0 0 0 0 52 0 0 0 55 0 0 0 0 0 0 0 0 0 0 0 58 58 49 0 49 0
0 98 0 0 0 0 0 0 98 0 0 0 0 0 0 0 0 0 0 0 0 0 98 0 0 0 98 0 0 0 0 0 0 0 0 0 0 0 0 0 0 52 0 0 0 0 0 0 0 0 90 0 0 0 0 180 0 0 0 0 0 0 92 0
0 0 0 0 56 0 0 0 0 0 0 0 98 0 0 0 0 0 98 0 0 0 0 0 0 0 0 0 0 0 0 0 0 0 0 0 0 0 0 0 0 0 0 0 0 0 0 0 0 0 0 0 0 0 0 0 0 0 0 0 0 0 0 0
0 0 0 0 0 0 0 0 0 98 0 0 0 0 0 98 0 0 0 0 0 0 0 0 0 0 0 0 0 0 0 0 0 0 0 0 0 0 0 0 0 0 0 0 0 0 0 96 0 94 0 0 0 0 0 45 0 45 0 45 0 0 0 0
0 0 98 0 0 0 0 0 98 0 0 0 0 0 0 0 0 0 0 0 98 0 0 98 0 98 0 0 0 0 0 0 0 0 0 0 0 0 0 0 0 0 0 0 0 0 0 0 37 0 0 0 0 0 45 48 0 37 0 0 45 0 0 0
0 0 0 98 0 0 0 0 0 0 0 0 0 0 0 98 0 0 0 0 0 0 0 0 0 0 0 0 0 0 0 0 0 0 46 0 0 0 46 0 0 0 0 0 0 98 0 0 0 0 0 0 0 0 0 45 0 0 0 45 0 0 0 0
0 0 0 98 0 0 0 0 0 0 0 0 98 0 0 0 0 0 98 0 0 0 0 0 0 0 0 0 0 0 0 0 98 46 0 0 37 0 0 46 0 0 0 0 0 0 98 0 0 0 0 67 0 33 0 0 0 0 0 0 0 0 0 0
0 0 0 0 0 0 0 98 0 0 0 98 0 0 0 0 0 0 0 0 0 0 98 0 0 0 98 0 0 0 0 0 0 0 46 0 0 0 46 0 0 0 0 0 51 0 0 0 0 0 0 36 0 0 65 0 96 0 94 0 0 0 23 0
0 0 0 0 0 0 98 0 0 0 0 0 98 0 0 0 0 0 0 0 0 98 0 0 0 0 0 0 0 0 49 49 0 0 0 0 0 0 0 0 0 0 0 0 0 0 0 115 0 0 0 0 0 0 0 0 151 37 0 0 0 37 0 0
0 0 0 98 0 0 0 0 0 0 0 0 0 0 0 0 0 0 98 0 0 0 0 0 0 0 0 0 0 0 49 49 0 0 0 0 0 0 0 0 0 48 58 58 58 0 0 0 0 0 0 64 0 66 0 0 0 0 0 0 0 0 23 0
0 0 98 0 0 0 0 0 0 0 98 0 0 98 0 0 98 0 0 0 0 0 0 0 0 98 0 0 0 0 0 0 0 98 0 0 0 0 0 0 0 0 0 58 58 0 0 0 0 0 0 0 59 0 0 0 0 0 0 0 0 0 0 0
0 0 0 0 0 0 0 0 0 98 0 0 0 0 0 0 0 0 0 0 0 0 0 0 0 0 0 0 0 0 0 0 98 0 0 0 0 0 0 0 0 0 0 0 0 0 0 0 0 0 0 68 0 0 0 0 0 0 0 0 0 0 23 0
0 0 0 0 0 0 98 0 0 0 0 0 0 0 0 98 0 0 0 0 0 98 0 0 0 0 0 0 0 0 0 0 0 0 0 0 0 0 0 0 0 0 0 0 58 0 0 0 0 0 0 0 0 0 0 0 0 0 0 0 0 37 0 0
0 98 0 0 0 98 0 98 0 0 0 0 0 0 0 0 0 0 0 0 98 0 98 0 0 0 98 0 0 0 0 0 0 0 0 0 0 0 0 0 0 0 0 0 58 58 0 0 0 0 0 25 25 25 0 0 0 0 0 0 0 0 23 0
0 0 0 0 0 0 0 0 0 0 0 0 98 0 0 0 0 0 98 0 0 0 0 0 0 0 0 98 0 0 0 0 0 0 0 0 0 0 0 0 0 0 0 0 0 0 0 0 0 185 0 0 0 0 0 0 0 0 185 0 0 0 0 0
0 0 0 0 0 0 0 0 0 0 0 0 0 0 0 98 0 0 0 0 0 0 0 0 98 0 0 0 0 0 0 0 0 0 0 0 0 0 0 0 26 49 147 183 55 26 0 0 0 0 0 25 25 25 0 0 0 0 0 0 0 23 33 0
0 0 98 0 98 0 0 0 0 0 0 0 0 0 0 0 0 98 0 0 0 0 98 0 0 98 0 0 0 0 0 0 0 0 0 0 0 0 0 0 48 108 49 55 49 0 0 0 0 0 0 0 0 0 0 0 0 0 0 0 37 0 0 0
0 0 0 0 0 0 0 0 0 98 0 0 0 0 0 98 0 0 0 0 0 98 0 0 0 0 0 0 0 0 0 147 183 183 0 0 0 0 0 0 62 165 0 0 0 0 0 0 0 0 0 25 25 25 0 0 0 0 0 0 0 0 46 0
0 0 0 0 0 0 98 0 0 0 0 0 98 0 0 0 0 0 0 0 56 0 0 0 0 0 49 0 0 0 0 0 0 0 0 0 0 0 0 0 48 126 25 0 0 0 0 0 0 0 0 0 0 0 0 0 0 0 0 0 0 0 0 0
0 98 0 0 0 0 0 0 0 0 0 0 0 0 0 0 0 0 0 0 0 0 0 0 0 0 0 0 0 198 0 162 37 0 0 0 37 0 0 0 62 0 0 55 0 0 0 0 0 92 0 0 0 114 0 0 94 0 0 0 0 0 0 0
0 0 0 98 0 0 0 0 0 98 0 0 0 0 0 98 0 0 0 0 0 98 0 0 0 0 0 0 0 0 0 0 0 0 0 0 0 0 0 0 48 108 49 49 0 55 0 0 37 0 0 0 0 0 0 0 0 37 0 0 0 0 0 0
0 0 0 0 0 0 98 0 0 0 0 0 98 0 0 0 0 0 98 0 0 0 0 0 98 0 0 0 0 0 0 145 181 181 0 0 0 0 0 0 26 49 49 181 181 26 0 90 0 0 0 148 0 0 0 0 0 0 92 0 0 0 0 0
0 0 0 0 0 0 0 0 0 0 0 0 0 0 0 0 0 0 0 0 0 0 0 0 0 0 0 0 0 0 0 0 0 0 0 0 0 0 0 0 0 0 0 0 0 0 0 0 0 0 0 0 0 0 0 0 0 0 0 0 0 0 0 0
