8 8 8 9 8 8 8 8 8 8 8 8 8 8 8 9 9 9 8 9 8 9 8 19 19 19 19 19 19 19 19 19 19 19 19 19 19 19 19 19 19 19 19 25 19 19 19 19 19 19 19 19 19 19 19 19 19 19 19 19 19 19 19 19
8 8 8 8 113 113 113 8 8 8 8 8 8 8 8 9 113 113 113 113 113 113 8 115 115 115 115 19 19 19 19 19 19 115 19 19 19 19 19 19 114 114 114 114 114 114 114 19 19 114 114 114 114 114 19 106 114 114 25 19 121 121 121 19
8 8 8 9 113 113 113 8 9 8 8 9 9 8 9 8 113 113 113 113 113 113 90 115 115 115 115 115 115 115 115 115 115 115 19 19 19 19 19 19 106 114 114 114 114 114 106 19 19 19 19 19 114 114 19 114 114 114 19 19 121 121 121 19
8 8 9 8 113 113 113 9 113 113 113 113 113 113 113 113 113 113 113 113 113 113 9 115 115 115 115 19 19 19 19 19 19 106 19 19 19 19 19 19 19 19 114 114 114 19 19 19 19 19 25 19 19 19 19 114 114 114 19 19 19 121 121 19
8 8 8 113 113 113 113 8 113 113 113 113 113 113 113 113 113 113 113 8 8 9 9 19 115 115 115 19 19 25 106 115 19 115 19 19 114 114 114 114 114 114 114 114 114 114 114 114 114 114 114 114 114 106 114 114 114 114 114 114 19 19 121 19
8 9 8 113 113 113 113 9 113 113 113 113 113 113 113 113 113 113 113 9 19 19 19 19 115 115 115 19 19 19 115 115 19 19 19 19 114 114 114 114 114 114 114 114 114 114 114 114 114 114 114 114 114 114 114 114 114 114 114 114 19 121 121 19
8 8 9 8 8 9 8 8 113 113 113 8 9 8 8 9 8 9 8 8 19 19 19 19 115 115 115 115 106 115 115 115 19 19 19 19 114 114 114 19 19 19 19 19 19 19 19 19 19 19 19 19 19 19 19 19 19 19 19 19 19 121 121 19
8 113 113 113 113 113 113 113 113 113 113 9 113 113 113 113 113 8 19 19 19 19 19 19 115 115 115 115 115 115 106 115 19 19 19 19 114 114 114 19 19 19 19 19 19 19 17 17 17 17 17 17 17 17 17 17 17 17 17 17 17 17 17 17
8 113 113 113 113 113 113 113 113 113 113 9 113 113 113 113 113 8 19 19 115 115 115 115 115 115 115 19 19 19 115 115 19 19 19 19 19 91 19 19 19 19 19 19 19 19 17 121 121 106 17 121 121 121 121 121 121 121 121 17 106 121 121 17
9 113 113 113 113 113 113 113 113 113 113 9 113 113 113 113 9 9 19 19 115 115 115 115 115 115 115 19 19 19 106 115 19 19 19 19 115 115 115 19 19 19 19 19 17 17 17 121 121 121 17 121 121 121 121 121 121 121 121 17 121 106 121 17
8 113 113 113 9 8 9 8 8 9 8 8 113 113 113 113 8 19 19 19 115 115 115 115 115 115 115 19 19 19 19 19 25 19 19 19 115 115 115 19 19 19 19 17 17 21 18 121 121 121 121 121 121 121 121 121 121 121 121 17 121 121 106 17
9 113 113 113 9 19 19 19 19 19 8 8 8 9 8 8 9 19 19 19 115 115 115 19 19 19 19 19 19 115 115 115 115 115 115 115 115 115 115 19 19 19 19 17 21 121 100 121 121 121 121 121 121 121 121 121 121 121 121 100 121 106 121 17
8 113 113 113 9 19 19 19 19 19 19 19 19 19 19 19 19 19 19 19 115 115 115 19 19 19 19 19 19 115 115 115 115 115 115 115 115 115 115 19 19 19 19 17 17 21 18 121 121 121 121 121 121 121 121 121 121 121 121 17 121 121 106 17
8 9 91 8 9 19 19 19 19 19 19 19 19 19 19 19 19 19 19 19 115 115 115 19 19 19 19 19 19 115 115 115 115 115 115 115 115 115 115 19 19 19 19 19 17 17 17 121 121 121 17 121 121 121 121 121 121 121 121 17 121 106 121 17
19 112 112 112 19 19 19 19 19 19 19 142 142 142 19 115 115 115 115 115 115 115 115 115 115 115 115 115 115 115 115 115 19 19 19 19 19 19 19 19 19 106 19 19 19 19 17 121 121 106 17 121 121 121 121 121 121 121 121 17 106 121 121 17
19 112 112 112 19 19 19 25 19 19 19 142 142 142 90 115 115 115 115 115 115 115 115 115 115 115 115 115 115 115 115 115 19 115 19 19 19 19 19 19 19 120 19 17 17 17 17 17 17 17 17 17 20 93 20 17 17 20 93 20 17 17 17 17
19 112 112 112 112 112 112 112 112 112 19 142 142 142 19 115 115 115 115 115 115 115 115 115 115 115 115 115 115 115 115 115 115 19 115 115 19 120 120 120 120 120 120 18 138 138 138 138 138 106 138 138 138 138 138 138 138 138 138 106 138 138 138 17
19 112 112 112 112 112 112 112 112 112 19 19 19 19 19 19 19 115 19 19 19 115 19 19 19 115 19 19 19 115 19 19 19 19 19 115 19 120 120 120 120 120 120 90 138 138 106 138 138 138 138 138 138 138 138 138 138 138 138 138 138 138 138 17
19 112 112 112 112 112 112 112 112 112 19 19 19 19 19 19 19 19 19 19 19 19 19 19 19 19 19 19 19 19 19 115 115 115 115 115 19 120 120 120 120 120 120 18 138 138 138 138 138 138 138 138 106 138 138 138 138 138 138 138 138 138 138 17
19 19 19 19 19 19 19 112 112 112 19 19 25 19 19 19 19 19 19 19 19 19 19 19 19 19 19 19 19 19 19 115 115 115 115 115 19 120 120 120 19 120 19 17 17 17 17 17 17 17 17 17 17 17 17 17 17 17 17 17 17 17 17 17
19 19 19 19 19 19 19 112 112 112 112 112 112 112 112 112 112 112 112 112 112 112 112 112 112 112 112 112 112 112 19 115 115 19 115 115 19 120 120 120 19 106 19 19 19 19 19 19 19 19 19 19 19 19 19 19 17 138 138 138 138 138 138 17
19 19 19 19 19 19 19 112 112 112 112 112 112 112 112 112 112 112 112 112 112 112 112 112 112 112 112 112 112 112 19 115 115 115 115 115 90 120 120 120 19 19 19 19 19 19 19 19 19 19 19 19 19 19 19 19 17 138 138 138 138 138 138 17
19 19 19 19 19 19 19 112 112 112 112 112 112 112 112 112 112 112 112 112 112 112 112 112 112 112 112 112 112 112 19 115 115 19 115 115 19 120 120 120 19 19 19 19 19 19 19 19 19 19 19 19 19 19 19 19 17 17 138 138 138 138 138 17
19 111 111 111 19 19 19 19 112 112 112 19 19 19 19 19 19 19 19 19 19 19 19 19 19 25 19 112 112 112 19 115 115 115 115 115 19 120 120 120 19 19 19 19 25 19 19 19 19 19 120 120 120 19 19 19 19 17 138 138 138 138 138 17
19 111 111 111 19 19 19 19 19 91 19 19 19 19 19 19 19 19 19 19 19 19 19 19 19 19 19 112 112 112 19 115 115 115 115 115 19 120 120 120 19 19 120 120 120 120 120 19 19 19 120 120 120 19 19 19 19 17 138 138 138 138 138 17
19 19 19 19 19 19 19 19 109 109 109 19 19 19 19 25 19 19 19 19 19 19 19 19 19 19 19 19 91 19 19 19 19 19 19 115 19 120 120 120 120 120 120 120 120 120 120 120 120 120 120 120 120 19 19 19 19 17 138 138 138 138 138 17
19 109 109 109 109 109 109 109 109 109 109 109 109 109 109 109 109 19 19 19 19 19 19 25 19 19 19 109 109 109 19 19 19 19 115 115 19 120 120 120 120 120 120 120 120 120 120 120 120 120 120 120 120 19 2 1 2 1 17 17 17 17 17 17
19 109 109 109 109 109 109 109 109 109 109 109 109 109 109 109 109 19 19 106 109 109 109 109 109 19 19 109 109 109 19 19 19 19 19 19 19 120 120 120 120 120 120 120 120 120 120 120 120 120 120 120 120 120 1 119 119 2 1 19 19 19 19 19
19 109 109 109 109 109 109 109 109 109 109 109 109 109 109 109 109 109 109 109 109 109 109 109 109 109 109 109 109 109 19 111 111 111 111 111 19 19 19 19 25 19 120 120 120 120 120 19 19 19 120 120 120 120 90 119 119 119 1 2 19 19 19 19
19 109 109 109 19 19 19 19 109 109 109 19 19 19 109 109 109 109 109 109 109 15 15 109 109 109 109 109 109 109 19 111 111 111 111 111 111 111 19 19 19 19 19 19 19 19 19 19 19 19 120 120 120 120 1 119 119 119 119 1 1 19 19 19
19 109 109 109 19 19 19 19 19 25 19 19 19 19 109 109 109 109 109 109 109 109 109 109 109 109 109 109 109 109 19 19 19 19 19 19 111 111 19 111 111 111 111 19 19 19 19 19 19 19 19 19 19 19 1 1 119 119 119 119 2 19 19 19
19 109 109 109 19 19 19 19 19 19 19 19 19 19 19 19 19 19 19 106 109 109 109 109 109 19 19 19 19 19 19 19 19 19 19 19 19 19 19 111 111 111 111 19 19 19 19 19 19 19 19 19 19 19 19 1 1 119 119 119 1 19 19 19
19 109 109 109 19 19 19 19 19 19 19 19 19 19 19 19 19 19 19 19 19 19 19 19 19 19 19 19 19 19 19 111 111 111 111 111 111 111 19 19 19 111 111 19 111 106 111 19 19 19 19 19 19 19 19 19 1 119 119 119 1 19 19 19
19 109 109 109 109 109 109 109 109 109 109 109 109 109 109 109 109 109 19 19 19 19 19 19 19 19 19 19 19 19 19 111 111 111 111 111 111 111 19 111 111 111 111 19 106 111 106 19 19 19 19 19 19 19 19 19 2 119 119 119 1 2 1 19
19 109 109 109 109 109 109 109 109 109 109 109 109 109 109 109 109 109 19 25 19 19 19 19 19 19 19 25 19 19 19 19 19 19 19 19 19 19 19 19 19 19 19 19 111 111 111 19 19 19 19 19 19 19 19 19 1 119 119 119 119 119 2 19
19 109 109 109 109 109 109 109 109 109 109 109 109 109 109 109 109 109 109 109 109 109 109 109 109 109 109 109 109 109 109 19 111 111 111 111 111 111 111 111 111 111 111 111 111 111 111 106 111 111 111 111 19 19 19 19 1 119 119 119 119 119 1 19
19 19 19 19 19 19 19 19 19 19 19 19 19 19 19 109 109 109 109 109 109 109 109 109 109 109 109 109 109 109 109 90 111 111 111 111 111 111 111 111 111 111 111 111 111 111 111 111 111 111 111 106 19 19 19 19 2 119 119 119 119 119 1 19
19 19 19 19 19 13 19 19 19 19 19 19 19 19 19 109 109 109 109 109 109 109 109 109 109 109 109 109 109 109 109 19 111 111 111 111 111 111 111 111 111 111 111 111 111 111 111 19 19 19 19 19 19 19 19 19 1 119 1 119 119 119 1 19
19 19 19 19 108 108 108 19 19 19 19 19 19 19 19 19 19 19 19 19 19 19 19 19 19 19 19 19 19 19 25 19 111 111 111 19 19 19 19 19 19 19 19 19 111 111 111 19 19 19 19 19 19 19 19 19 1 106 2 119 119 119 2 19
19 19 19 19 108 108 108 19 19 106 122 122 122 122 19 19 19 19 19 19 19 19 19 19 19 19 19 19 19 19 19 19 111 111 111 19 19 19 19 19 19 19 19 19 111 111 111 19 19 19 19 19 19 19 19 19 2 1 1 119 119 119 1 19
19 19 19 19 108 108 108 108 19 122 122 122 122 122 19 19 19 19 19 19 19 19 19 19 19 19 19 19 19 19 19 19 111 111 111 19 19 19 19 116 116 116 19 19 19 91 19 19 19 19 19 19 19 19 19 19 1 1 2 119 119 119 1 19
19 19 19 19 108 108 108 108 90 122 122 122 122 122 19 19 19 19 19 19 19 19 19 19 19 106 19 19 25 19 19 19 111 111 111 25 19 19 19 116 116 116 19 19 116 116 116 19 19 19 19 19 19 19 19 1 2 1 1 119 119 119 1 19
19 19 19 19 108 108 108 108 19 122 122 122 122 122 19 19 19 108 108 108 108 108 108 108 108 108 108 19 111 111 111 106 111 106 111 19 19 19 19 19 19 19 19 19 116 116 116 19 19 118 118 118 118 118 118 3 119 119 119 119 119 119 1 19
19 19 19 19 108 108 108 19 19 122 122 122 122 122 19 19 108 108 108 108 108 108 108 108 108 108 108 90 111 111 106 111 111 111 111 19 19 19 116 116 116 116 116 116 116 116 116 19 19 118 118 118 118 118 118 90 119 119 119 119 119 119 2 19
19 19 19 19 108 108 108 19 19 19 19 19 19 19 19 108 108 108 108 108 108 108 108 108 108 108 108 19 111 111 111 111 111 106 111 19 19 19 116 116 116 116 116 116 116 106 116 19 19 118 118 118 106 118 118 3 119 119 119 119 119 119 1 19
19 19 19 19 108 108 108 19 19 19 19 19 19 19 108 108 108 108 108 108 19 19 19 19 19 106 19 19 19 19 19 19 19 19 19 19 19 19 116 116 116 116 116 116 116 116 116 19 19 118 118 118 19 19 19 1 1 2 2 2 1 2 1 19
19 19 19 19 108 108 108 19 19 108 108 108 19 19 108 108 108 108 108 19 12 12 12 12 12 19 12 12 12 12 12 12 12 12 12 12 12 19 116 116 116 19 19 19 19 19 19 19 19 118 118 118 19 19 19 19 19 19 19 19 19 19 19 19
19 19 19 19 108 108 108 19 19 108 108 108 19 19 108 108 108 108 19 19 12 117 117 117 12 12 12 117 117 117 12 12 12 117 117 117 12 19 116 116 116 19 19 19 116 116 116 116 19 118 118 118 19 19 19 19 19 19 19 19 118 118 118 19
19 19 19 19 108 108 108 19 19 108 108 108 19 108 108 108 108 19 19 12 12 117 117 117 117 117 117 117 117 117 117 117 117 117 117 117 12 19 116 116 116 19 106 19 116 116 116 116 19 118 118 118 19 19 19 19 19 19 19 19 118 118 118 19
19 19 19 19 108 108 108 19 19 108 108 108 90 108 108 108 108 19 19 12 12 12 10 12 12 12 12 12 11 12 12 12 12 12 10 12 12 19 116 116 116 116 116 19 19 116 116 116 19 118 118 118 118 118 118 19 19 19 19 19 118 118 118 19
19 19 19 19 108 108 108 19 19 108 108 108 19 108 108 108 108 19 19 12 117 117 117 117 117 117 117 117 117 117 117 117 117 117 117 117 12 19 116 116 116 116 116 19 19 19 19 19 19 118 118 118 118 118 118 19 19 19 19 118 118 118 118 19
19 19 19 19 108 108 108 19 19 108 108 108 19 19 108 108 108 19 19 12 117 117 117 117 117 117 117 117 117 117 117 117 117 117 117 117 12 19 116 116 116 116 116 19 19 19 19 19 19 118 118 118 118 118 118 19 19 19 19 118 118 118 118 19
19 19 19 19 108 108 108 19 19 108 108 108 19 19 108 108 108 19 19 12 12 12 12 12 12 12 12 12 12 12 12 12 12 117 117 117 12 19 19 19 116 116 116 19 19 19 19 19 19 19 19 19 118 118 118 19 19 19 19 19 19 19 19 19
19 106 19 19 108 108 108 19 19 19 19 19 19 19 108 108 108 19 25 19 19 19 19 19 19 19 19 19 25 19 19 11 117 117 117 117 117 11 19 19 116 116 116 19 19 19 19 19 19 19 19 19 118 118 118 118 118 118 118 118 118 118 19 19
19 108 108 108 108 108 108 108 106 108 106 108 19 19 108 108 108 108 108 108 108 19 19 110 110 110 110 110 110 110 19 12 12 117 117 117 12 12 19 19 116 116 116 19 19 19 19 19 19 19 19 19 118 118 118 118 118 118 118 118 118 118 19 19
19 108 108 108 108 108 108 108 108 108 108 108 19 19 108 108 108 108 108 108 108 19 19 110 110 110 110 110 110 110 19 12 12 117 117 117 12 12 19 19 116 116 116 116 116 116 116 116 116 19 19 19 118 118 118 118 118 118 118 118 118 118 19 19
19 108 108 108 108 108 108 108 108 108 108 108 19 19 108 108 108 108 108 108 108 19 19 19 110 110 110 110 110 110 19 10 117 117 117 117 117 10 19 19 116 116 116 116 116 116 116 116 116 19 19 19 19 19 19 19 19 19 19 19 91 19 19 19
19 19 19 19 91 19 19 19 19 108 108 108 19 19 19 19 19 19 108 108 108 108 19 110 110 110 110 110 110 110 19 12 12 117 117 117 12 12 19 19 116 116 116 116 116 116 116 116 116 19 19 116 116 116 116 116 19 19 19 116 116 116 19 19
19 19 19 19 108 19 19 19 19 108 108 108 19 19 19 19 19 19 108 108 108 108 90 110 110 110 110 110 110 110 19 19 12 117 117 117 12 12 19 19 19 19 19 19 19 116 116 116 116 19 116 106 19 116 19 106 116 19 19 116 116 116 19 19
19 19 19 108 108 108 19 19 19 108 108 108 19 19 19 19 19 19 108 108 108 108 19 110 110 110 110 110 110 110 25 19 12 117 117 117 12 12 19 19 19 19 19 19 116 116 116 116 116 19 19 19 19 116 19 19 19 19 116 116 116 116 19 19
19 19 108 108 108 108 108 19 19 108 108 108 108 108 108 108 108 108 108 108 108 19 19 19 110 110 110 110 110 110 19 19 12 117 117 117 117 12 116 116 116 116 116 116 116 116 116 116 116 116 116 116 116 116 116 116 116 116 116 116 116 19 19 19
19 108 108 108 108 108 108 108 19 108 108 108 108 108 108 108 108 108 108 108 108 19 19 106 110 110 110 110 110 110 25 19 12 117 117 117 117 90 116 116 116 116 116 116 116 116 19 116 116 116 116 116 116 116 116 116 116 116 116 116 19 19 19 19
19 108 108 108 108 108 108 108 19 108 108 108 108 108 108 108 108 108 108 108 108 19 19 110 110 110 110 110 110 110 19 19 12 117 117 117 117 12 116 116 116 116 116 116 116 19 19 19 116 116 116 116 116 116 116 116 116 116 116 19 19 19 19 19
19 19 19 19 19 19 19 19 19 19 19 19 19 19 19 19 19 19 19 19 19 19 19 19 19 25 19 19 19 19 19 19 12 12 12 12 12 12 19 19 19 19 19 19 19 19 19 19 19 19 19 19 19 19 19 19 19 19 19 19 19 19 19 19
