0 0 0 0 0 0 0 0 0 0 0 0 0 0 0 0 0 0 0 0 0 0 0 0 0 0 0 0 0 0 0 0 0 0 0 0 0 0 0 0 0 0 0 0 0 0 0 0 0 0 0 0 0 0 0 0 0 0 0 0 0 0 0 0
0 0 0 0 0 0 0 0 0 0 0 0 0 0 0 35 0 0 0 0 0 0 0 0 54 52 35 0 0 0 0 0 0 0 0 0 0 0 0 0 0 0 0 0 0 0 0 0 0 0 53 0 0 53 53 53 53 53 0 200 49 0 0 0
0 0 0 0 0 0 0 0 0 0 0 0 0 0 0 0 0 0 144 0 0 0 108 0 0 0 54 0 0 0 0 0 0 0 0 0 0 0 0 0 0 0 0 0 0 0 0 110 0 0 25 0 0 0 53 53 53 0 0 0 0 25 0 0
0 0 0 0 0 0 0 0 0 0 0 0 0 0 0 0 0 0 0 0 0 0 0 0 128 36 53 0 0 37 0 0 0 37 0 0 0 37 0 0 0 37 0 0 0 37 0 0 0 0 0 0 0 0 0 0 0 0 0 0 0 53 0 0
0 0 0 0 0 0 0 0 0 0 0 0 0 0 0 0 0 0 144 0 0 0 108 0 0 0 53 0 0 0 0 0 0 0 0 0 0 0 0 0 0 0 0 0 0 0 0 110 0 0 0 0 0 25 0 54 54 0 25 0 0 0 0 0
0 0 0 0 0 0 0 0 0 0 0 0 0 0 0 35 0 0 0 0 0 0 182 0 0 52 35 0 0 0 0 0 0 0 0 0 0 0 0 0 0 0 0 0 0 0 0 0 0 0 0 27 0 0 0 0 0 0 0 0 27 0 0 0
0 0 0 0 0 0 0 0 0 0 0 0 0 0 0 0 0 0 0 0 0 0 0 0 0 0 0 0 0 0 0 0 0 0 0 0 0 0 0 0 0 0 0 0 0 0 0 0 0 0 0 0 0 25 0 0 0 0 25 0 0 0 0 0
0 0 0 0 0 0 0 0 0 0 0 0 0 0 0 0 0 0 0 0 0 0 0 0 0 0 0 0 0 0 0 0 0 0 0 0 0 0 0 0 0 0 0 0 0 0 0 0 0 0 0 0 0 0 0 0 0 0 0 0 127 54 0 0
0 0 0 0 0 0 0 0 0 0 0 0 0 0 0 0 37 0 0 0 37 0 0 0 0 37 0 0 0 37 0 0 0 37 0 0 0 37 0 0 0 37 0 0 0 37 0 0 0 0 25 0 163 54 0 52 0 0 0 0 0 25 0 0
0 0 0 0 0 0 0 0 0 0 0 0 0 0 0 0 0 0 0 0 0 0 0 0 0 0 0 0 0 0 0 0 0 0 0 0 0 0 0 0 0 0 0 0 0 0 0 0 0 0 0 0 0 0 52 52 52 0 48 0 49 0 53 0
0 0 0 0 0 0 0 0 0 0 0 0 0 0 0 0 0 0 0 0 0 0 0 0 0 0 0 0 0 0 0 0 0 0 0 0 0 0 0 0 0 0 0 0 0 0 0 0 0 0 0 0 0 0 0 0 0 0 0 0 0 0 0 0
0 0 0 0 0 0 0 0 0 0 0 0 0 0 0 49 47 49 0 0 31 0 0 0 180 0 0 0 0 0 0 0 0 0 0 0 52 0 54 54 0 0 0 0 0 0 0 0 0 33 0 0 0 0 0 38 0 0 0 0 0 0 0 0
0 0 0 0 0 0 0 0 0 0 0 0 0 0 0 0 0 0 0 98 0 0 0 37 0 0 0 37 0 0 0 37 0 0 0 52 26 0 0 0 26 54 0 0 0 37 0 0 0 0 37 0 49 165 37 48 0 0 0 0 0 47 0 0
0 0 0 0 0 0 0 0 0 0 0 0 0 0 0 49 47 49 0 0 31 0 0 0 0 0 0 144 0 0 0 0 111 0 0 52 52 0 25 0 54 0 0 0 0 0 0 0 0 0 36 0 0 0 36 0 0 0 0 0 24 47 0 0
0 0 0 0 47 0 0 47 47 0 49 0 0 0 0 0 0 0 0 0 0 0 0 0 0 0 0 0 0 0 0 0 0 0 0 53 0 0 0 0 0 0 0 0 0 0 0 0 0 0 0 0 0 0 0 0 0 0 0 24 24 24 0 0
0 0 26 49 47 0 0 0 0 47 0 26 0 0 0 0 0 0 0 0 0 0 0 0 0 0 0 0 0 0 0 37 0 0 0 0 108 0 0 0 0 53 0 0 111 0 0 0 0 0 37 129 0 0 37 0 0 0 0 0 24 0 0 0
0 0 111 0 25 0 0 0 0 25 0 0 0 0 0 0 0 0 0 0 0 0 0 0 0 0 0 0 0 0 0 0 0 0 0 0 0 0 25 0 0 0 0 0 0 37 0 0 0 0 36 0 0 0 36 0 0 96 212 0 0 94 0 0
0 0 0 0 0 0 0 0 0 0 0 0 0 0 0 0 0 0 0 0 0 0 0 0 0 0 0 0 0 0 0 0 0 0 0 0 26 0 0 0 26 0 0 0 0 0 0 0 0 0 0 0 0 0 0 0 0 0 0 0 0 0 0 0
0 0 0 0 0 0 0 0 0 0 146 0 0 0 0 0 0 0 0 0 0 0 0 0 0 0 0 0 0 0 0 0 0 0 0 0 180 0 0 0 0 0 0 0 0 0 0 0 0 0 0 0 0 0 200 0 0 90 0 0 0 92 0 0
0 0 0 0 0 0 0 0 0 0 0 0 0 0 0 0 0 0 0 0 0 0 0 0 0 0 0 0 0 0 0 0 0 0 0 0 0 0 0 0 0 0 0 0 0 0 0 0 0 0 0 0 0 0 0 0 0 0 0 0 0 0 0 0
0 0 180 0 0 0 0 0 0 0 0 182 0 0 0 0 0 0 0 0 0 0 0 0 0 0 0 0 0 0 0 0 0 0 0 0 0 0 0 0 0 0 0 0 34 0 34 0 0 0 0 0 0 0 0 0 0 0 0 0 0 0 0 0
0 0 0 0 0 0 0 0 0 0 0 0 0 0 0 0 0 0 0 0 0 0 0 0 0 0 0 0 0 0 37 0 0 37 0 0 37 0 0 37 0 0 37 0 0 37 0 180 37 0 0 37 0 0 37 0 0 37 0 0 37 0 0 0
0 0 0 0 34 0 0 0 0 34 0 0 0 0 0 0 0 0 0 0 0 0 0 0 0 0 0 0 0 0 0 0 0 0 0 0 0 0 0 0 0 0 0 0 0 0 0 0 0 0 0 0 0 144 0 0 0 0 0 0 0 0 0 0
0 0 96 0 0 0 0 150 0 0 0 94 0 0 0 0 0 0 0 0 0 0 0 0 0 0 0 0 0 0 0 0 0 0 0 0 0 0 0 0 0 0 0 0 0 0 0 0 0 0 0 0 0 0 0 0 0 0 0 0 0 0 0 0
0 0 141 0 0 0 0 0 0 0 0 0 0 0 0 0 0 0 180 0 0 0 0 0 0 0 0 0 0 0 0 0 0 0 0 0 0 0 0 0 0 0 0 0 0 0 0 0 0 0 0 0 0 0 0 110 0 0 0 0 0 0 0 0
0 0 0 0 90 0 0 0 0 96 0 0 0 0 0 0 0 0 0 0 0 0 0 0 0 108 0 0 0 0 0 0 0 37 0 0 0 0 0 37 0 0 0 0 0 37 0 0 0 0 0 37 0 0 37 0 0 37 0 0 37 0 0 0
0 0 0 37 0 0 0 0 0 0 37 0 0 0 0 0 0 0 0 0 0 0 0 0 0 0 0 0 0 0 0 0 0 0 0 0 0 0 0 0 0 0 0 0 0 0 0 0 0 0 31 0 31 0 0 0 0 0 0 31 0 31 0 0
0 0 0 0 0 0 0 0 0 0 0 0 0 0 0 0 0 0 0 0 0 0 0 0 0 0 0 0 0 0 0 0 0 0 0 0 0 0 0 0 0 0 98 0 0 0 0 0 0 0 0 0 0 0 0 0 0 0 0 0 0 0 0 0
0 0 0 0 131 0 0 0 0 0 0 0 0 0 0 0 0 0 0 0 0 0 0 0 0 0 0 0 0 0 0 0 0 0 0 0 0 0 0 0 0 0 0 0 0 0 0 0 0 0 0 0 0 0 0 0 0 0 0 0 0 0 0 0
0 0 0 37 0 0 0 0 0 133 37 0 0 0 0 0 0 0 0 0 0 0 0 0 0 0 0 0 0 0 0 0 0 0 0 0 0 0 0 0 0 0 0 49 0 0 0 0 31 0 0 0 0 182 0 31 0 0 0 0 0 0 34 0
0 0 0 0 0 0 0 0 0 0 0 0 0 0 0 0 0 0 0 0 0 0 0 0 0 0 0 0 0 0 0 37 0 0 0 51 0 0 0 183 0 0 0 49 0 49 31 0 53 0 0 0 0 0 0 0 0 0 0 0 0 0 0 0
0 0 0 0 0 0 0 0 0 0 0 0 0 0 0 0 0 0 0 0 0 0 0 0 0 0 0 0 110 0 0 0 0 0 0 49 0 0 0 0 0 0 0 49 0 108 0 0 0 53 0 0 0 0 0 0 0 0 0 0 35 54 54 0
0 0 0 0 0 0 0 0 0 0 0 0 0 0 0 0 0 0 0 0 0 0 0 0 0 0 0 0 0 0 0 0 0 0 0 0 98 0 0 0 0 0 0 0 0 53 0 53 0 0 0 0 0 0 0 0 0 0 0 0 0 0 54 0
0 0 0 37 0 0 0 0 0 0 37 113 0 0 0 97 0 0 0 110 0 0 0 0 0 0 0 0 0 0 0 0 0 0 0 49 108 0 0 37 0 39 0 0 0 31 0 0 0 31 0 0 0 145 0 0 0 0 0 0 0 31 0 0
0 0 0 0 0 0 0 0 0 90 0 92 0 0 91 0 95 0 164 0 0 43 0 0 0 0 0 0 0 0 0 0 47 0 0 0 0 0 0 0 0 0 0 0 0 0 0 108 0 0 0 0 0 0 0 0 0 0 109 0 34 0 0 0
0 0 0 0 0 0 0 0 0 0 0 0 0 0 0 93 212 0 0 0 0 0 0 0 183 25 49 0 0 58 181 47 47 0 0 0 0 0 0 0 0 0 0 0 0 0 35 53 53 0 0 0 0 0 0 0 0 0 53 0 0 0 0 0
0 0 0 0 0 0 0 0 0 0 0 0 0 0 0 0 0 0 0 0 0 0 0 0 0 37 49 0 0 0 0 0 0 0 0 0 0 0 0 0 0 0 0 0 0 0 0 0 0 0 0 0 0 0 0 0 0 0 0 0 0 0 0 0
0 0 0 37 0 0 0 0 0 0 0 0 0 0 0 0 0 0 0 0 0 0 0 0 0 0 0 0 0 0 0 0 0 0 0 0 0 0 0 0 0 0 0 0 0 0 0 0 0 0 0 0 0 0 0 0 0 0 0 0 0 0 0 0
0 0 0 0 0 0 0 0 0 53 0 0 0 0 0 0 0 0 0 0 0 0 0 0 0 0 0 0 0 28 0 0 28 0 0 0 0 0 0 96 0 0 0 58 58 96 0 53 53 0 0 0 0 0 0 0 0 0 0 94 58 58 0 0
0 0 0 0 0 0 0 0 0 146 53 0 0 0 0 28 0 0 0 0 0 0 0 0 0 0 0 0 0 0 0 0 0 0 32 0 0 0 0 0 0 0 0 58 23 0 53 0 0 0 0 58 0 0 0 0 47 0 0 0 57 47 0 0
0 0 0 0 185 0 0 0 0 37 36 110 0 0 0 0 0 0 0 0 0 0 0 0 0 0 0 0 0 0 0 0 0 0 146 24 0 0 0 0 0 0 0 47 0 0 0 0 23 0 0 0 0 0 0 0 0 47 0 0 0 53 59 0
0 0 0 37 139 0 0 0 0 0 0 0 0 0 0 0 110 37 0 0 0 0 0 0 0 37 0 0 0 0 0 0 37 0 0 0 0 0 0 37 0 0 0 0 36 0 0 0 0 0 0 29 36 36 0 0 0 0 0 0 0 36 0 0
0 0 90 0 92 0 0 0 0 0 200 0 0 0 0 0 0 0 0 201 0 0 0 0 0 0 0 0 0 0 0 0 0 0 0 32 0 0 0 115 0 0 0 47 0 90 0 0 0 0 138 0 0 0 0 0 0 0 0 92 53 47 60 0
0 0 0 0 0 0 0 0 0 0 0 0 0 0 0 28 164 0 0 0 28 0 0 0 0 0 0 0 0 0 0 0 0 0 0 199 33 0 0 0 0 0 0 0 0 0 0 0 0 0 0 0 0 0 0 0 0 0 0 0 0 0 0 0
0 0 0 0 0 0 0 0 0 0 0 0 0 0 0 0 0 0 0 0 0 0 0 0 0 0 0 0 0 0 0 0 0 0 0 0 36 0 0 0 0 0 0 0 24 0 24 0 0 24 0 0 24 24 23 0 24 0 0 24 0 24 0 0
0 0 0 0 0 0 0 0 0 0 0 0 0 0 0 0 0 0 0 0 0 0 0 34 0 0 0 34 0 0 0 0 0 0 0 0 0 0 0 37 0 0 0 0 0 0 0 0 0 0 0 0 0 0 0 0 23 0 0 0 0 0 0 0
0 0 0 30 0 0 0 0 0 0 0 0 0 0 0 0 0 0 0 0 0 0 0 0 0 0 0 0 0 0 0 0 0 0 0 0 0 0 0 0 0 0 0 38 108 0 0 0 0 0 25 25 0 0 25 25 0 0 0 0 111 0 38 0
0 0 0 0 0 109 0 0 0 0 96 37 0 0 0 0 0 37 0 0 0 37 0 0 0 37 0 0 0 37 0 0 0 37 114 0 0 0 0 0 0 0 0 0 0 0 0 0 0 0 0 0 0 0 0 0 0 0 0 0 0 0 0 0
0 0 0 0 163 37 0 0 0 0 0 0 0 0 0 0 0 0 0 0 0 0 0 0 0 0 0 0 0 0 0 0 0 0 0 0 0 0 0 0 0 0 0 38 25 0 0 0 0 0 0 0 0 0 0 0 0 0 0 0 0 25 38 0
0 0 0 0 0 0 0 0 0 0 0 0 0 0 0 0 0 0 0 0 0 0 0 0 0 0 0 0 0 0 0 0 0 0 0 0 0 0 0 37 0 0 0 0 0 0 0 0 0 0 0 47 47 0 0 0 0 0 0 0 0 0 182 0
0 0 0 30 0 0 0 0 0 0 90 0 0 0 0 0 96 0 0 0 0 0 0 0 0 0 0 0 0 0 0 0 0 49 49 0 50 0 0 0 0 0 0 0 0 0 0 0 0 0 0 0 0 0 0 0 0 0 0 0 0 0 0 0
0 0 0 0 0 0 199 0 0 0 0 0 0 0 110 0 37 0 0 42 47 0 0 0 0 0 0 0 0 0 0 0 0 49 49 0 0 0 0 0 0 0 0 0 0 0 0 0 0 0 0 0 0 0 0 0 0 0 0 0 0 0 0 0
0 0 0 0 0 0 0 0 0 0 0 0 0 0 0 0 0 0 0 0 0 0 0 0 0 37 0 0 0 32 0 0 0 49 0 0 0 0 0 0 0 0 0 53 25 0 0 25 0 0 0 0 0 0 0 25 0 0 25 0 0 25 0 0
0 0 0 0 0 0 0 0 0 0 0 0 0 0 0 0 96 0 0 0 0 0 0 0 0 0 0 0 0 0 0 0 0 0 0 0 0 0 0 37 0 0 0 0 0 0 0 0 0 0 0 0 0 0 0 146 0 0 0 0 0 0 0 0
0 33 0 0 0 0 90 138 0 94 0 0 46 46 0 0 0 0 0 0 0 0 0 0 0 0 0 0 0 0 0 0 0 0 0 0 0 0 0 0 0 0 0 0 26 0 0 0 0 0 0 27 0 0 0 0 0 0 0 0 0 26 0 0
0 46 0 29 36 0 23 0 0 46 0 0 0 46 0 0 37 0 0 0 0 0 0 0 0 0 0 0 0 0 0 0 0 0 0 0 0 0 0 0 0 0 0 0 0 108 0 0 0 0 0 0 0 0 0 0 0 0 0 0 0 110 53 0
0 23 0 95 0 0 0 0 0 0 0 0 0 0 0 0 0 0 0 0 0 0 0 0 0 0 0 0 0 0 0 42 0 0 0 0 0 0 0 0 0 0 0 49 25 0 0 25 0 0 0 0 0 0 0 25 0 0 25 0 0 25 49 0
0 0 0 0 93 0 94 0 95 176 0 94 0 0 0 0 0 0 0 32 0 0 0 0 0 37 0 0 47 0 0 0 0 53 52 0 0 0 0 37 0 0 0 180 0 0 0 0 0 0 0 0 0 0 0 182 0 0 0 0 0 0 0 0
0 97 0 0 0 97 0 93 0 0 0 0 93 0 0 0 0 0 0 0 0 0 0 0 0 0 0 0 0 0 0 0 0 54 53 52 0 0 0 0 0 0 0 0 0 0 0 0 0 0 0 0 0 0 0 0 0 0 0 0 0 0 0 0
0 0 95 0 91 0 90 0 0 0 0 91 0 0 0 0 37 0 0 42 0 0 0 0 0 0 0 0 0 0 0 0 0 54 54 53 0 0 0 0 0 0 0 0 0 0 0 0 0 0 0 0 0 0 0 0 0 0 0 0 0 0 0 0
0 96 0 0 92 0 0 0 0 0 0 0 0 0 0 0 92 0 0 0 0 0 0 0 0 37 0 0 47 0 0 0 0 0 0 0 0 0 0 0 0 0 0 0 0 34 0 34 0 0 34 0 34 0 0 24 23 0 0 0 0 33 0 0
0 90 138 91 0 0 96 29 0 94 0 0 0 0 0 0 19 0 0 0 0 0 47 0 0 0 0 0 0 0 0 42 0 0 0 0 0 98 0 37 0 0 0 37 0 110 0 37 0 0 0 37 0 0 0 0 0 0 0 0 0 0 0 0
0 0 0 0 23 0 90 174 0 92 0 90 138 94 0 0 0 0 0 0 0 0 0 0 0 109 0 0 0 0 0 0 0 0 0 0 0 0 0 92 0 0 0 0 0 0 0 0 0 146 0 0 0 0 0 24 23 181 0 0 0 33 0 0
0 0 0 0 0 0 0 0 0 0 0 0 0 0 0 0 0 0 0 0 0 0 0 0 0 0 0 0 0 0 0 0 0 0 0 0 0 0 0 0 0 0 0 0 0 0 0 0 0 0 0 0 0 0 0 0 0 0 0 0 0 0 0 0
