2 1 1 1 1 2 2 1 2 2 2 2 2 1 1 1 1 1 1 1 13 1 2 1 1 2 1 1 1 2 2 1 1 2 2 1 2 2 1 9 8 9 9 8 8 8 8 9 9 9 9 9 9 9 9 8 8 8 8 8 8 8 8 9
1 1 1 109 109 109 109 109 109 109 109 109 1 109 109 1 1 1 108 108 108 108 108 1 112 112 112 112 112 112 112 112 112 112 112 112 112 112 112 8 112 112 112 112 112 9 112 112 112 112 112 9 143 143 143 143 143 9 112 112 112 112 112 9
2 1 109 109 109 109 109 109 109 109 109 109 1 109 109 109 109 6 108 108 108 108 108 6 112 112 112 112 112 112 112 112 112 112 112 112 1 112 112 8 112 112 112 112 112 8 112 112 112 112 112 9 143 143 143 143 143 9 112 112 112 112 112 8
1 1 109 109 109 1 1 1 1 1 1 1 1 109 109 109 109 1 108 108 108 108 108 1 112 112 112 112 1 112 112 112 112 112 112 112 1 112 112 8 112 112 112 112 112 8 112 112 112 112 112 8 143 143 143 143 143 8 112 112 112 112 112 8
2 1 1 1 2 1 2 2 1 2 1 2 1 1 2 1 2 2 1 108 108 108 1 1 2 1 2 1 1 1 1 1 2 2 2 2 1 2 2 8 112 112 112 112 112 9 112 112 112 112 112 9 143 143 143 143 143 9 112 112 112 112 112 9
1 109 109 109 109 109 109 109 109 109 109 109 1 108 108 108 108 108 108 108 108 108 108 108 108 108 108 108 1 109 109 109 109 109 109 109 109 109 1 9 112 112 112 112 112 8 112 112 112 112 112 8 143 143 143 143 143 8 112 112 112 112 112 8
1 109 109 109 109 109 109 109 109 109 109 109 90 108 108 108 108 108 108 108 108 108 108 108 108 108 108 108 90 109 109 109 109 109 109 109 109 109 1 9 9 8 91 8 9 9 8 9 91 8 9 8 8 8 91 8 9 8 8 8 91 8 9 8
1 109 109 109 109 109 109 109 109 109 109 109 1 108 108 108 108 108 108 108 108 108 108 108 108 108 108 108 1 109 109 109 109 109 109 109 109 109 109 9 112 112 112 112 112 112 112 112 112 112 112 112 112 112 112 112 112 112 112 112 112 112 112 7
2 109 109 109 109 1 1 1 2 2 2 2 1 1 1 2 2 1 1 1 91 1 1 1 1 2 1 1 1 1 1 1 2 1 1 109 109 109 109 8 112 112 112 112 112 112 112 112 112 112 112 112 112 112 112 112 112 112 112 112 112 112 112 8
1 1 109 109 1 1 109 109 109 109 109 1 1 127 127 127 127 127 1 142 142 142 1 128 128 128 128 128 2 1 109 109 109 109 1 109 109 109 109 90 112 112 112 112 112 112 112 112 112 112 112 112 112 112 112 112 112 112 112 112 112 112 112 5
1 3 109 109 3 3 109 109 109 109 109 109 6 127 127 127 127 127 90 142 142 142 90 128 128 128 128 128 6 109 109 109 109 109 3 109 109 109 109 8 112 112 112 112 112 112 112 112 112 112 112 112 112 112 112 112 112 112 112 112 112 112 112 8
1 1 109 109 1 1 109 109 109 109 109 109 1 127 127 127 127 127 2 142 142 142 1 128 128 128 128 128 1 109 109 109 109 109 2 109 109 109 109 8 112 112 112 112 112 112 112 112 112 112 112 112 112 112 112 112 112 112 112 112 112 112 112 5
2 109 109 109 109 1 2 1 2 2 1 6 1 1 2 1 1 1 2 2 6 1 1 1 1 1 2 1 1 1 1 1 2 2 1 109 109 109 1 9 8 8 91 8 9 8 9 8 91 8 9 8 9 8 91 8 8 9 8 8 91 8 8 8
1 109 109 109 109 109 109 1 3 1 109 109 109 1 4 1 109 109 109 1 6 1 109 109 109 109 109 109 109 109 109 109 109 109 109 109 109 109 1 8 112 112 112 112 112 8 112 112 112 112 112 9 112 112 112 112 112 8 112 112 112 112 112 9
1 109 109 109 109 109 109 109 109 109 109 109 109 109 109 109 109 109 109 109 109 109 109 109 109 109 109 109 109 109 109 109 109 109 109 109 109 109 1 9 112 112 112 112 112 9 112 112 112 112 112 9 112 112 112 112 112 9 112 112 112 112 112 8
2 109 109 109 109 109 109 109 109 109 109 109 109 109 109 109 109 109 109 109 109 109 109 109 109 109 109 109 109 109 109 109 109 109 109 109 109 109 1 9 112 112 112 112 112 9 112 112 112 112 112 8 112 112 112 112 112 8 112 112 112 112 112 8
1 109 109 109 109 109 109 1 3 2 109 109 109 1 4 2 109 109 109 109 109 109 109 109 109 109 109 109 109 109 109 109 109 1 6 1 109 109 1 8 112 112 112 112 112 9 112 112 112 112 112 9 112 112 112 112 112 9 112 112 112 112 112 9
1 1 2 1 1 1 2 1 2 2 1 6 2 1 2 2 1 2 1 109 109 109 1 3 2 2 3 2 109 109 109 2 2 1 1 2 1 1 1 8 112 112 112 112 112 9 112 112 112 112 112 8 112 112 112 112 112 8 112 112 112 112 112 8
15 15 15 15 15 15 15 15 15 15 15 15 15 15 15 15 1 2 1 2 91 1 1 1 1 1 1 1 2 91 2 1 1 1 1 1 1 1 2 8 8 9 9 8 8 9 8 8 9 9 8 9 9 8 9 8 8 9 8 9 8 9 9 9
15 121 121 121 121 121 121 121 121 121 121 121 121 121 121 15 1 113 113 113 113 113 113 113 113 113 113 113 113 113 113 113 113 113 113 113 113 113 113 1 2 3 2 1 1 2 1 1 2 1 2 3 1 1 2 1 1 2 1 2 2 3 1 1
15 121 121 121 121 121 121 121 121 121 121 121 121 121 121 15 1 113 113 113 113 113 113 113 113 113 113 113 113 113 113 113 113 113 113 113 113 113 113 2 139 139 139 139 139 139 139 139 139 139 139 139 139 139 139 139 139 139 139 139 139 139 139 1
15 121 15 15 15 15 15 15 15 15 15 15 15 15 15 15 1 113 113 113 113 113 113 113 113 113 113 113 113 113 113 113 113 113 113 113 113 113 113 1 139 139 139 139 139 139 139 139 139 139 139 139 139 139 139 139 139 139 139 139 139 139 139 1
15 121 15 1 2 1 1 1 2 1 1 1 1 1 1 1 1 1 1 1 1 1 2 1 1 2 1 1 2 2 1 1 1 2 1 1 113 113 113 1 139 139 139 139 139 139 139 139 139 139 139 139 139 139 139 139 139 139 139 139 139 139 139 1
15 121 15 2 130 130 130 130 130 130 130 1 1 2 6 1 6 1 1 2 132 132 132 132 132 132 132 1 1 133 133 133 133 133 2 2 113 113 113 1 139 139 139 12 12 12 12 10 12 12 12 12 12 12 12 10 12 12 12 12 139 139 139 2
15 121 15 1 130 130 130 130 130 130 130 1 131 131 131 131 131 131 131 2 132 132 132 132 132 132 132 2 133 133 133 133 133 133 133 1 113 113 113 2 139 139 139 12 140 140 140 140 140 140 140 12 141 141 141 141 141 141 141 12 139 139 139 1
15 121 15 1 130 130 130 130 130 130 130 2 131 131 131 131 131 131 131 1 132 132 132 132 132 132 132 1 133 133 133 133 133 133 133 1 113 113 113 1 139 139 139 12 140 140 140 140 140 140 140 12 141 141 141 141 141 141 141 12 139 139 139 1
15 121 15 2 130 130 130 130 130 130 130 90 131 131 131 131 131 131 131 90 132 132 132 132 132 132 132 90 133 133 133 133 133 133 133 2 113 113 113 4 139 139 139 12 140 140 140 140 140 140 140 12 141 141 141 141 141 141 141 12 139 139 139 4
15 121 15 1 130 130 130 130 130 130 130 1 131 131 131 131 131 131 131 1 132 132 132 132 132 132 132 1 133 133 133 133 133 133 133 1 113 113 113 1 139 139 139 12 140 140 140 140 140 140 140 12 141 141 141 141 141 141 141 12 139 139 139 1
15 121 15 2 130 130 130 130 130 130 130 1 131 131 131 131 131 131 131 2 132 132 132 132 132 132 132 2 133 133 133 133 133 133 133 1 113 113 113 1 139 139 139 12 140 140 140 140 140 140 140 12 141 141 141 141 141 141 141 12 139 139 139 1
15 121 15 1 130 130 130 130 130 130 130 1 1 2 6 2 6 2 1 1 132 132 132 132 132 132 132 1 2 133 133 133 133 133 1 1 113 113 113 2 139 139 139 12 12 12 12 11 12 91 12 12 12 91 12 11 12 12 12 12 139 139 139 1
15 121 15 1 2 2 1 91 1 2 2 1 1 1 2 1 1 2 1 1 1 1 1 1 1 1 1 2 1 1 2 2 1 2 1 1 113 113 113 1 139 139 139 139 139 139 139 139 139 139 139 139 139 139 139 139 139 139 139 139 139 139 139 1
15 121 15 2 1 129 129 129 129 129 1 1 2 2 2 2 2 2 2 1 1 1 1 1 1 1 1 1 1 1 2 4 1 2 2 1 113 113 113 1 139 139 139 139 139 139 139 139 139 139 139 139 139 139 139 139 139 139 139 139 139 139 139 2
15 121 15 1 129 129 129 129 129 129 129 1 2 2 2 2 2 2 2 2 1 1 1 1 1 1 1 2 2 126 126 126 126 126 126 2 113 113 113 1 139 139 139 139 139 139 139 139 139 139 139 139 139 139 139 139 139 139 139 139 139 139 139 1
15 121 15 1 129 129 129 129 129 129 129 2 2 2 2 2 2 2 2 1 1 1 1 1 1 1 1 1 1 126 126 126 126 126 126 1 113 113 113 2 1 3 2 2 1 1 1 1 1 2 2 3 2 1 1 2 1 1 2 1 6 91 6 1
15 121 15 2 129 129 129 129 129 129 129 1 2 2 2 2 2 2 2 2 1 1 1 1 1 1 1 1 3 126 126 126 126 126 126 90 113 113 113 1 138 138 138 138 138 138 138 138 138 138 138 138 138 138 138 138 138 138 138 1 136 136 136 2
15 121 15 1 129 129 129 129 129 129 129 2 2 2 2 2 2 2 2 1 1 1 1 1 1 1 1 2 1 126 126 126 126 126 126 1 113 113 113 2 138 138 138 138 138 138 138 138 138 138 138 138 138 138 138 138 138 138 138 2 136 136 136 1
15 121 15 1 129 129 129 129 129 129 129 1 2 2 2 2 2 2 2 1 1 1 1 1 1 1 1 2 2 126 126 126 126 126 126 2 113 113 113 2 138 138 138 138 138 138 138 138 138 138 138 138 138 138 138 138 138 138 138 2 136 136 136 1
15 121 15 1 1 129 129 129 129 129 1 2 2 2 2 2 2 2 2 1 1 1 1 1 1 1 1 1 2 126 126 126 126 126 126 1 113 113 113 2 138 138 138 1 1 1 1 1 138 138 138 1 1 1 1 1 138 138 138 1 136 136 136 1
15 121 15 1 1 1 1 91 1 1 2 1 2 1 2 2 1 2 1 1 1 1 1 1 1 1 1 1 1 1 1 91 1 1 1 1 113 113 113 2 138 138 138 1 138 138 138 138 138 138 138 1 138 138 138 1 138 138 138 2 136 136 136 2
15 121 15 1 1 122 122 122 122 122 122 1 123 123 123 123 123 123 123 1 1 1 1 1 1 1 1 1 125 125 125 125 125 125 125 1 113 113 113 1 138 138 138 1 138 138 138 138 138 138 138 1 138 138 138 1 138 138 138 1 136 136 136 1
15 121 15 1 122 122 122 122 122 122 122 2 123 123 123 123 123 123 123 1 1 1 1 1 1 1 1 1 125 125 125 125 125 125 125 1 113 113 113 1 138 138 138 1 138 138 138 138 138 138 138 1 138 138 138 1 138 138 138 1 136 136 136 1
15 121 15 1 2 122 122 122 122 122 122 1 123 123 123 123 123 123 123 1 1 1 1 1 1 1 1 1 125 125 125 125 125 125 125 1 113 113 113 1 1 93 2 1 1 2 1 2 138 138 138 1 1 138 1 1 138 138 138 1 136 136 136 2
15 121 15 1 122 122 122 122 122 122 122 90 123 123 123 123 123 123 1 1 1 1 1 1 1 1 1 1 125 125 125 125 125 125 125 90 113 113 113 2 137 137 137 2 1 1 21 3 138 138 138 138 138 138 138 138 138 138 138 2 136 136 136 1
15 121 15 1 1 122 122 122 122 122 122 1 123 123 123 123 123 123 123 1 1 1 1 1 1 1 1 1 125 125 125 125 125 125 125 1 113 113 113 1 137 137 137 2 1 21 138 100 138 138 138 138 138 138 138 138 138 138 138 1 136 136 136 1
15 121 15 1 122 122 122 122 122 122 122 1 123 123 123 123 123 123 123 1 1 1 1 1 1 1 1 1 125 125 125 125 125 125 125 1 113 113 113 1 137 137 137 1 1 1 21 3 138 138 138 138 138 138 138 138 138 138 138 2 136 136 136 1
15 121 15 1 1 122 1 122 2 122 1 1 123 123 123 123 123 123 123 1 1 1 1 1 1 1 1 1 125 125 125 125 125 125 125 1 113 113 113 6 137 137 137 6 137 137 1 1 2 2 1 2 1 2 2 1 1 1 1 2 136 136 136 1
15 121 15 1 1 2 1 1 2 1 1 1 1 2 1 91 1 2 1 1 2 1 2 1 2 1 1 2 1 1 2 1 1 1 1 2 113 113 113 1 137 137 137 1 137 137 137 137 137 137 137 137 137 137 137 137 137 137 137 1 136 136 136 2
15 121 15 1 120 120 120 120 120 120 120 1 1 119 119 119 119 119 119 1 116 116 116 116 116 1 1 2 115 115 115 115 115 115 115 2 113 113 113 2 137 137 137 2 137 137 137 137 137 137 137 137 137 137 137 137 137 137 137 2 136 136 136 1
15 121 15 2 120 120 120 120 120 120 120 2 119 119 119 119 119 119 119 2 116 116 116 116 116 2 2 1 115 115 115 115 115 115 115 1 113 113 113 1 137 137 137 1 137 137 137 137 137 137 137 137 137 137 137 137 137 137 137 1 136 136 136 1
15 121 15 1 120 120 120 120 120 120 120 1 119 119 119 119 119 119 119 1 116 116 116 116 116 116 116 1 115 115 115 115 115 115 115 1 113 113 113 1 1 91 1 1 1 1 2 2 1 2 2 1 1 2 1 1 137 137 137 1 136 136 136 1
15 121 15 2 120 120 120 120 120 120 120 90 119 119 119 119 119 119 119 90 116 116 116 116 116 116 116 90 115 115 115 115 115 115 115 90 113 113 113 2 135 135 135 135 135 135 135 135 135 135 135 135 135 135 135 1 137 137 137 2 136 136 136 1
15 121 15 1 120 120 120 120 120 120 120 1 119 119 119 119 119 119 119 1 116 116 116 116 116 116 116 2 115 115 115 115 115 115 115 1 113 113 113 2 135 135 135 135 135 135 135 135 135 135 135 135 135 135 135 2 137 137 137 1 136 136 136 2
15 121 15 1 1 120 120 120 120 120 120 2 119 119 119 119 119 119 119 1 1 2 116 116 116 2 1 1 115 115 115 115 115 115 115 1 113 113 113 1 135 135 135 135 135 135 135 135 135 135 135 135 135 135 135 2 137 137 137 1 136 136 136 1
15 121 15 1 1 1 120 120 120 120 120 1 119 119 119 119 119 119 1 2 1 1 116 116 116 1 1 2 115 115 115 115 115 115 115 2 113 113 113 2 1 1 1 1 1 91 1 1 2 2 1 1 135 135 135 1 137 137 137 1 136 136 136 1
15 121 15 1 1 1 1 91 1 1 1 1 2 1 1 6 1 1 1 1 1 2 1 2 1 2 1 1 2 1 2 2 1 1 2 1 113 113 113 2 134 134 134 134 134 134 134 134 134 134 134 1 135 135 135 2 137 137 137 2 136 136 136 1
15 121 15 2 1 2 1 121 1 2 1 2 1 1 1 1 1 1 1 1 1 1 1 1 1 1 1 1 114 114 114 114 114 114 114 1 113 113 113 1 134 134 134 134 134 134 134 134 134 134 134 2 135 135 135 1 137 137 137 1 136 136 136 1
15 121 15 1 121 121 121 121 121 121 121 1 1 1 1 1 1 1 1 1 1 1 1 1 1 1 1 1 114 114 114 114 114 114 114 2 113 113 113 2 134 134 1 134 134 134 134 134 2 134 134 1 135 135 135 1 137 137 137 1 136 136 136 1
15 121 15 2 121 121 121 121 121 121 121 1 1 1 1 1 1 1 1 1 1 1 1 1 1 1 1 1 114 114 114 114 114 114 114 1 113 113 113 1 134 134 134 134 134 134 134 134 134 134 134 1 135 135 135 1 137 137 137 1 136 136 136 1
15 121 15 1 1 1 1 1 2 1 1 6 1 1 1 1 1 1 1 1 1 1 1 1 1 1 1 1 114 114 114 114 114 114 114 90 113 113 113 90 134 134 134 134 134 134 134 134 134 134 134 90 135 135 135 1 137 137 137 2 136 136 136 1
15 121 15 1 121 1 1 121 121 121 121 1 1 1 1 1 1 1 1 1 1 1 1 1 1 1 1 1 114 114 114 114 114 114 114 1 113 113 113 1 134 134 134 134 134 134 134 134 134 134 134 1 135 135 135 2 1 1 2 1 136 136 136 2
15 121 121 121 121 1 1 121 121 121 121 1 1 1 1 1 1 1 1 1 1 1 1 1 1 1 1 1 114 114 114 114 114 114 114 2 1 3 1 2 134 134 2 134 134 134 134 134 1 134 134 2 135 135 135 1 136 136 136 136 136 136 136 1
15 15 1 2 1 2 1 1 2 1 1 1 1 1 1 1 1 1 1 1 1 1 1 1 1 1 1 1 114 114 114 114 114 114 114 1 113 113 113 1 134 134 134 134 134 134 134 134 134 134 134 2 135 135 135 90 136 136 136 136 136 136 136 3
15 15 1 121 121 121 121 121 121 121 121 1 1 1 1 1 1 1 1 1 1 1 1 1 1 1 1 1 1 1 1 2 1 1 1 2 2 113 1 1 134 134 134 134 134 134 134 134 134 134 134 1 135 135 135 1 136 136 136 136 136 136 136 2
15 15 1 1 1 1 1 121 1 1 1 1 1 1 1 1 1 1 1 1 1 1 1 1 1 1 1 1 1 1 1 1 2 1 1 1 2 1 1 1 2 1 1 1 1 2 1 1 1 1 2 2 1 1 2 1 1 2 2 1 1 2 2 2
