1 1 1 1 1 1 1 1 1 1 1 1 1 1 1 1 1 1 1 1 1 1 1 4 2 1 1 2 2 2 2 2 2 1 2 1 9 9 8 8 9 8 8 8 8 9 8 9 8 8 9 8 8 9 8 8 9 9 8 8 8 9 9 9
1 1 1 2 2 1 2 1 1 2 3 1 2 3 1 1 2 1 2 2 2 1 113 113 113 2 114 114 114 114 114 114 114 114 114 2 8 116 116 116 116 116 9 116 116 116 116 116 9 116 116 116 116 116 9 116 116 116 116 116 9 9 9 8
1 108 108 108 108 108 108 6 108 108 108 108 108 108 108 108 108 108 108 108 108 2 113 113 113 90 114 114 114 114 114 114 114 114 114 1 9 116 116 116 116 116 8 116 116 116 116 116 8 116 116 116 116 116 8 116 116 116 116 116 8 9 9 8
13 108 108 108 108 108 108 90 108 108 108 108 108 108 108 108 108 108 108 108 108 1 113 113 113 1 114 114 114 114 114 114 114 114 114 1 9 116 116 116 116 116 9 116 116 116 116 116 8 116 116 116 116 116 9 116 116 116 116 116 9 9 9 9
2 108 108 108 108 108 108 6 108 108 108 108 108 108 108 108 108 108 108 108 108 2 113 113 113 2 114 114 114 114 114 114 114 114 114 1 8 9 8 91 8 9 8 9 8 91 8 9 9 8 9 91 8 8 9 9 8 91 8 9 8 9 9 9
1 1 2 2 2 1 2 1 1 2 3 2 1 3 2 2 108 108 108 108 108 2 113 113 113 2 114 114 114 114 114 114 114 114 114 2 5 116 116 116 116 116 116 116 116 116 116 116 116 116 116 116 116 116 116 116 116 116 116 116 9 9 9 8
1 108 108 108 108 108 108 1 1 1 1 1 1 1 1 2 108 108 108 108 108 1 113 113 113 2 114 114 114 114 114 114 114 114 114 1 9 116 116 116 116 116 116 116 116 116 116 116 116 116 116 116 116 116 116 116 116 116 116 116 9 9 9 8
1 108 108 108 108 108 108 1 1 1 1 1 1 1 1 1 108 108 108 108 108 2 113 113 113 1 2 2 1 114 114 114 114 114 114 1 5 116 116 116 116 116 116 116 116 116 116 116 116 116 116 116 116 116 116 116 116 116 116 116 8 9 9 8
1 1 108 108 108 108 108 1 138 138 138 138 138 138 138 2 108 108 108 108 108 2 113 113 113 113 113 113 2 114 114 114 114 114 114 2 8 8 9 9 8 8 9 9 116 116 116 116 116 8 8 9 9 9 9 9 8 8 8 9 8 9 9 9
1 1 1 2 2 2 2 1 138 138 138 138 1 138 1 1 2 1 91 1 2 2 113 113 113 113 113 113 90 114 114 114 114 114 114 2 8 116 116 116 116 8 8 9 9 116 116 116 9 8 8 8 8 8 8 8 8 8 8 8 8 8 8 9
2 110 110 110 110 110 110 1 138 138 138 138 1 138 138 1 1 109 109 109 1 2 113 113 113 113 113 113 1 114 114 114 114 114 114 2 8 116 116 116 116 8 9 8 9 116 116 116 8 8 8 8 8 8 8 8 8 8 8 8 8 8 8 9
1 110 110 110 110 110 110 90 138 138 138 138 2 2 1 1 2 109 109 109 1 1 2 1 2 113 113 113 2 1 1 2 2 1 1 2 2 8 116 116 116 8 116 116 8 116 116 116 9 8 8 8 8 8 8 8 8 8 8 8 8 8 8 8
1 110 110 110 110 110 110 1 138 138 138 138 2 109 109 109 109 109 109 109 109 109 109 109 2 113 113 113 113 113 113 113 113 113 113 113 2 9 116 116 116 9 116 116 8 8 91 8 9 8 8 8 8 8 8 8 8 8 8 8 8 8 8 8
1 110 110 17 17 110 110 2 138 138 138 138 2 109 109 109 109 109 109 109 109 109 109 109 1 113 113 113 113 113 113 113 113 113 113 113 1 8 116 116 116 8 116 116 9 115 115 115 8 8 8 8 8 8 8 8 8 8 8 8 8 8 8 8
2 110 110 17 110 110 110 2 138 138 138 138 1 109 109 3 2 109 109 109 1 4 109 109 2 113 113 113 113 113 113 113 113 113 113 113 2 8 116 116 116 9 116 116 8 115 115 115 8 8 8 8 8 8 8 8 8 8 8 8 8 8 8 8
1 110 110 17 17 110 110 1 2 1 2 1 2 109 109 1 4 109 109 109 3 2 109 109 1 2 1 1 2 6 1 2 1 113 113 113 1 9 8 8 9 8 9 8 8 115 115 115 9 8 8 8 8 8 8 8 8 8 8 8 8 8 8 8
1 110 110 110 110 110 110 110 110 110 2 109 109 109 109 109 109 109 109 109 109 109 109 109 109 109 1 109 109 109 109 109 2 113 113 113 113 8 115 115 115 115 115 115 115 115 115 115 8 8 8 8 8 8 8 8 8 8 8 8 8 8 8 8
1 110 110 110 110 110 110 110 110 110 90 109 109 109 109 109 109 109 109 109 109 109 109 109 109 109 90 109 109 109 109 109 90 113 113 113 113 90 115 115 115 115 115 115 115 115 115 115 8 8 8 9 9 9 9 9 8 8 8 9 8 9 9 8
1 110 110 110 110 110 110 110 110 110 1 109 109 109 109 109 109 109 109 109 109 109 109 109 109 109 2 109 109 109 109 109 1 113 113 113 113 8 115 115 115 115 115 115 115 115 115 115 9 8 112 112 112 112 112 112 112 112 112 112 112 8 8 8
2 110 110 17 17 110 110 1 2 1 2 1 1 109 109 1 3 109 109 109 4 1 109 109 2 1 1 2 2 6 1 2 1 1 1 1 1 8 9 8 8 9 9 9 9 8 8 9 9 112 112 112 112 112 112 112 112 112 112 112 112 112 8 8
2 110 110 17 110 110 110 1 139 139 139 139 1 109 109 4 2 109 109 109 2 3 109 109 1 2 2 2 2 2 2 2 2 2 2 2 1 2 8 117 117 117 117 117 117 117 117 117 8 112 112 112 112 112 112 112 112 112 112 112 112 112 9 8
1 110 110 17 17 110 110 2 139 139 139 139 1 109 109 109 109 109 109 109 109 109 109 109 2 2 2 2 2 2 2 2 2 2 2 2 1 1 8 117 117 117 117 117 117 117 117 117 90 112 112 112 112 112 112 112 112 112 112 112 112 112 8 8
1 110 110 110 110 110 110 1 139 139 139 139 2 109 109 109 109 109 109 109 109 109 109 109 1 2 2 2 2 2 2 2 2 2 2 2 2 2 8 117 117 8 117 117 117 8 117 117 8 112 112 112 1 2 1 1 2 1 2 112 112 112 8 8
1 110 110 110 110 110 110 90 139 139 139 139 1 2 1 2 1 109 109 109 2 1 1 1 2 2 2 2 2 2 2 2 2 2 2 2 2 2 8 117 117 117 117 117 117 117 117 117 9 112 112 112 2 1 1 1 1 1 2 112 112 112 8 8
2 110 110 110 110 110 110 1 139 139 139 139 1 129 129 129 2 109 109 109 1 2 2 2 2 2 2 2 2 2 2 2 2 2 2 2 2 2 9 117 117 117 117 117 117 117 117 117 9 112 112 112 1 1 1 1 112 112 1 112 112 112 9 8
1 2 1 4 2 1 2 1 139 139 139 139 1 129 129 129 2 1 91 1 1 2 2 2 2 2 2 2 2 2 2 2 2 2 2 2 2 2 8 117 117 8 117 117 117 8 117 117 8 112 112 112 1 1 112 112 112 112 2 112 112 112 8 8
1 111 111 111 111 111 111 1 139 139 139 139 1 129 129 129 2 111 111 111 2 2 2 2 2 2 2 2 2 2 2 2 2 2 1 2 2 1 8 117 117 117 117 117 117 117 117 117 90 112 112 112 1 1 112 112 112 112 1 112 112 112 8 8
2 111 111 111 111 111 111 1 2 2 1 1 1 129 129 129 2 111 111 111 1 2 2 2 2 2 2 2 2 2 2 2 1 112 112 112 112 112 9 117 117 117 117 117 117 117 117 117 8 112 112 112 1 1 112 112 112 112 1 112 112 112 8 8
1 111 111 111 111 111 2 2 1 2 1 2 1 1 91 2 1 111 111 111 1 2 2 2 1 1 1 2 1 1 2 1 1 112 112 112 112 112 8 8 91 8 9 8 9 8 91 9 9 112 112 112 2 1 2 1 2 1 2 112 112 112 9 8
1 111 111 111 111 111 3 111 111 111 111 111 111 111 111 111 111 111 111 111 111 111 111 111 111 111 111 111 111 111 3 112 112 112 112 112 112 112 112 112 112 112 112 112 112 112 112 112 112 112 112 112 112 112 112 112 112 112 112 112 112 112 9 8
6 111 111 111 111 111 90 111 111 111 111 111 111 111 111 111 111 111 111 111 111 111 111 111 111 111 111 111 111 111 90 112 112 112 112 112 112 112 112 112 112 112 112 112 112 112 112 112 112 112 112 112 112 112 112 112 112 112 112 112 112 112 9 8
2 111 111 111 111 111 3 111 111 111 111 111 111 111 111 111 111 111 111 111 111 111 111 111 111 111 111 111 111 111 3 112 112 112 112 112 112 112 112 112 112 112 112 112 112 112 112 112 112 112 112 112 112 112 112 112 112 112 112 112 112 112 8 8
2 111 111 111 111 111 1 1 1 2 2 1 2 2 1 2 1 111 111 111 2 1 1 2 2 1 1 2 2 2 1 112 112 112 112 112 112 112 8 9 9 8 9 9 8 8 8 8 9 112 112 112 1 2 1 1 2 1 2 112 112 112 8 8
2 111 111 111 111 111 111 2 120 120 120 120 120 120 120 120 1 111 111 111 2 112 112 112 112 112 112 112 112 112 112 112 112 112 112 112 112 112 8 126 126 126 126 126 126 126 126 126 8 112 112 112 2 142 142 142 142 142 2 112 112 112 8 8
2 111 111 111 111 111 111 2 120 120 120 120 120 120 120 120 2 111 111 111 1 112 112 112 112 112 112 112 112 112 112 112 112 112 112 112 112 112 8 126 126 126 126 126 126 126 126 126 9 112 112 112 1 142 142 142 142 142 1 112 112 112 8 8
1 2 2 4 1 2 1 1 120 120 120 120 120 120 120 120 2 1 91 1 2 112 112 112 112 112 112 112 112 112 112 112 112 112 112 112 112 112 9 126 126 126 126 126 126 126 126 126 8 112 112 112 1 142 142 142 142 142 2 112 112 112 9 8
1 121 121 121 121 121 2 2 120 120 120 120 120 120 120 120 120 120 120 120 2 112 112 112 112 112 112 112 112 112 112 112 112 112 112 112 112 112 9 126 126 126 126 126 126 126 126 126 8 112 112 112 1 142 142 142 142 142 1 112 112 112 8 8
2 121 121 121 121 121 2 2 120 120 120 120 120 120 120 120 120 120 120 120 90 112 112 112 112 112 112 112 112 112 112 112 112 112 112 112 112 112 9 126 126 126 126 126 126 126 126 126 8 112 112 112 1 142 142 142 142 142 1 112 112 112 8 8
1 121 121 121 121 121 1 1 120 120 120 120 120 120 120 120 120 120 120 120 1 112 112 112 112 112 112 112 112 112 112 112 112 112 112 112 112 112 9 126 126 126 126 126 126 126 126 126 9 112 112 112 2 1 2 91 2 1 2 112 112 112 8 8
1 121 121 121 121 121 2 1 1 1 2 2 2 1 2 2 1 1 2 2 1 112 112 112 112 112 112 112 112 112 112 112 112 112 112 112 112 112 9 126 126 126 126 126 126 126 126 126 8 112 112 112 112 112 112 112 112 112 112 112 112 112 9 8
2 121 121 121 121 121 121 121 121 121 121 121 121 121 121 121 2 112 112 112 112 112 112 112 1 2 91 1 1 2 1 91 2 1 1 1 91 2 9 8 91 8 9 9 8 91 8 9 9 112 112 112 112 112 112 112 112 112 112 112 112 112 9 8
2 121 121 121 121 121 121 121 121 121 121 121 121 121 121 121 90 112 112 112 112 112 112 112 1 123 123 123 123 123 123 123 123 123 123 123 123 123 1 125 125 125 9 127 127 127 127 127 9 9 112 112 112 112 112 112 112 112 112 112 112 8 8 8
1 121 121 121 121 121 121 121 121 121 121 121 121 121 121 121 1 112 112 112 112 112 112 112 2 123 123 123 123 123 123 123 123 123 123 123 123 123 2 125 125 125 8 127 127 127 127 127 9 8 9 8 8 8 8 9 9 8 9 9 8 8 8 8
2 121 121 121 121 121 2 1 1 2 1 2 2 1 2 1 2 1 1 1 1 1 2 1 1 123 123 123 123 12 123 12 12 12 123 123 123 123 1 125 125 125 9 127 127 127 127 127 9 8 8 8 8 8 8 8 8 8 8 8 8 8 8 8
2 121 121 121 121 121 2 1 1 1 1 1 1 1 1 1 1 1 1 1 1 1 1 2 1 1 123 123 123 12 123 12 123 123 123 123 123 1 1 125 125 125 9 127 127 127 127 127 9 8 8 8 8 8 8 8 8 8 8 8 8 8 8 8
2 121 121 121 121 121 1 1 1 1 1 1 1 1 1 1 1 1 1 1 1 1 1 2 1 3 123 123 123 12 12 123 12 12 123 123 123 3 1 125 125 125 9 127 127 127 127 127 8 8 8 8 8 8 8 8 8 8 8 8 8 8 9 8
2 121 121 121 121 121 2 1 1 1 1 1 1 1 1 1 1 1 1 1 1 1 1 1 1 1 123 123 123 123 123 12 123 12 123 123 123 1 1 125 125 125 8 127 127 127 127 127 9 8 8 8 8 8 8 8 8 8 8 8 8 8 8 8
1 121 121 121 121 121 1 1 1 1 1 1 1 1 1 1 1 1 1 1 1 1 1 1 2 123 123 123 123 12 12 12 123 12 123 123 123 123 2 125 125 125 8 127 127 127 127 127 8 8 8 8 8 8 8 8 8 8 8 8 8 8 8 8
1 1 1 91 2 1 1 1 1 1 1 1 1 1 1 1 1 1 1 1 1 1 1 1 1 123 123 123 123 123 123 123 123 123 123 123 123 123 90 125 125 125 9 127 127 127 127 127 8 8 8 8 8 8 8 8 8 8 8 8 8 8 8 8
2 140 140 140 140 140 1 1 1 1 1 1 1 1 1 1 1 1 1 1 1 1 1 1 1 123 123 123 123 123 123 123 123 123 123 123 123 123 1 125 125 125 8 127 127 127 127 127 9 8 8 8 8 8 8 8 8 8 8 8 8 8 8 8
2 140 140 140 140 140 2 1 1 1 1 1 1 1 1 1 1 1 1 1 1 1 1 2 1 1 1 1 1 1 2 4 1 1 1 1 1 1 2 125 125 125 9 127 127 127 127 127 9 8 8 8 8 8 8 8 8 8 8 8 8 8 9 8
2 140 140 140 140 140 2 1 1 1 1 1 1 1 124 124 124 124 124 124 124 124 124 124 124 124 1 2 124 124 124 124 124 124 124 2 2 1 2 125 125 125 8 127 127 127 127 127 9 8 8 8 8 8 8 8 8 8 8 8 8 8 8 8
1 140 140 140 140 140 2 1 1 1 1 1 1 1 124 124 124 124 124 124 124 124 124 124 124 124 2 124 124 124 124 124 124 124 124 124 1 1 1 125 125 125 8 127 127 127 127 127 9 8 9 8 8 8 8 9 9 8 9 9 8 8 8 8
1 140 140 140 140 140 1 1 1 1 1 1 1 1 124 124 124 124 124 124 124 124 124 124 1 1 124 124 124 124 124 124 124 124 124 124 124 1 2 125 125 125 9 127 127 127 127 127 9 128 128 128 128 128 128 128 128 128 128 128 128 9 8 8
1 1 1 1 1 1 1 1 1 1 1 1 1 1 124 124 124 124 124 124 124 124 124 124 2 124 124 124 124 124 124 124 124 124 124 124 124 124 1 125 125 125 9 127 127 127 127 127 90 128 128 128 128 128 128 128 128 128 128 128 128 128 8 8
2 1 1 2 2 1 2 1 1 1 1 1 1 1 124 124 124 124 124 124 124 124 124 124 2 124 124 124 124 124 17 17 17 124 124 124 124 124 90 125 125 125 8 127 127 127 127 127 8 128 128 128 128 128 128 128 128 128 128 128 128 128 128 8
1 1 1 1 1 1 1 1 1 1 1 1 1 1 124 124 124 124 124 124 124 124 124 124 2 124 124 124 124 17 17 17 17 17 124 124 124 124 2 125 125 125 8 9 9 9 8 8 9 128 128 128 128 128 128 128 128 9 8 128 128 128 128 8
1 1 1 1 1 1 1 1 1 1 1 1 1 1 124 124 124 124 124 124 124 124 124 124 1 124 124 124 124 17 17 17 17 17 124 124 124 124 1 125 125 125 8 8 8 9 141 141 9 128 128 128 128 128 128 128 128 9 9 8 128 128 128 8
2 1 1 1 1 1 1 1 1 1 1 1 1 1 124 124 124 124 124 124 124 124 124 124 2 124 124 124 124 124 17 17 17 124 124 124 124 124 90 125 125 125 8 8 21 9 141 141 9 128 128 128 128 128 128 128 128 8 9 9 128 128 128 9
1 1 1 1 1 1 1 1 1 1 1 1 1 1 124 124 124 124 124 124 124 124 124 124 1 124 124 124 124 124 124 124 124 124 124 124 124 124 2 125 125 125 8 21 141 100 141 141 92 128 128 128 128 128 128 128 128 9 8 128 128 128 128 8
2 1 1 1 1 1 1 1 1 1 1 1 1 1 124 124 124 124 124 124 124 124 124 124 1 2 124 124 124 124 124 124 124 124 124 124 124 1 1 125 125 125 8 8 21 8 141 141 9 128 128 128 128 128 128 128 128 128 128 128 128 128 128 8
2 1 1 1 1 1 1 1 1 1 1 1 1 1 1 1 1 1 1 1 1 1 1 2 1 1 1 124 124 124 124 124 124 124 124 124 2 1 2 125 125 125 9 8 8 8 141 141 8 128 128 128 128 128 128 128 128 128 128 128 128 128 8 9
2 1 1 1 2 2 1 2 1 1 1 1 1 1 1 1 1 1 1 1 1 1 1 2 1 1 1 2 124 124 124 124 124 124 124 2 1 1 2 125 125 125 9 8 8 8 8 8 8 128 128 128 128 128 128 128 128 128 128 128 128 8 9 8
1 1 1 1 1 1 1 1 1 1 1 1 1 1 1 1 1 1 1 1 1 1 1 1 1 1 1 1 2 2 1 2 1 1 1 1 1 1 1 2 3 1 9 8 9 9 9 9 9 8 8 9 9 9 8 8 9 9 8 8 9 8 8 8
