17 17 17 17 17 17 17 17 17 17 17 17 17 17 17 17 17 17 17 17 17 17 17 17 17 17 17 17 17 17 17 17 17 17 17 17 17 17 17 17 17 17 17 17 17 17 17 17 17 17 17 17 17 17 17 17 17 17 17 17 17 17 17 17
17 131 131 131 131 131 131 131 131 131 131 131 131 131 131 131 131 131 131 17 17 110 110 110 110 110 110 110 110 17 106 143 143 18 21 17 17 17 109 109 109 109 109 109 17 17 133 17 133 17 133 17 133 17 111 111 111 111 111 111 111 111 111 17
17 131 131 131 131 131 131 131 131 131 131 131 131 131 131 131 131 131 131 17 17 110 110 110 110 110 110 110 110 92 143 143 143 100 143 21 17 109 109 109 109 109 109 109 109 17 133 133 133 133 133 133 133 17 111 111 111 111 111 111 111 111 111 17
17 131 131 131 131 131 131 131 131 131 131 131 131 131 131 131 131 131 131 17 17 110 110 110 110 110 110 110 110 17 106 143 143 18 21 17 17 109 109 109 109 109 109 109 109 17 133 133 133 133 133 133 133 90 111 111 111 111 111 111 111 111 111 17
17 17 91 17 17 17 17 17 17 17 17 17 17 17 17 17 131 131 131 17 17 110 110 110 17 17 17 17 17 17 17 17 17 17 17 17 17 109 109 109 109 109 109 109 109 17 133 133 133 133 133 133 133 17 17 17 17 17 17 17 111 111 111 17
17 131 131 131 17 17 17 17 17 132 132 17 17 17 17 17 131 131 131 17 17 110 110 110 17 17 110 110 17 17 17 17 17 17 17 17 17 17 109 109 109 109 109 109 17 17 133 17 133 17 133 17 133 17 17 17 17 17 17 17 111 111 111 17
17 131 131 131 17 17 17 132 132 132 132 132 132 17 17 17 131 131 131 17 17 110 110 110 17 17 110 110 17 17 109 109 109 109 106 17 17 17 17 91 17 17 91 17 17 17 17 17 17 17 17 17 17 17 106 109 109 109 109 17 111 111 111 17
17 131 131 131 17 17 132 132 132 132 132 132 132 132 17 17 131 131 131 17 17 110 110 110 110 17 17 17 17 17 109 109 109 109 109 109 109 109 109 109 109 109 109 109 109 109 109 109 109 109 109 109 109 109 109 109 109 109 109 17 111 111 111 17
17 17 17 17 17 17 132 132 132 132 132 132 132 132 17 17 131 131 131 17 17 110 110 110 110 110 110 90 109 109 109 109 109 109 109 109 109 109 109 109 109 109 109 109 109 109 109 109 109 109 109 109 109 109 109 109 109 109 109 90 111 111 111 17
17 17 17 17 17 132 132 132 132 132 132 132 132 132 132 17 131 131 131 17 17 110 110 110 110 17 17 17 17 17 109 109 109 109 109 109 109 109 109 109 109 109 109 109 109 109 109 109 109 109 109 109 109 109 109 109 109 109 109 17 111 111 111 17
17 17 17 17 17 132 132 132 132 2 1 132 132 132 132 17 131 131 131 17 17 110 110 110 17 17 131 17 17 17 109 109 109 109 106 17 17 17 17 17 17 17 17 17 91 17 17 17 17 17 17 17 17 17 106 109 109 109 109 17 111 111 111 17
17 17 17 17 17 132 132 132 1 1 1 2 132 132 132 17 131 131 131 17 17 110 110 110 17 17 131 17 17 17 17 17 17 17 17 17 17 17 17 17 17 108 108 108 108 108 108 108 17 17 17 112 112 17 17 17 17 17 17 17 111 111 111 17
17 17 17 17 17 132 132 132 2 1 2 1 132 132 132 17 131 131 131 17 17 110 110 110 17 131 131 17 131 131 17 131 131 131 131 131 131 17 17 17 108 108 108 108 108 108 108 108 108 17 17 112 112 112 112 112 112 112 112 17 111 111 111 17
17 17 17 17 17 132 132 132 132 1 2 132 132 132 132 17 131 131 131 17 17 110 110 110 17 17 17 17 131 131 18 131 131 131 131 131 131 17 17 108 108 108 108 108 12 108 108 108 108 108 17 112 112 112 112 112 112 112 112 17 111 111 111 17
17 17 17 17 17 132 132 132 132 132 132 132 132 132 132 17 131 131 131 17 17 110 110 110 17 17 17 17 17 17 17 131 131 131 131 131 131 17 17 108 108 108 108 108 11 108 108 108 108 108 17 112 112 112 12 10 12 112 112 17 111 111 111 17
17 17 17 17 17 17 132 132 132 132 132 132 132 132 17 17 131 131 131 17 17 110 110 110 17 17 131 131 131 17 17 17 17 131 131 131 131 17 17 108 108 108 108 12 12 12 108 108 108 108 17 112 112 112 11 12 11 112 112 90 111 111 111 17
17 17 17 17 17 17 132 132 132 132 132 132 132 132 17 17 131 131 131 17 17 110 110 110 17 17 131 131 131 17 17 17 17 131 131 131 131 17 17 108 108 108 12 12 12 12 12 108 108 108 17 112 112 112 12 10 12 112 112 17 111 111 111 17
17 17 17 17 17 17 132 132 132 132 132 132 132 17 17 17 131 131 131 17 17 110 110 110 17 17 17 131 17 17 17 17 17 131 131 131 131 17 17 108 108 108 108 12 12 12 108 108 108 108 17 112 112 112 112 112 112 112 112 17 111 111 111 17
17 17 17 17 17 17 132 17 17 132 132 17 17 17 17 17 131 131 131 17 17 110 110 110 17 17 17 131 17 17 17 17 17 131 131 131 131 17 17 108 108 108 108 108 10 108 108 108 108 108 17 112 112 112 112 112 112 112 112 17 111 111 111 17
17 17 17 17 17 17 91 17 17 17 17 17 17 17 17 17 131 131 131 17 17 17 91 17 17 17 17 131 17 17 17 17 17 131 131 131 131 17 17 17 17 108 108 108 12 108 108 108 17 17 17 112 112 112 17 17 17 17 17 17 111 111 111 17
17 17 17 17 17 131 131 131 131 131 131 131 131 131 131 131 131 131 131 131 131 131 131 131 131 131 131 131 131 131 131 131 131 131 131 131 131 17 17 17 17 17 108 108 108 108 108 17 17 112 112 112 112 112 17 111 111 111 111 17 111 111 111 17
17 17 17 17 17 131 131 131 131 131 131 131 131 131 131 131 131 131 131 131 131 131 131 131 131 131 131 131 131 131 131 131 131 131 131 131 131 17 17 17 17 17 108 108 108 108 108 17 112 112 112 112 112 112 17 111 111 111 111 17 111 111 111 17
17 17 17 17 17 17 17 17 17 17 17 17 17 17 17 17 17 17 17 17 17 17 17 17 17 17 17 17 17 17 17 17 17 17 17 17 17 17 17 17 17 17 108 108 108 108 108 17 112 112 112 112 112 112 17 17 17 17 17 17 111 111 111 17
17 17 17 17 17 17 17 17 17 17 17 17 17 17 17 17 17 17 17 17 17 17 17 17 17 17 17 17 17 17 17 17 17 17 17 17 17 17 17 17 17 17 108 108 108 108 108 17 112 112 112 112 112 112 17 111 111 111 111 111 111 111 111 17
17 17 17 17 17 17 17 17 17 17 17 17 17 17 17 17 17 17 17 17 17 17 17 17 17 17 17 17 17 17 17 17 17 17 17 17 17 17 130 130 130 17 17 18 13 18 17 17 17 91 17 17 91 17 17 111 111 111 111 111 111 111 111 17
17 17 17 17 17 17 17 17 17 17 17 17 17 17 17 17 17 17 17 17 17 17 17 17 17 17 17 17 128 128 128 17 17 17 17 17 17 130 130 130 130 17 17 17 17 17 17 17 114 114 114 114 114 114 17 111 111 111 111 111 111 111 111 17
17 128 128 128 17 17 17 17 17 17 17 17 17 17 17 17 17 17 17 17 17 17 17 17 17 17 17 17 128 128 128 17 17 17 17 17 17 130 130 130 130 90 111 111 111 111 111 17 114 114 114 114 114 114 17 111 111 111 111 111 17 17 17 17
17 128 128 128 17 17 17 17 17 17 17 17 17 17 17 17 17 17 17 17 17 17 17 17 17 17 17 17 128 128 128 17 17 17 17 17 17 130 130 130 130 17 111 111 111 111 111 17 114 114 114 114 114 114 17 111 111 111 111 17 17 115 115 17
17 128 128 128 17 17 17 17 17 17 17 17 17 17 17 17 17 17 17 17 17 17 17 17 17 17 17 17 17 91 17 17 17 17 17 17 17 17 130 130 130 17 111 111 111 111 111 17 114 114 114 114 114 114 17 111 111 111 111 90 115 115 115 17
17 17 91 17 17 17 17 17 17 17 17 17 17 17 17 17 17 17 17 17 17 17 17 17 17 17 17 17 128 128 128 17 17 17 17 17 17 17 17 17 17 17 17 17 111 111 111 17 17 17 17 17 17 17 17 111 111 111 111 17 115 115 115 17
17 128 128 128 128 128 128 128 128 128 128 128 128 128 128 128 128 128 128 128 128 128 128 128 128 128 128 128 128 128 128 18 129 129 129 129 129 129 129 129 129 129 129 17 111 111 111 111 111 111 111 111 111 111 111 111 111 111 111 17 115 115 115 17
17 128 128 128 128 128 128 128 128 128 128 128 128 128 128 128 128 128 128 128 128 128 128 128 128 128 128 128 128 128 128 90 129 129 129 129 129 129 129 129 129 129 129 90 111 111 111 111 111 111 111 111 111 111 111 111 111 111 111 90 115 115 115 17
17 128 128 128 128 128 128 128 128 128 128 128 128 128 128 128 128 128 128 128 128 128 128 128 128 128 128 128 128 128 128 18 129 129 129 129 129 129 129 129 129 129 129 17 111 111 111 111 111 111 111 111 111 111 111 111 111 111 111 17 17 115 115 17
17 128 128 128 17 17 17 17 17 17 17 17 17 17 17 17 17 17 17 17 17 17 17 17 17 17 17 17 128 128 128 17 17 17 17 17 17 17 17 17 17 17 17 17 17 17 17 17 17 17 17 17 17 17 17 17 17 17 17 17 17 17 17 17
17 128 128 128 17 125 125 125 125 125 125 125 125 125 125 125 125 125 125 125 125 125 125 125 125 125 125 17 17 91 17 17 17 17 17 17 17 17 17 17 17 17 17 17 17 17 17 17 17 17 17 17 17 17 17 17 17 17 17 17 17 17 17 17
17 128 128 128 90 125 125 125 125 125 125 125 125 125 125 125 125 125 125 125 125 125 125 125 125 125 125 17 128 128 128 17 17 17 17 17 17 17 17 17 17 17 17 17 17 17 17 17 17 17 17 17 17 17 17 17 17 17 17 17 17 17 17 17
17 128 128 128 17 125 125 125 125 125 125 125 125 125 125 125 125 125 125 125 125 125 125 125 125 125 125 17 128 128 128 17 17 17 17 17 17 17 17 17 17 17 17 17 17 17 17 17 17 17 17 17 17 17 17 17 17 17 17 17 17 17 17 17
12 12 12 12 12 12 12 12 125 125 125 1 2 1 1 2 1 91 1 2 1 2 1 2 125 125 125 17 128 128 128 17 17 17 17 17 17 17 17 17 17 17 17 17 17 17 17 17 17 17 17 17 17 17 17 17 17 17 17 17 17 17 17 17
12 127 127 127 127 127 127 12 125 125 125 2 126 126 126 126 126 126 126 126 126 126 126 2 125 125 125 17 17 17 17 17 17 17 17 17 17 17 17 17 17 17 17 17 17 17 17 17 17 17 17 17 17 17 17 17 17 17 17 17 17 17 17 17
12 127 127 127 127 127 127 12 125 125 125 1 126 126 126 126 126 126 126 126 126 126 126 1 125 125 125 125 125 17 17 17 17 17 17 17 17 17 17 17 17 17 17 17 17 17 17 17 17 17 17 17 17 17 17 17 17 17 17 17 17 17 17 17
12 127 127 127 127 127 127 12 125 125 125 1 126 126 126 126 126 126 126 126 126 126 126 2 125 125 125 125 125 17 17 17 17 17 17 17 17 17 17 17 17 17 17 17 17 17 17 17 17 17 17 17 17 17 17 17 17 17 17 17 17 17 17 17
12 127 127 127 127 127 127 12 125 125 125 1 126 126 126 126 126 126 126 126 126 126 126 1 125 125 125 125 125 17 17 17 17 17 17 17 17 17 17 17 17 17 17 17 17 17 17 17 17 17 17 17 17 17 17 17 17 17 17 17 17 17 17 17
12 12 127 127 127 127 127 12 125 125 125 2 126 126 126 126 126 126 126 126 126 126 126 1 125 125 125 17 17 17 17 17 17 17 17 17 17 17 17 17 17 17 17 17 17 17 17 17 17 17 17 17 17 17 17 17 17 17 17 17 17 17 17 17
12 12 12 127 127 127 127 12 125 125 125 1 126 126 126 126 126 126 126 126 126 126 126 1 125 125 125 18 124 124 124 17 17 17 17 17 17 17 17 17 17 17 17 17 17 17 17 17 17 17 17 17 17 17 17 17 17 17 17 17 17 17 17 17
12 12 12 12 127 127 127 12 125 125 125 2 126 126 126 126 126 126 126 126 126 126 126 2 125 125 125 90 124 124 106 17 17 17 17 17 17 17 17 17 17 17 17 17 17 17 17 17 17 17 17 17 17 17 17 17 17 17 17 17 17 17 17 17
12 12 12 127 127 127 127 12 125 125 125 1 126 126 126 126 126 126 126 126 126 126 126 1 125 125 125 18 124 124 124 17 17 17 17 17 17 17 17 17 17 17 17 17 17 17 17 17 17 17 17 17 17 17 17 17 17 17 17 17 17 17 17 17
12 12 127 127 127 127 127 12 125 125 125 1 1 2 1 1 1 91 1 2 1 2 1 1 125 125 125 17 17 17 17 17 17 17 17 17 17 17 17 17 17 17 17 17 17 17 17 17 17 17 17 17 17 17 17 17 17 17 17 17 17 17 17 17
12 127 127 127 127 127 127 12 125 125 125 125 125 125 125 125 125 125 125 125 125 125 125 125 125 125 125 125 125 12 17 17 17 17 17 17 17 17 17 17 17 17 17 17 17 17 17 17 17 17 17 17 17 17 17 17 17 17 17 17 17 17 17 17
12 127 127 127 127 127 127 12 125 125 125 125 125 125 125 125 125 125 125 125 125 125 125 125 125 125 125 125 125 12 17 17 17 17 17 17 17 17 17 17 17 17 17 17 17 17 17 17 17 17 17 17 17 17 17 17 17 17 17 17 17 17 17 17
12 127 127 127 127 127 127 12 125 125 125 125 125 125 125 125 125 125 125 125 125 125 125 125 125 125 125 125 125 12 17 17 17 17 17 17 17 17 17 17 17 17 17 17 17 17 17 17 17 17 17 17 17 17 17 17 17 17 17 17 17 17 17 17
12 127 127 127 127 127 12 12 125 125 125 12 12 12 12 12 12 11 12 12 12 12 12 12 12 12 12 12 12 12 17 17 17 17 17 17 17 17 17 17 17 17 17 17 17 17 17 17 17 17 17 17 17 17 17 17 17 17 17 17 17 17 17 17
12 127 127 127 127 127 12 12 125 125 125 12 17 17 17 17 17 17 17 17 17 17 17 17 17 17 17 17 17 17 17 17 17 17 17 17 17 17 17 17 17 17 17 17 17 17 17 17 17 17 17 17 17 17 17 17 17 17 17 17 17 17 17 17
12 127 127 127 127 12 12 10 125 125 125 11 17 17 17 17 17 17 17 17 17 17 17 17 17 17 17 17 17 17 17 17 17 17 17 17 17 17 17 17 17 17 17 17 17 17 17 17 17 17 17 17 17 17 17 17 17 17 17 17 17 17 17 17
12 127 127 127 12 12 12 12 125 125 125 12 17 17 17 17 17 17 17 17 17 17 17 17 17 17 17 17 17 17 17 17 17 17 17 17 17 17 17 17 17 17 17 17 17 17 17 17 17 17 17 17 17 17 17 17 17 17 17 17 17 17 17 17
12 127 127 127 12 12 12 11 125 125 125 10 17 17 17 17 17 17 17 17 17 17 17 17 17 17 17 17 17 17 17 17 17 17 17 17 17 17 17 17 17 17 17 17 17 17 17 17 17 17 17 17 17 17 17 17 17 17 17 17 17 17 17 17
12 127 127 127 12 12 12 12 125 125 125 12 17 17 17 17 17 17 17 17 17 17 17 17 17 17 17 17 17 17 17 17 17 17 17 17 17 17 17 17 17 17 17 17 17 17 17 17 17 17 17 17 17 17 17 17 17 17 17 17 17 17 17 17
12 127 127 127 127 12 12 10 125 125 125 11 17 17 17 17 17 17 17 17 17 17 17 17 17 17 17 17 17 17 17 17 17 17 17 17 17 17 17 17 17 17 17 17 17 17 17 17 17 17 17 17 17 17 17 17 17 17 17 17 17 17 17 17
12 127 127 127 127 127 12 12 125 125 125 12 17 17 17 17 17 17 17 17 17 17 17 17 17 17 17 17 17 17 17 17 17 17 17 17 17 17 17 17 17 17 17 17 17 17 17 17 17 17 17 17 17 17 17 17 17 17 17 17 17 17 17 17
12 127 127 127 127 127 12 12 125 125 125 12 17 17 17 17 17 17 17 17 17 17 17 17 17 17 17 17 17 17 17 17 17 17 17 17 17 17 17 17 17 17 17 17 17 17 17 17 17 17 17 17 17 17 17 17 17 17 17 17 17 17 17 17
12 127 127 127 127 127 127 12 125 125 125 12 17 17 17 17 17 17 17 17 17 17 17 17 17 17 17 17 17 17 17 17 17 17 17 17 17 17 17 17 17 17 17 17 17 17 17 17 17 17 17 17 17 17 17 17 17 17 17 17 17 17 17 17
12 127 127 127 127 127 127 90 125 125 125 12 17 17 17 17 17 17 17 17 17 17 17 17 17 17 17 17 17 17 17 17 17 17 17 17 17 17 17 17 17 17 17 17 17 17 17 17 17 17 17 17 17 17 17 17 17 17 17 17 17 17 17 17
12 127 127 127 127 127 127 12 125 125 125 12 17 17 17 17 17 17 17 17 17 17 17 17 17 17 17 17 17 17 17 17 17 17 17 17 17 17 17 17 17 17 17 17 17 17 17 17 17 17 17 17 17 17 17 17 17 17 17 17 17 17 17 17
12 127 127 127 127 127 127 12 125 125 125 12 17 17 17 17 17 17 17 17 17 17 17 17 17 17 17 17 17 17 17 17 17 17 17 17 17 17 17 17 17 17 17 17 17 17 17 17 17 17 17 17 17 17 17 17 17 17 17 17 17 17 17 17
12 12 12 12 12 12 12 12 12 12 12 12 17 17 17 17 17 17 17 17 17 17 17 17 17 17 17 17 17 17 17 17 17 17 17 17 17 17 17 17 17 17 17 17 17 17 17 17 17 17 17 17 17 17 17 17 17 17 17 17 17 17 17 17
