17 17 17 17 17 17 17 17 17 17 17 17 17 17 17 17 17 17 17 17 17 17 17 17 17 17 17 17 17 17 17 17 17 17 17 17 17 17 12 12 12 12 12 12 12 12 12 12 12 12 12 12 12 12 12 12 12 12 12 12 12 12 12 17
17 119 119 119 119 119 119 119 119 119 119 119 119 119 119 119 119 119 119 119 119 119 119 119 119 119 119 119 119 119 119 17 17 17 17 17 17 17 12 12 12 12 12 12 12 12 12 12 12 12 12 12 12 12 12 12 12 12 12 12 12 12 12 17
17 119 119 119 119 119 119 119 119 119 119 119 119 119 119 119 119 119 119 119 119 119 119 119 119 119 119 119 119 119 119 17 17 17 17 17 17 17 12 12 12 12 12 12 12 12 12 12 12 12 12 12 12 12 12 12 12 12 12 12 12 12 12 17
17 119 119 119 119 119 119 119 119 119 119 119 119 119 119 119 119 119 119 119 119 119 119 119 119 119 119 119 119 119 119 17 17 17 17 17 17 17 12 12 12 12 12 12 12 12 12 12 12 12 12 12 12 12 12 12 12 12 12 12 12 12 12 17
17 119 119 119 2 1 1 2 1 1 2 1 1 2 2 91 1 2 1 1 2 1 1 1 2 2 1 2 119 119 119 17 17 17 17 17 17 17 12 12 12 12 12 12 12 12 12 12 12 12 12 12 12 12 12 12 12 12 12 12 12 12 12 17
17 119 119 119 1 121 1 121 2 121 1 121 1 2 120 120 120 2 123 1 123 2 123 2 123 1 1 1 119 119 119 17 17 17 17 17 17 17 12 12 12 142 142 142 12 12 12 12 12 12 12 12 12 12 12 12 12 12 12 12 12 12 12 17
17 119 119 119 1 106 121 121 121 121 106 121 121 1 120 120 120 1 123 123 123 123 123 123 123 123 1 2 119 119 119 17 17 17 17 17 17 17 12 142 142 142 142 142 12 12 12 12 12 12 12 12 12 12 12 12 12 12 12 12 12 12 12 17
17 119 119 119 4 121 121 121 121 106 121 121 121 90 120 120 120 2 123 123 123 123 123 123 123 123 123 1 119 119 119 17 17 17 17 17 17 17 12 142 142 142 142 142 12 12 12 12 12 12 12 12 12 12 12 12 12 12 12 12 12 12 12 17
17 119 119 119 2 121 121 121 121 121 121 121 121 1 120 120 120 90 123 123 123 123 123 123 123 123 2 1 119 119 119 17 17 17 17 17 17 17 12 11 12 12 12 12 12 12 12 12 12 12 12 12 12 12 12 12 12 12 12 12 12 12 12 17
17 119 119 119 1 121 2 121 1 121 1 121 1 2 120 120 120 1 123 123 123 123 123 123 123 123 123 2 119 119 119 17 117 17 117 17 117 17 142 142 142 12 12 12 12 12 12 12 12 12 12 12 12 12 12 12 12 12 12 12 12 12 12 17
17 119 119 119 1 1 1 1 2 2 1 2 2 1 120 120 120 2 123 123 123 123 123 123 123 123 1 1 119 119 119 17 117 117 117 117 117 17 142 142 142 12 12 12 12 12 12 12 12 12 12 12 12 12 12 12 12 12 12 12 12 12 12 17
17 119 119 119 1 122 2 122 1 122 2 122 1 2 120 120 120 2 123 1 123 2 123 1 123 1 2 2 119 119 119 17 117 117 117 117 117 90 142 142 142 10 142 142 12 12 12 12 12 12 12 12 12 12 12 12 12 12 12 12 12 12 12 17
17 119 119 119 1 106 122 122 122 122 122 122 122 1 120 120 120 1 1 3 1 3 1 3 1 3 1 1 119 119 119 17 117 117 117 117 117 17 142 142 142 12 142 142 142 142 12 12 12 12 12 12 12 12 12 12 12 12 12 12 12 12 12 17
17 119 119 119 4 122 122 122 122 106 122 122 122 90 120 120 120 1 124 124 124 124 124 124 124 124 124 1 119 119 119 17 117 17 117 17 117 17 142 142 142 12 142 142 142 142 12 12 12 143 143 143 143 143 143 12 12 12 12 12 12 12 12 17
17 119 119 119 1 122 122 122 122 122 122 122 122 1 120 120 120 1 124 124 124 124 124 124 124 124 124 1 119 119 119 17 17 17 17 17 17 17 142 142 142 12 142 142 142 142 12 12 12 143 143 143 143 143 143 12 12 12 12 12 12 12 12 17
17 119 119 119 2 122 2 122 2 122 1 122 1 1 120 120 120 1 124 124 124 124 124 124 124 124 124 2 119 119 119 17 116 17 116 17 116 17 142 142 142 12 12 12 12 12 12 12 12 10 12 12 12 12 12 12 12 12 12 12 12 12 12 17
17 119 119 119 1 1 2 1 1 2 1 1 2 1 120 120 120 2 124 124 124 1 2 2 1 1 1 1 119 119 119 17 116 116 116 116 116 17 142 142 142 12 12 12 12 12 12 12 143 143 143 12 12 12 12 12 12 12 12 12 12 12 12 17
17 119 119 119 1 125 1 125 2 125 1 125 1 2 120 120 120 1 124 124 124 2 119 119 119 119 119 119 119 119 119 17 116 116 116 116 116 90 142 142 142 142 142 142 142 142 142 12 143 143 143 12 12 12 12 12 12 12 12 12 12 12 12 17
17 119 119 119 1 125 125 106 125 125 125 125 125 1 120 120 120 2 124 124 124 1 119 119 119 119 119 119 119 119 119 17 116 116 116 116 116 17 142 142 142 142 142 142 142 142 142 12 143 143 143 12 12 12 12 17 17 17 17 17 17 17 17 17
17 119 119 119 4 125 125 125 125 125 106 125 125 90 120 120 120 1 124 124 124 1 119 119 119 119 119 119 119 119 119 17 116 17 116 17 116 17 142 142 142 142 142 142 142 142 142 11 143 143 143 11 12 12 12 17 17 17 17 17 17 17 17 17
17 119 119 119 1 125 106 125 125 125 125 125 125 1 120 120 120 90 124 124 124 2 119 119 119 17 17 17 17 17 17 17 17 17 17 17 17 17 17 17 17 17 17 17 142 142 142 12 143 143 143 12 12 12 12 17 17 17 17 17 17 17 17 17
17 119 119 119 2 125 2 125 1 125 1 125 1 2 120 120 120 2 124 124 124 1 119 119 119 17 17 17 17 17 17 17 17 17 17 17 17 17 17 17 17 17 17 17 142 142 142 12 143 143 143 12 12 12 12 17 17 17 17 17 17 17 17 17
17 119 119 119 1 1 1 1 2 1 1 1 2 1 1 91 1 1 2 1 1 1 119 119 119 17 17 17 17 17 17 17 17 17 17 17 17 17 17 17 17 17 17 17 142 142 142 12 12 91 12 12 12 12 12 17 17 17 17 17 17 17 17 17
17 119 119 119 119 119 119 119 119 119 119 119 119 119 119 119 119 119 119 119 119 119 119 119 119 17 114 114 114 114 114 114 114 17 115 115 115 115 115 115 115 115 115 17 142 142 142 142 142 142 142 142 142 142 142 17 17 17 17 17 17 17 17 17
17 119 119 119 119 119 119 119 119 119 119 119 119 119 119 119 119 119 119 119 119 119 119 119 119 17 114 114 114 114 114 114 114 90 115 115 115 115 115 115 115 115 115 90 142 142 142 142 142 142 142 142 142 142 142 17 17 17 17 17 17 17 17 17
17 119 119 119 119 119 119 119 119 119 119 119 119 119 119 119 119 119 119 119 119 119 119 119 119 17 114 114 114 114 114 114 114 17 115 115 115 115 115 115 115 115 115 17 142 142 142 142 142 142 142 142 142 142 142 17 17 17 17 17 17 17 17 17
17 17 17 17 17 17 17 17 17 17 17 17 17 17 17 17 17 17 17 17 17 17 119 119 119 17 114 114 114 114 114 114 114 17 17 17 17 17 17 17 17 17 17 17 17 91 17 17 17 17 17 17 17 17 17 17 17 17 17 17 17 17 17 17
17 17 17 17 17 17 17 17 17 17 17 17 17 17 126 126 126 17 17 17 17 17 119 119 119 17 114 114 114 114 114 114 114 17 17 113 113 113 113 113 113 113 17 17 137 137 137 137 137 137 137 137 137 137 137 17 17 17 17 17 17 17 17 17
17 17 17 17 17 17 17 17 17 17 17 126 126 17 126 126 126 17 17 17 17 17 119 119 119 17 114 114 114 114 114 114 114 17 17 113 113 113 113 113 113 113 17 17 137 137 137 137 137 137 137 137 137 137 137 17 17 17 17 17 17 17 17 17
17 17 17 17 17 17 17 17 126 126 17 126 126 17 17 17 17 17 17 17 17 17 20 91 20 17 114 114 114 114 114 114 114 17 17 113 113 113 113 113 113 113 17 17 137 137 137 137 137 137 137 137 137 137 137 17 17 17 17 17 17 17 17 17
17 17 17 17 17 126 126 17 126 126 17 17 17 17 17 126 126 126 17 17 17 17 131 131 131 17 17 17 17 91 17 17 17 17 17 113 113 113 113 113 113 113 17 17 17 17 17 17 137 137 137 137 137 137 137 17 17 17 17 17 17 17 17 17
17 17 126 126 17 126 126 17 17 17 17 17 17 17 17 126 126 126 17 17 17 17 131 131 131 17 112 112 112 112 112 112 112 17 17 106 113 113 113 113 113 113 17 17 17 17 17 17 137 137 137 137 137 137 137 17 17 17 17 17 17 17 17 17
17 17 126 126 17 17 17 17 17 126 126 17 126 126 17 126 126 126 17 17 17 17 131 131 131 17 112 112 112 112 112 112 112 17 17 113 113 113 113 113 113 113 17 17 17 17 17 17 137 137 137 137 137 137 137 17 17 17 17 17 17 17 17 17
17 17 17 17 17 17 126 126 17 126 126 17 126 126 17 17 91 17 17 17 17 17 131 131 131 90 112 112 112 112 112 112 112 17 17 113 106 113 113 113 113 113 17 17 17 17 17 17 137 137 137 137 137 137 137 17 17 17 17 17 17 17 17 17
17 17 17 126 126 17 126 126 17 17 17 17 126 126 17 131 131 131 131 131 131 131 131 131 131 17 112 112 112 112 112 112 112 17 17 17 17 91 17 91 17 17 17 17 17 17 17 17 137 137 137 137 137 137 137 17 17 17 17 17 17 17 17 17
17 17 17 126 126 17 17 17 17 17 17 17 126 126 17 131 131 131 131 131 131 131 131 131 131 17 112 112 112 112 112 112 17 17 110 110 110 110 110 110 110 110 110 17 137 137 137 137 137 137 137 137 137 137 137 17 17 17 17 17 17 17 17 17
17 17 17 17 17 17 17 17 17 17 17 17 17 17 17 131 131 131 131 131 131 131 131 131 131 17 17 17 17 17 17 17 17 17 110 110 110 110 110 110 110 110 110 17 137 137 137 137 137 137 137 137 137 137 137 17 17 17 17 17 17 17 17 17
17 17 17 17 17 17 17 20 17 17 17 17 20 17 17 131 131 131 17 17 17 17 17 17 17 17 17 17 17 17 17 17 17 17 110 110 110 110 110 110 110 110 110 90 137 137 137 137 137 137 137 137 137 137 137 17 17 17 17 17 17 17 17 17
17 17 17 17 17 17 128 128 128 128 128 128 128 128 18 131 131 131 17 17 109 109 106 109 109 17 17 17 17 17 17 17 17 17 17 17 110 110 110 110 110 110 110 17 137 137 137 17 17 17 17 17 17 17 17 17 17 17 17 17 17 17 17 17
17 17 17 17 17 17 128 128 128 128 128 128 128 128 90 131 131 131 17 17 109 109 109 109 109 17 17 17 17 17 17 17 17 17 17 17 110 110 110 110 110 110 110 17 137 137 137 17 17 17 17 17 17 17 17 17 17 17 17 17 17 17 17 17
17 17 17 17 17 17 128 128 128 128 128 128 128 128 18 131 131 131 17 17 109 109 109 109 106 17 17 17 17 17 17 17 17 17 17 17 17 17 17 17 17 17 17 17 137 137 137 17 17 17 17 17 17 17 17 17 17 17 17 17 17 17 17 17
17 17 17 17 17 17 17 91 17 17 17 17 17 17 17 17 17 17 17 17 109 109 109 109 109 17 109 109 109 109 109 109 109 109 109 109 109 109 109 109 109 109 109 17 137 137 137 17 17 17 17 17 17 17 17 17 17 17 17 17 17 17 17 17
17 17 17 17 17 17 130 130 130 17 17 17 17 17 17 17 17 17 17 17 17 109 109 106 109 90 109 109 109 109 109 109 8 109 8 109 8 109 109 109 109 109 109 90 137 137 137 17 17 17 17 17 17 17 17 17 17 17 17 17 17 17 17 17
17 17 17 17 17 17 130 130 130 17 17 17 17 17 17 17 17 17 17 17 17 17 109 109 109 17 106 109 106 109 109 109 109 109 109 109 109 109 109 109 106 109 106 17 137 137 137 17 17 17 17 17 17 17 17 17 17 17 17 17 17 17 17 17
17 17 17 17 17 17 130 130 130 17 17 17 17 17 17 17 17 17 17 17 17 17 17 17 17 17 17 17 17 17 109 109 109 109 109 109 109 109 109 17 17 91 17 17 137 137 137 17 17 17 17 17 17 17 17 17 17 17 17 17 17 17 17 17
17 17 17 17 17 17 130 130 130 17 17 17 17 17 17 17 17 17 17 17 17 17 17 17 17 17 17 17 17 17 109 109 109 109 109 109 109 109 109 17 141 141 141 17 17 17 17 17 17 17 17 17 17 17 17 17 17 17 17 17 17 17 17 17
17 17 17 17 17 17 130 130 130 17 17 17 17 17 17 17 17 17 17 17 17 17 17 17 17 17 17 17 17 17 109 109 109 109 109 109 109 109 109 17 141 141 141 17 17 17 17 17 17 17 17 17 17 17 17 17 17 17 17 17 17 17 17 17
17 17 17 17 17 17 130 130 130 17 17 17 17 17 17 17 17 17 17 17 17 17 17 17 17 17 17 17 17 17 109 109 109 109 109 109 109 109 109 17 141 141 141 17 17 17 17 17 17 17 17 17 17 17 17 17 17 17 17 17 17 17 17 17
17 134 134 134 17 17 130 130 130 17 17 17 17 17 17 17 17 17 17 17 17 17 17 17 17 17 17 17 17 17 17 109 109 109 109 109 109 109 17 17 141 141 141 17 17 17 17 17 17 17 17 17 17 17 17 17 17 17 17 17 17 17 17 17
17 134 134 134 17 17 17 91 17 17 17 17 17 17 17 17 17 17 17 17 17 17 17 17 17 17 17 17 17 17 17 17 17 17 91 17 17 17 17 17 141 141 141 17 17 17 17 17 17 17 17 17 17 17 17 17 17 17 17 17 17 17 17 17
17 17 17 17 17 17 132 132 132 17 17 17 17 17 17 17 17 133 133 133 133 133 133 133 17 17 17 17 17 17 108 108 108 108 108 108 108 108 108 17 141 141 141 17 17 17 17 17 17 17 17 17 17 17 17 17 17 17 17 17 17 17 17 17
17 134 134 134 17 132 132 132 132 132 17 133 133 133 133 133 133 133 133 133 133 133 133 133 17 17 17 17 17 17 106 108 108 108 108 108 108 108 106 17 17 17 17 17 17 17 17 17 17 17 17 17 17 17 17 17 17 17 17 17 17 17 17 17
17 134 134 134 90 132 132 132 132 132 90 133 133 133 133 133 133 133 133 133 133 133 133 133 17 17 17 17 17 17 17 17 108 108 108 108 108 17 17 17 17 17 17 17 17 17 17 17 17 17 17 17 17 17 17 17 17 17 17 17 17 17 17 17
17 134 134 134 17 132 132 132 132 132 17 133 133 133 133 133 133 133 133 133 133 133 133 133 17 17 17 17 17 17 17 17 108 108 108 108 108 17 17 17 17 17 17 17 17 17 17 17 17 17 17 17 17 17 17 17 17 17 17 17 17 17 17 17
17 134 134 134 17 17 132 132 132 17 17 17 17 17 17 17 17 133 133 133 133 133 133 133 17 17 17 17 17 17 17 17 108 108 108 108 108 17 17 17 17 17 17 17 17 17 17 17 17 17 17 17 17 17 17 17 17 17 17 17 17 17 17 17
17 134 134 134 17 17 17 17 17 17 17 17 17 17 17 17 17 17 17 17 17 17 17 17 17 17 17 17 17 17 17 17 108 108 108 108 108 17 17 17 17 17 17 17 17 17 17 17 17 17 17 17 17 17 17 17 17 17 17 17 17 17 17 17
17 134 134 134 17 17 17 17 17 17 17 17 17 17 17 17 17 17 17 17 17 17 17 17 17 17 17 17 17 17 17 17 17 108 108 108 17 17 17 17 17 17 17 17 17 17 17 17 17 17 17 17 17 17 17 17 17 17 17 17 17 17 17 17
17 134 134 134 17 17 17 17 17 17 17 17 17 17 17 17 17 17 17 17 17 17 17 17 17 17 17 17 17 17 17 17 17 108 108 108 17 17 17 17 17 17 17 17 17 17 17 17 17 17 17 17 17 17 17 17 17 17 17 17 17 17 17 17
17 134 134 134 17 17 17 17 17 17 17 17 17 17 17 17 17 17 17 17 17 17 17 17 17 17 17 17 17 17 17 17 17 108 108 108 17 17 17 17 17 17 17 17 17 17 17 17 17 17 17 17 17 17 17 17 17 17 17 17 17 17 17 17
17 134 134 134 17 17 17 17 17 17 17 17 17 17 17 17 17 17 17 17 17 17 17 17 17 17 17 17 17 17 17 17 17 17 13 17 17 17 17 17 17 17 17 17 17 17 17 17 17 17 17 17 17 17 17 17 17 17 17 17 17 17 17 17
17 134 134 134 134 134 134 134 134 134 134 134 134 134 134 134 18 134 134 134 134 134 134 106 134 134 134 17 21 17 17 17 17 17 17 17 17 17 17 17 17 17 17 17 17 17 17 17 17 17 17 17 17 17 17 17 17 17 17 17 17 17 17 17
17 134 134 134 134 134 134 134 134 134 134 134 134 134 134 134 92 134 134 134 134 134 134 134 106 134 134 100 134 21 17 17 17 17 17 17 17 17 17 17 17 17 17 17 17 17 17 17 17 17 17 17 17 17 17 17 17 17 17 17 17 17 17 17
17 134 134 134 134 134 134 134 134 134 134 134 134 134 134 134 18 134 134 134 134 106 134 134 134 134 134 17 21 17 17 17 17 17 17 17 17 17 17 17 17 17 17 17 17 17 17 17 17 17 17 17 17 17 17 17 17 17 17 17 17 17 17 17
17 17 17 17 17 17 17 17 17 17 17 17 17 17 17 17 17 17 17 17 17 17 17 17 17 17 17 17 17 17 17 17 17 17 17 17 17 17 17 17 17 17 17 17 17 17 17 17 17 17 17 17 17 17 17 17 17 17 17 17 17 17 17 17
